תאריך,שעה,עלו(₪/MWh),ייצור אנרגיהמתחדש (MW),ייצור קונבנציונלי(MW),ביקוש משקי(MW)
2021/01/01,00:00:00,157.05,4,7002,7006
2021/01/01,00:30:00,157.13,5,6682,6687
2021/01/01,01:00:00,157.13,4,6395,6399
2021/01/01,01:30:00,157.35,4,6147,6151
2021/01/01,02:00:00,157.24,3,5931,5934
2021/01/01,02:30:00,157.24,1,5768,5769
2021/01/01,03:00:00,157.01,1,5622,5623
2021/01/01,03:30:00,157.01,2,5565,5567
2021/01/01,04:00:00,157.12,2,5537,5539
2021/01/01,04:30:00,157.18,1,5601,5602
2021/01/01,05:00:00,157.1,2,5694,5696
2021/01/01,05:30:00,157.25,2,5870,5872
2021/01/01,06:00:00,157.08,2,5993,5995
2021/01/01,06:30:00,157.24,2,6049,6051
2021/01/01,07:00:00,159.16,1,6099,6100
2021/01/01,07:30:00,158.79,129,6211,6340
2021/01/01,08:00:00,158.42,338,6202,6540
2021/01/01,08:30:00,157.19,600,6136,6736
2021/01/01,09:00:00,157.08,874,5992,6866
2021/01/01,09:30:00,157.17,1137,5880,7017
2021/01/01,10:00:00,157.18,1297,5818,7115
2021/01/01,10:30:00,157.18,1396,5790,7186
2021/01/01,11:00:00,157.75,1478,5776,7254
2021/01/01,11:30:00,158.12,1468,5805,7273
2021/01/01,12:00:00,158.19,1497,5796,7293
2021/01/01,12:30:00,158.02,1478,5794,7272
2021/01/01,13:00:00,158.55,1429,5849,7278
2021/01/01,13:30:00,158.92,1360,5955,7315
2021/01/01,14:00:00,159.31,1234,6125,7359
2021/01/01,14:30:00,159.91,1059,6386,7445
2021/01/01,15:00:00,171.79,834,6719,7553
2021/01/01,15:30:00,167.78,553,7177,7730
2021/01/01,16:00:00,165.49,289,7503,7792
2021/01/01,16:30:00,213.84,55,7673,7728
2021/01/01,17:00:00,207.07,0,8091,8091
2021/01/01,17:30:00,196.21,0,8453,8453
2021/01/01,18:00:00,196.21,0,8528,8528
2021/01/01,18:30:00,196.21,0,8498,8498
2021/01/01,19:00:00,196.21,0,8365,8365
2021/01/01,19:30:00,167.39,0,8219,8219
2021/01/01,20:00:00,167.46,0,8027,8027
2021/01/01,20:30:00,167.46,0,7984,7984
2021/01/01,21:00:00,167.46,0,7850,7850
2021/01/01,21:30:00,167.46,0,7706,7706
2021/01/01,22:00:00,177.27,0,7485,7485
2021/01/01,22:30:00,159.36,0,7298,7298
2021/01/01,23:00:00,157.27,0,7035,7035
2021/01/01,23:30:00,157.2,0,6765,6765
2021/01/02,00:00:00,157.06,0,6473,6473
2021/01/02,00:30:00,157.03,0,6197,6197
2021/01/02,01:00:00,157.02,1,5976,5977
2021/01/02,01:30:00,156.99,1,5779,5780
2021/01/02,02:00:00,157.24,1,5623,5624
2021/01/02,02:30:00,157.06,1,5526,5527
2021/01/02,03:00:00,157.24,2,5418,5420
2021/01/02,03:30:00,157.24,2,5390,5392
2021/01/02,04:00:00,157.03,2,5412,5414
2021/01/02,04:30:00,156.99,3,5449,5452
2021/01/02,05:00:00,157.19,3,5540,5543
2021/01/02,05:30:00,157.47,2,5667,5669
2021/01/02,06:00:00,156.99,1,5715,5716
2021/01/02,06:30:00,157.02,1,5686,5687
2021/01/02,07:00:00,157.44,1,5627,5628
2021/01/02,07:30:00,157.07,144,5637,5781
2021/01/02,08:00:00,158.63,365,5585,5950
2021/01/02,08:30:00,158.21,451,5736,6187
2021/01/02,09:00:00,157.98,615,5668,6283
2021/01/02,09:30:00,157.66,816,5620,6436
2021/01/02,10:00:00,157.34,1011,5612,6623
2021/01/02,10:30:00,157.24,1211,5517,6728
2021/01/02,11:00:00,157.56,1269,5503,6772
2021/01/02,11:30:00,158.05,1264,5559,6823
2021/01/02,12:00:00,158.05,1238,5566,6804
2021/01/02,12:30:00,157.74,1268,5505,6773
2021/01/02,13:00:00,157.56,1349,5410,6759
2021/01/02,13:30:00,157.61,1321,5385,6706
2021/01/02,14:00:00,158.39,1247,5401,6648
2021/01/02,14:30:00,159.13,1157,5560,6717
2021/01/02,15:00:00,158.41,1035,5827,6862
2021/01/02,15:30:00,158.59,872,6195,7067
2021/01/02,16:00:00,181.85,483,6572,7055
2021/01/02,16:30:00,182.04,60,7085,7145
2021/01/02,17:00:00,191.57,3,7605,7608
2021/01/02,17:30:00,181.85,4,8087,8091
2021/01/02,18:00:00,195.2,5,8538,8543
2021/01/02,18:30:00,195.31,6,8736,8742
2021/01/02,19:00:00,176.19,5,8770,8775
2021/01/02,19:30:00,183.31,6,8778,8784
2021/01/02,20:00:00,175.98,5,8707,8712
2021/01/02,20:30:00,175.98,8,8580,8588
2021/01/02,21:00:00,182.6,7,8417,8424
2021/01/02,21:30:00,182.6,8,8334,8342
2021/01/02,22:00:00,182.6,3,8066,8069
2021/01/02,22:30:00,182.6,4,7774,7778
2021/01/02,23:00:00,180.79,6,7450,7456
2021/01/02,23:30:00,160.21,7,7022,7029
2021/01/03,00:00:00,178.98,5,6616,6621
2021/01/03,00:30:00,178.81,5,6246,6251
2021/01/03,01:00:00,178.81,6,5931,5937
2021/01/03,01:30:00,178.98,7,5717,5724
2021/01/03,02:00:00,178.98,5,5521,5526
2021/01/03,02:30:00,178.81,7,5388,5395
2021/01/03,03:00:00,178.81,7,5340,5347
2021/01/03,03:30:00,178.98,6,5311,5317
2021/01/03,04:00:00,178.98,6,5320,5326
2021/01/03,04:30:00,179.16,5,5456,5461
2021/01/03,05:00:00,178.81,5,5627,5632
2021/01/03,05:30:00,179.16,6,5907,5913
2021/01/03,06:00:00,178.98,4,6099,6103
2021/01/03,06:30:00,178.81,8,6427,6435
2021/01/03,07:00:00,179.16,6,6794,6800
2021/01/03,07:30:00,178.98,124,7063,7187
2021/01/03,08:00:00,182.6,304,7000,7304
2021/01/03,08:30:00,179.51,531,6988,7519
2021/01/03,09:00:00,178.81,786,6801,7587
2021/01/03,09:30:00,178.81,951,6704,7655
2021/01/03,10:00:00,178.98,1099,6609,7708
2021/01/03,10:30:00,178.98,1251,6509,7760
2021/01/03,11:00:00,178.98,1283,6451,7734
2021/01/03,11:30:00,178.98,1298,6407,7705
2021/01/03,12:00:00,178.98,1278,6353,7631
2021/01/03,12:30:00,178.81,1287,6341,7628
2021/01/03,13:00:00,178.98,1248,6403,7651
2021/01/03,13:30:00,178.64,1175,6549,7724
2021/01/03,14:00:00,178.98,1072,6609,7681
2021/01/03,14:30:00,178.81,948,6779,7727
2021/01/03,15:00:00,189.72,748,7047,7795
2021/01/03,15:30:00,189.55,520,7309,7829
2021/01/03,16:00:00,188.89,295,7521,7816
2021/01/03,16:30:00,189.05,110,7919,8029
2021/01/03,17:00:00,184.99,5,8587,8592
2021/01/03,17:30:00,185.06,5,9061,9066
2021/01/03,18:00:00,221.81,5,9309,9314
2021/01/03,18:30:00,211.9,5,9400,9405
2021/01/03,19:00:00,209.05,6,9443,9449
2021/01/03,19:30:00,215.01,5,9354,9359
2021/01/03,20:00:00,214.78,6,9274,9280
2021/01/03,20:30:00,215.01,6,9123,9129
2021/01/03,21:00:00,215.24,6,8887,8893
2021/01/03,21:30:00,178.64,8,8584,8592
2021/01/03,22:00:00,179.64,5,8272,8277
2021/01/03,22:30:00,178.64,3,8019,8022
2021/01/03,23:00:00,178.64,2,7620,7622
2021/01/03,23:30:00,178.64,3,7202,7205
2021/01/04,00:00:00,178.98,2,6757,6759
2021/01/04,00:30:00,178.81,4,6392,6396
2021/01/04,01:00:00,178.98,3,6107,6110
2021/01/04,01:30:00,178.98,5,5860,5865
2021/01/04,02:00:00,179.16,5,5702,5707
2021/01/04,02:30:00,178.98,6,5593,5599
2021/01/04,03:00:00,178.98,5,5519,5524
2021/01/04,03:30:00,178.98,7,5518,5525
2021/01/04,04:00:00,178.98,9,5524,5533
2021/01/04,04:30:00,179.16,8,5634,5642
2021/01/04,05:00:00,179.33,8,5827,5835
2021/01/04,05:30:00,179.33,6,6105,6111
2021/01/04,06:00:00,179.33,6,6271,6277
2021/01/04,06:30:00,178.98,5,6614,6619
2021/01/04,07:00:00,178.98,4,6897,6901
2021/01/04,07:30:00,178.98,93,7210,7303
2021/01/04,08:00:00,178.98,206,7209,7415
2021/01/04,08:30:00,178.98,380,7249,7629
2021/01/04,09:00:00,178.98,606,7072,7678
2021/01/04,09:30:00,178.98,860,6876,7736
2021/01/04,10:00:00,178.98,1135,6614,7749
2021/01/04,10:30:00,178.98,1364,6415,7779
2021/01/04,11:00:00,179.33,1428,6309,7737
2021/01/04,11:30:00,179.33,1459,6256,7715
2021/01/04,12:00:00,179.33,1478,6209,7687
2021/01/04,12:30:00,179.33,1459,6182,7641
2021/01/04,13:00:00,178.81,1417,6267,7684
2021/01/04,13:30:00,178.98,1327,6373,7700
2021/01/04,14:00:00,178.98,1213,6489,7702
2021/01/04,14:30:00,178.98,1044,6677,7721
2021/01/04,15:00:00,178.81,826,6899,7725
2021/01/04,15:30:00,179.16,601,7151,7752
2021/01/04,16:00:00,179.07,320,7341,7661
2021/01/04,16:30:00,179.25,140,7776,7916
2021/01/04,17:00:00,179.25,101,8358,8459
2021/01/04,17:30:00,209,102,8830,8932
2021/01/04,18:00:00,237.53,102,9088,9190
2021/01/04,18:30:00,236.87,102,9161,9263
2021/01/04,19:00:00,237.53,105,9213,9318
2021/01/04,19:30:00,236.24,88,9180,9268
2021/01/04,20:00:00,237.53,41,9126,9167
2021/01/04,20:30:00,236.24,4,8984,8988
2021/01/04,21:00:00,237.53,4,8771,8775
2021/01/04,21:30:00,236.24,7,8463,8470
2021/01/04,22:00:00,236.24,3,8146,8149
2021/01/04,22:30:00,180.07,5,7923,7928
2021/01/04,23:00:00,180.07,5,7554,7559
2021/01/04,23:30:00,180.07,2,7115,7117
2021/01/05,00:00:00,179.88,2,6660,6662
2021/01/05,00:30:00,180.07,4,6291,6295
2021/01/05,01:00:00,179.88,4,5996,6000
2021/01/05,01:30:00,179.88,5,5812,5817
2021/01/05,02:00:00,180.07,6,5645,5651
2021/01/05,02:30:00,180.26,8,5510,5518
2021/01/05,03:00:00,180.26,9,5443,5452
2021/01/05,03:30:00,180.07,8,5433,5441
2021/01/05,04:00:00,180.07,8,5460,5468
2021/01/05,04:30:00,180.07,5,5610,5615
2021/01/05,05:00:00,180.07,5,5766,5771
2021/01/05,05:30:00,180.26,4,6061,6065
2021/01/05,06:00:00,180.45,4,6226,6230
2021/01/05,06:30:00,180.07,4,6551,6555
2021/01/05,07:00:00,180.07,3,6816,6819
2021/01/05,07:30:00,180.26,112,7089,7201
2021/01/05,08:00:00,180.26,271,7040,7311
2021/01/05,08:30:00,180.07,483,6996,7479
2021/01/05,09:00:00,180.07,706,6838,7544
2021/01/05,09:30:00,218.8,913,6716,7629
2021/01/05,10:00:00,218.8,1026,6551,7577
2021/01/05,10:30:00,218.8,1142,6404,7546
2021/01/05,11:00:00,218.8,1340,6260,7600
2021/01/05,11:30:00,218.8,1425,6241,7666
2021/01/05,12:00:00,218.8,1435,6291,7726
2021/01/05,12:30:00,202.12,1407,6280,7687
2021/01/05,13:00:00,218.8,1366,6371,7737
2021/01/05,13:30:00,218.8,1277,6493,7770
2021/01/05,14:00:00,218.8,1064,6660,7724
2021/01/05,14:30:00,202.12,974,6776,7750
2021/01/05,15:00:00,202.12,834,6898,7732
2021/01/05,15:30:00,202.12,578,7218,7796
2021/01/05,16:00:00,202.12,318,7354,7672
2021/01/05,16:30:00,202.12,118,7767,7885
2021/01/05,17:00:00,207.62,34,8424,8458
2021/01/05,17:30:00,207.01,2,8945,8947
2021/01/05,18:00:00,208.06,2,9121,9123
2021/01/05,18:30:00,208.93,2,9229,9231
2021/01/05,19:00:00,208.93,2,9257,9259
2021/01/05,19:30:00,208.49,2,9193,9195
2021/01/05,20:00:00,208.49,2,9096,9098
2021/01/05,20:30:00,195.37,3,8942,8945
2021/01/05,21:00:00,199.21,3,8696,8699
2021/01/05,21:30:00,208.49,4,8440,8444
2021/01/05,22:00:00,178.64,4,8110,8114
2021/01/05,22:30:00,178.81,2,7901,7903
2021/01/05,23:00:00,178.64,1,7532,7533
2021/01/05,23:30:00,178.64,2,7122,7124
2021/01/06,00:00:00,178.81,2,6723,6725
2021/01/06,00:30:00,178.81,2,6345,6347
2021/01/06,01:00:00,178.81,3,6104,6107
2021/01/06,01:30:00,178.64,3,5882,5885
2021/01/06,02:00:00,178.64,3,5677,5680
2021/01/06,02:30:00,178.98,3,5584,5587
2021/01/06,03:00:00,178.64,3,5537,5540
2021/01/06,03:30:00,178.64,3,5519,5522
2021/01/06,04:00:00,178.64,2,5538,5540
2021/01/06,04:30:00,178.64,2,5648,5650
2021/01/06,05:00:00,178.64,1,5850,5851
2021/01/06,05:30:00,178.64,0,6140,6140
2021/01/06,06:00:00,178.64,0,6290,6290
2021/01/06,06:30:00,178.98,1,6566,6567
2021/01/06,07:00:00,178.81,1,6843,6844
2021/01/06,07:30:00,178.47,89,7143,7232
2021/01/06,08:00:00,179.16,192,7112,7304
2021/01/06,08:30:00,232.1,383,7171,7554
2021/01/06,09:00:00,232.74,675,6897,7572
2021/01/06,09:30:00,178.98,1007,6613,7620
2021/01/06,10:00:00,179.16,1227,6456,7683
2021/01/06,10:30:00,179.16,1354,6292,7646
2021/01/06,11:00:00,178.98,1417,6189,7606
2021/01/06,11:30:00,178.98,1257,6345,7602
2021/01/06,12:00:00,178.98,1208,6392,7600
2021/01/06,12:30:00,178.98,1161,6421,7582
2021/01/06,13:00:00,178.98,1083,6560,7643
2021/01/06,13:30:00,178.98,891,6786,7677
2021/01/06,14:00:00,179.16,1027,6732,7759
2021/01/06,14:30:00,179.33,919,6849,7768
2021/01/06,15:00:00,179.7,754,7010,7764
2021/01/06,15:30:00,178.98,549,7208,7757
2021/01/06,16:00:00,178.98,268,7400,7668
2021/01/06,16:30:00,178.98,132,7732,7864
2021/01/06,17:00:00,200.63,2,8370,8372
2021/01/06,17:30:00,195.2,3,8853,8856
2021/01/06,18:00:00,192.97,3,9049,9052
2021/01/06,18:30:00,198.05,3,9132,9135
2021/01/06,19:00:00,198.05,2,9161,9163
2021/01/06,19:30:00,198.05,1,9103,9104
2021/01/06,20:00:00,198.05,1,9005,9006
2021/01/06,20:30:00,198.05,1,8854,8855
2021/01/06,21:00:00,198.05,1,8633,8634
2021/01/06,21:30:00,172.68,1,8355,8356
2021/01/06,22:00:00,177.2,2,8043,8045
2021/01/06,22:30:00,176.66,4,7858,7862
2021/01/06,23:00:00,176.28,3,7525,7528
2021/01/06,23:30:00,179.16,3,7166,7169
2021/01/07,00:00:00,179.33,3,6729,6732
2021/01/07,00:30:00,179.33,2,6354,6356
2021/01/07,01:00:00,179.33,1,6094,6095
2021/01/07,01:30:00,179.16,3,5872,5875
2021/01/07,02:00:00,179.33,3,5685,5688
2021/01/07,02:30:00,179.33,2,5568,5570
2021/01/07,03:00:00,179.16,3,5479,5482
2021/01/07,03:30:00,179.16,2,5495,5497
2021/01/07,04:00:00,179.16,2,5521,5523
2021/01/07,04:30:00,178.98,1,5614,5615
2021/01/07,05:00:00,178.98,1,5804,5805
2021/01/07,05:30:00,178.98,0,6067,6067
2021/01/07,06:00:00,233.7,2,6217,6219
2021/01/07,06:30:00,235.11,1,6443,6444
2021/01/07,07:00:00,233.84,1,6667,6668
2021/01/07,07:30:00,234.46,110,6939,7049
2021/01/07,08:00:00,237.26,285,6850,7135
2021/01/07,08:30:00,234.46,528,6806,7334
2021/01/07,09:00:00,218.8,744,6619,7363
2021/01/07,09:30:00,218.8,1001,6432,7433
2021/01/07,10:00:00,218.8,1176,6324,7500
2021/01/07,10:30:00,218.8,1328,6198,7526
2021/01/07,11:00:00,218.8,1416,6104,7520
2021/01/07,11:30:00,218.8,1464,6048,7512
2021/01/07,12:00:00,218.8,1476,6019,7495
2021/01/07,12:30:00,218.8,1460,6006,7466
2021/01/07,13:00:00,218.8,1408,6077,7485
2021/01/07,13:30:00,218.8,1358,6151,7509
2021/01/07,14:00:00,218.8,1255,6276,7531
2021/01/07,14:30:00,176.66,1090,6424,7514
2021/01/07,15:00:00,176.17,888,6638,7526
2021/01/07,15:30:00,218.8,622,6926,7548
2021/01/07,16:00:00,176.66,371,7039,7410
2021/01/07,16:30:00,176.84,166,7346,7512
2021/01/07,17:00:00,180.07,100,7914,8014
2021/01/07,17:30:00,179.88,111,8386,8497
2021/01/07,18:00:00,180.07,111,8587,8698
2021/01/07,18:30:00,180.07,113,8720,8833
2021/01/07,19:00:00,180.07,112,8712,8824
2021/01/07,19:30:00,180.07,111,8655,8766
2021/01/07,20:00:00,180.07,68,8605,8673
2021/01/07,20:30:00,180.26,1,8539,8540
2021/01/07,21:00:00,179.88,1,8376,8377
2021/01/07,21:30:00,180.07,2,8119,8121
2021/01/07,22:00:00,180.07,2,7886,7888
2021/01/07,22:30:00,180.07,2,7783,7785
2021/01/07,23:00:00,180.07,2,7540,7542
2021/01/07,23:30:00,179.88,1,7235,7236
2021/01/08,00:00:00,180.07,2,6853,6855
2021/01/08,00:30:00,180.07,1,6485,6486
2021/01/08,01:00:00,180.07,1,6227,6228
2021/01/08,01:30:00,180.07,2,5972,5974
2021/01/08,02:00:00,180.07,2,5770,5772
2021/01/08,02:30:00,180.07,1,5669,5670
2021/01/08,03:00:00,180.07,2,5575,5577
2021/01/08,03:30:00,179.88,2,5501,5503
2021/01/08,04:00:00,180.07,1,5509,5510
2021/01/08,04:30:00,180.07,1,5563,5564
2021/01/08,05:00:00,180.26,1,5667,5668
2021/01/08,05:30:00,180.07,2,5841,5843
2021/01/08,06:00:00,180.07,2,5943,5945
2021/01/08,06:30:00,180.07,2,5998,6000
2021/01/08,07:00:00,219.52,1,5959,5960
2021/01/08,07:30:00,219.52,160,6026,6186
2021/01/08,08:00:00,218.38,409,5998,6407
2021/01/08,08:30:00,180.07,746,5851,6597
2021/01/08,09:00:00,218.8,1078,5686,6764
2021/01/08,09:30:00,218.8,1282,5614,6896
2021/01/08,10:00:00,180.07,1431,5581,7012
2021/01/08,10:30:00,180.07,1522,5574,7096
2021/01/08,11:00:00,180.07,1583,5602,7185
2021/01/08,11:30:00,180.07,1606,5651,7257
2021/01/08,12:00:00,180.07,1615,5643,7258
2021/01/08,12:30:00,218.8,1597,5686,7283
2021/01/08,13:00:00,218.8,1556,5715,7271
2021/01/08,13:30:00,180.07,1481,5810,7291
2021/01/08,14:00:00,180.07,1381,5944,7325
2021/01/08,14:30:00,180.07,1277,6167,7444
2021/01/08,15:00:00,180.07,1156,6439,7595
2021/01/08,15:30:00,180.07,1029,6920,7949
2021/01/08,16:00:00,220.13,820,7327,8147
2021/01/08,16:30:00,221.45,163,7491,7654
2021/01/08,17:00:00,220.13,50,7736,7786
2021/01/08,17:30:00,220.13,3,8179,8182
2021/01/08,18:00:00,221.45,3,8238,8241
2021/01/08,18:30:00,220.13,2,8223,8225
2021/01/08,19:00:00,221.45,2,8099,8101
2021/01/08,19:30:00,218.66,3,7958,7961
2021/01/08,20:00:00,180.07,4,7808,7812
2021/01/08,20:30:00,180.07,3,7801,7804
2021/01/08,21:00:00,180.07,2,7685,7687
2021/01/08,21:30:00,180.07,4,7481,7485
2021/01/08,22:00:00,179.88,3,7251,7254
2021/01/08,22:30:00,180.07,5,7069,7074
2021/01/08,23:00:00,179.88,2,6778,6780
2021/01/08,23:30:00,180.07,2,6528,6530
2021/01/09,00:00:00,180.07,4,6261,6265
2021/01/09,00:30:00,179.88,5,6037,6042
2021/01/09,01:00:00,180.07,4,5831,5835
2021/01/09,01:30:00,180.07,3,5694,5697
2021/01/09,02:00:00,180.07,2,5543,5545
2021/01/09,02:30:00,180.07,5,5463,5468
2021/01/09,03:00:00,180.07,6,5388,5394
2021/01/09,03:30:00,180.07,5,5335,5340
2021/01/09,04:00:00,180.07,6,5343,5349
2021/01/09,04:30:00,180.07,7,5405,5412
2021/01/09,05:00:00,180.07,4,5463,5467
2021/01/09,05:30:00,220.77,2,5605,5607
2021/01/09,06:00:00,210.01,3,5627,5630
2021/01/09,06:30:00,206.34,7,5597,5604
2021/01/09,07:00:00,219.52,8,5484,5492
2021/01/09,07:30:00,220.77,149,5475,5624
2021/01/09,08:00:00,220.13,382,5376,5758
2021/01/09,08:30:00,219.52,698,5258,5956
2021/01/09,09:00:00,179.88,984,5104,6088
2021/01/09,09:30:00,179.88,1197,4996,6193
2021/01/09,10:00:00,180.07,1353,4947,6300
2021/01/09,10:30:00,180.07,1447,4939,6386
2021/01/09,11:00:00,179.88,1506,4916,6422
2021/01/09,11:30:00,180.07,1541,4873,6414
2021/01/09,12:00:00,180.07,1544,4888,6432
2021/01/09,12:30:00,179.88,1528,4930,6458
2021/01/09,13:00:00,179.88,1472,4990,6462
2021/01/09,13:30:00,179.88,1400,5034,6434
2021/01/09,14:00:00,179.88,1297,5126,6423
2021/01/09,14:30:00,179.88,1133,5316,6449
2021/01/09,15:00:00,179.88,914,5532,6446
2021/01/09,15:30:00,179.88,631,5876,6507
2021/01/09,16:00:00,180.07,358,6282,6640
2021/01/09,16:30:00,179.88,140,6714,6854
2021/01/09,17:00:00,220.13,41,7157,7198
2021/01/09,17:30:00,220.13,2,7683,7685
2021/01/09,18:00:00,221.45,2,8057,8059
2021/01/09,18:30:00,220.13,4,8226,8230
2021/01/09,19:00:00,187.31,4,8261,8265
2021/01/09,19:30:00,187.31,4,8247,8251
2021/01/09,20:00:00,187.31,4,8187,8191
2021/01/09,20:30:00,189.17,4,8130,8134
2021/01/09,21:00:00,188.96,4,7957,7961
2021/01/09,21:30:00,188.96,1,7897,7898
2021/01/09,22:00:00,193.73,1,7650,7651
2021/01/09,22:30:00,180.07,1,7410,7411
2021/01/09,23:00:00,179.88,2,7085,7087
2021/01/09,23:30:00,180.07,2,6769,6771
2021/01/10,00:00:00,180.07,2,6398,6400
2021/01/10,00:30:00,180.07,2,6058,6060
2021/01/10,01:00:00,180.07,2,5801,5803
2021/01/10,01:30:00,180.07,3,5607,5610
2021/01/10,02:00:00,180.07,6,5448,5454
2021/01/10,02:30:00,180.07,5,5323,5328
2021/01/10,03:00:00,180.07,8,5258,5266
2021/01/10,03:30:00,180.07,5,5247,5252
2021/01/10,04:00:00,179.88,5,5256,5261
2021/01/10,04:30:00,179.88,5,5371,5376
2021/01/10,05:00:00,179.88,4,5547,5551
2021/01/10,05:30:00,180.07,2,5837,5839
2021/01/10,06:00:00,180.07,3,5967,5970
2021/01/10,06:30:00,180.07,4,6190,6194
2021/01/10,07:00:00,180.07,2,6411,6413
2021/01/10,07:30:00,180.07,120,6676,6796
2021/01/10,08:00:00,180.07,331,6719,7050
2021/01/10,08:30:00,180.07,653,6739,7392
2021/01/10,09:00:00,180.07,913,6584,7497
2021/01/10,09:30:00,180.07,1151,6372,7523
2021/01/10,10:00:00,180.07,1293,6221,7514
2021/01/10,10:30:00,218.8,1369,6104,7473
2021/01/10,11:00:00,218.8,1436,6011,7447
2021/01/10,11:30:00,180.07,1468,6000,7468
2021/01/10,12:00:00,218.8,1472,6009,7481
2021/01/10,12:30:00,218.8,1462,6067,7529
2021/01/10,13:00:00,218.8,1428,6075,7503
2021/01/10,13:30:00,218.8,1355,6177,7532
2021/01/10,14:00:00,218.8,1248,6313,7561
2021/01/10,14:30:00,218.8,1076,6461,7537
2021/01/10,15:00:00,180.26,892,6641,7533
2021/01/10,15:30:00,179.88,634,6957,7591
2021/01/10,16:00:00,180.26,364,7118,7482
2021/01/10,16:30:00,179.88,136,7446,7582
2021/01/10,17:00:00,179.88,43,8017,8060
2021/01/10,17:30:00,231.15,1,8641,8642
2021/01/10,18:00:00,232.6,1,8848,8849
2021/01/10,18:30:00,232.6,1,8937,8938
2021/01/10,19:00:00,233.38,1,8946,8947
2021/01/10,19:30:00,231.15,1,8890,8891
2021/01/10,20:00:00,232.6,0,8833,8833
2021/01/10,20:30:00,231.86,1,8687,8688
2021/01/10,21:00:00,180.07,1,8504,8505
2021/01/10,21:30:00,179.88,1,8261,8262
2021/01/10,22:00:00,179.88,1,7921,7922
2021/01/10,22:30:00,179.88,1,7772,7773
2021/01/10,23:00:00,179.88,2,7396,7398
2021/01/10,23:30:00,179.88,1,6998,6999
2021/01/11,00:00:00,179.88,1,6630,6631
2021/01/11,00:30:00,179.88,2,6295,6297
2021/01/11,01:00:00,179.88,2,6004,6006
2021/01/11,01:30:00,179.88,2,5827,5829
2021/01/11,02:00:00,180.26,2,5662,5664
2021/01/11,02:30:00,179.88,1,5594,5595
2021/01/11,03:00:00,179.88,2,5516,5518
2021/01/11,03:30:00,179.88,2,5464,5466
2021/01/11,04:00:00,180.07,2,5522,5524
2021/01/11,04:30:00,179.88,2,5646,5648
2021/01/11,05:00:00,179.88,2,5785,5787
2021/01/11,05:30:00,179.88,2,6070,6072
2021/01/11,06:00:00,180.07,2,6172,6174
2021/01/11,06:30:00,180.07,3,6373,6376
2021/01/11,07:00:00,180.07,2,6563,6565
2021/01/11,07:30:00,179.7,158,6789,6947
2021/01/11,08:00:00,179.7,410,6796,7206
2021/01/11,08:30:00,228.43,716,6787,7503
2021/01/11,09:00:00,228.43,999,6543,7542
2021/01/11,09:30:00,228.43,1217,6363,7580
2021/01/11,10:00:00,218.8,1347,6255,7602
2021/01/11,10:30:00,218.8,1439,6130,7569
2021/01/11,11:00:00,180.07,1483,6084,7567
2021/01/11,11:30:00,179.88,1489,6003,7492
2021/01/11,12:00:00,218.8,1486,6002,7488
2021/01/11,12:30:00,218.8,1511,6031,7542
2021/01/11,13:00:00,218.8,1473,6053,7526
2021/01/11,13:30:00,218.8,1409,6145,7554
2021/01/11,14:00:00,218.8,1319,6212,7531
2021/01/11,14:30:00,218.8,1182,6336,7518
2021/01/11,15:00:00,218.8,990,6588,7578
2021/01/11,15:30:00,218.8,924,6802,7726
2021/01/11,16:00:00,218.8,436,6962,7398
2021/01/11,16:30:00,179.33,181,7343,7524
2021/01/11,17:00:00,178.81,112,7864,7976
2021/01/11,17:30:00,224.37,112,8387,8499
2021/01/11,18:00:00,224.97,111,8610,8721
2021/01/11,18:30:00,224.97,111,8698,8809
2021/01/11,19:00:00,224.97,111,8742,8853
2021/01/11,19:30:00,178.98,111,8719,8830
2021/01/11,20:00:00,178.98,111,8626,8737
2021/01/11,20:30:00,178.98,106,8492,8598
2021/01/11,21:00:00,178.98,0,8445,8445
2021/01/11,21:30:00,178.98,0,8185,8185
2021/01/11,22:00:00,178.64,0,7867,7867
2021/01/11,22:30:00,178.64,0,7685,7685
2021/01/11,23:00:00,178.64,0,7361,7361
2021/01/11,23:30:00,179.16,0,7001,7001
2021/01/12,00:00:00,178.64,0,6605,6605
2021/01/12,00:30:00,178.81,1,6281,6282
2021/01/12,01:00:00,178.64,0,6016,6016
2021/01/12,01:30:00,178.64,0,5828,5828
2021/01/12,02:00:00,178.81,0,5647,5647
2021/01/12,02:30:00,180.07,0,5564,5564
2021/01/12,03:00:00,181.05,1,5497,5498
2021/01/12,03:30:00,181.05,1,5456,5457
2021/01/12,04:00:00,181.05,0,5480,5480
2021/01/12,04:30:00,180.85,0,5617,5617
2021/01/12,05:00:00,181.25,0,5778,5778
2021/01/12,05:30:00,181.05,1,6058,6059
2021/01/12,06:00:00,180.85,1,6162,6163
2021/01/12,06:30:00,181.05,1,6391,6392
2021/01/12,07:00:00,180.85,1,6540,6541
2021/01/12,07:30:00,180.85,154,6718,6872
2021/01/12,08:00:00,179.51,414,6714,7128
2021/01/12,08:30:00,179.16,741,6680,7421
2021/01/12,09:00:00,179.88,1062,6490,7552
2021/01/12,09:30:00,179.7,1249,6272,7521
2021/01/12,10:00:00,179.7,1366,6193,7559
2021/01/12,10:30:00,179.7,1441,6142,7583
2021/01/12,11:00:00,179.7,1479,6038,7517
2021/01/12,11:30:00,179.51,1526,5970,7496
2021/01/12,12:00:00,179.7,1530,5982,7512
2021/01/12,12:30:00,179.7,1522,6009,7531
2021/01/12,13:00:00,179.7,1492,6055,7547
2021/01/12,13:30:00,179.7,1405,6190,7595
2021/01/12,14:00:00,179.7,1311,6272,7583
2021/01/12,14:30:00,179.51,1164,6374,7538
2021/01/12,15:00:00,179.7,921,6639,7560
2021/01/12,15:30:00,179.7,595,6962,7557
2021/01/12,16:00:00,179.7,312,7117,7429
2021/01/12,16:30:00,179.88,197,7391,7588
2021/01/12,17:00:00,179.88,111,7872,7983
2021/01/12,17:30:00,179.51,112,8310,8422
2021/01/12,18:00:00,179.88,111,8466,8577
2021/01/12,18:30:00,224.05,60,8570,8630
2021/01/12,19:00:00,224.05,0,8622,8622
2021/01/12,19:30:00,224.05,0,8580,8580
2021/01/12,20:00:00,179.51,0,8466,8466
2021/01/12,20:30:00,179.51,0,8347,8347
2021/01/12,21:00:00,179.51,0,8198,8198
2021/01/12,21:30:00,179.7,0,7910,7910
2021/01/12,22:00:00,179.7,1,7633,7634
2021/01/12,22:30:00,179.7,1,7516,7517
2021/01/12,23:00:00,179.7,1,7190,7191
2021/01/12,23:30:00,181.05,1,6857,6858
2021/01/13,00:00:00,181.05,1,6480,6481
2021/01/13,00:30:00,181.05,1,6201,6202
2021/01/13,01:00:00,181.05,1,5950,5951
2021/01/13,01:30:00,180.85,1,5749,5750
2021/01/13,02:00:00,181.05,1,5599,5600
2021/01/13,02:30:00,181.05,2,5482,5484
2021/01/13,03:00:00,181.05,2,5434,5436
2021/01/13,03:30:00,181.05,2,5418,5420
2021/01/13,04:00:00,181.05,1,5447,5448
2021/01/13,04:30:00,180.85,1,5561,5562
2021/01/13,05:00:00,180.65,1,5737,5738
2021/01/13,05:30:00,180.85,1,5979,5980
2021/01/13,06:00:00,180.85,1,6052,6053
2021/01/13,06:30:00,180.85,1,6214,6215
2021/01/13,07:00:00,180.85,2,6396,6398
2021/01/13,07:30:00,237.53,41,6698,6739
2021/01/13,08:00:00,236.86,96,6926,7022
2021/01/13,08:30:00,239.67,176,7252,7428
2021/01/13,09:00:00,238.37,283,7304,7587
2021/01/13,09:30:00,239,431,7197,7628
2021/01/13,10:00:00,239.67,486,7276,7762
2021/01/13,10:30:00,240.37,569,7206,7775
2021/01/13,11:00:00,180.85,645,7161,7806
2021/01/13,11:30:00,181.05,636,7223,7859
2021/01/13,12:00:00,180.45,599,7277,7876
2021/01/13,12:30:00,180.85,582,7253,7835
2021/01/13,13:00:00,180.65,493,7343,7836
2021/01/13,13:30:00,180.85,397,7496,7893
2021/01/13,14:00:00,236.86,306,7537,7843
2021/01/13,14:30:00,237.53,285,7584,7869
2021/01/13,15:00:00,237.53,204,7754,7958
2021/01/13,15:30:00,237.53,145,7871,8016
2021/01/13,16:00:00,237.53,78,7880,7958
2021/01/13,16:30:00,240.53,40,8070,8110
2021/01/13,17:00:00,237.53,9,8470,8479
2021/01/13,17:30:00,240.53,11,8847,8858
2021/01/13,18:00:00,240.53,11,8943,8954
2021/01/13,18:30:00,238.23,9,8993,9002
2021/01/13,19:00:00,240.53,9,8951,8960
2021/01/13,19:30:00,236.86,7,8868,8875
2021/01/13,20:00:00,237.53,9,8756,8765
2021/01/13,20:30:00,199.68,13,8568,8581
2021/01/13,21:00:00,179.7,10,8384,8394
2021/01/13,21:30:00,179.7,8,8155,8163
2021/01/13,22:00:00,179.7,4,7842,7846
2021/01/13,22:30:00,179.7,5,7636,7641
2021/01/13,23:00:00,179.7,10,7338,7348
2021/01/13,23:30:00,179.7,9,6987,6996
2021/01/14,00:00:00,179.7,6,6629,6635
2021/01/14,00:30:00,179.51,6,6310,6316
2021/01/14,01:00:00,179.7,6,6045,6051
2021/01/14,01:30:00,179.88,4,5822,5826
2021/01/14,02:00:00,179.7,5,5663,5668
2021/01/14,02:30:00,179.7,2,5584,5586
2021/01/14,03:00:00,179.7,0,5540,5540
2021/01/14,03:30:00,179.7,0,5503,5503
2021/01/14,04:00:00,179.7,0,5504,5504
2021/01/14,04:30:00,179.7,1,5624,5625
2021/01/14,05:00:00,192.2,0,5792,5792
2021/01/14,05:30:00,192.2,0,6027,6027
2021/01/14,06:00:00,191.97,2,6146,6148
2021/01/14,06:30:00,192.2,5,6361,6366
2021/01/14,07:00:00,191.97,6,6529,6535
2021/01/14,07:30:00,195.99,161,6805,6966
2021/01/14,08:00:00,196.39,401,6989,7390
2021/01/14,08:30:00,192.65,699,7069,7768
2021/01/14,09:00:00,196.39,977,6949,7926
2021/01/14,09:30:00,178.31,1169,6948,8117
2021/01/14,10:00:00,178.47,1254,6963,8217
2021/01/14,10:30:00,178.31,1319,7056,8375
2021/01/14,11:00:00,180.07,1446,7035,8481
2021/01/14,11:30:00,180.07,1408,7103,8511
2021/01/14,12:00:00,180.07,1338,7223,8561
2021/01/14,12:30:00,180.07,1397,7326,8723
2021/01/14,13:00:00,181.46,1334,7514,8848
2021/01/14,13:30:00,181.46,1248,7657,8905
2021/01/14,14:00:00,239.13,1070,7764,8834
2021/01/14,14:30:00,239.13,770,8032,8802
2021/01/14,15:00:00,239.13,503,8324,8827
2021/01/14,15:30:00,239.13,279,8523,8802
2021/01/14,16:00:00,239.13,218,8636,8854
2021/01/14,16:30:00,239.13,96,8992,9088
2021/01/14,17:00:00,239.13,19,9421,9440
2021/01/14,17:30:00,241.28,16,9811,9827
2021/01/14,18:00:00,241.28,13,10001,10014
2021/01/14,18:30:00,240.61,10,10045,10055
2021/01/14,19:00:00,241.28,6,9921,9927
2021/01/14,19:30:00,244.3,3,9787,9790
2021/01/14,20:00:00,241.28,3,9599,9602
2021/01/14,20:30:00,242.72,6,9399,9405
2021/01/14,21:00:00,240.72,7,9164,9171
2021/01/14,21:30:00,179.33,4,8916,8920
2021/01/14,22:00:00,179.33,6,8592,8598
2021/01/14,22:30:00,178.98,6,8351,8357
2021/01/14,23:00:00,182,6,8041,8047
2021/01/14,23:30:00,197.71,7,7616,7623
2021/01/15,00:00:00,179.7,8,7151,7159
2021/01/15,00:30:00,179.7,4,6767,6771
2021/01/15,01:00:00,179.7,10,6454,6464
2021/01/15,01:30:00,179.33,6,6195,6201
2021/01/15,02:00:00,179.7,4,6007,6011
2021/01/15,02:30:00,179.7,3,5851,5854
2021/01/15,03:00:00,179.88,1,5789,5790
2021/01/15,03:30:00,179.33,1,5713,5714
2021/01/15,04:00:00,179.7,2,5702,5704
2021/01/15,04:30:00,179.7,2,5809,5811
2021/01/15,05:00:00,179.7,4,5912,5916
2021/01/15,05:30:00,179.7,4,6054,6058
2021/01/15,06:00:00,179.7,2,6199,6201
2021/01/15,06:30:00,179.33,3,6249,6252
2021/01/15,07:00:00,179.7,2,6281,6283
2021/01/15,07:30:00,179.33,136,6514,6650
2021/01/15,08:00:00,179.33,228,6679,6907
2021/01/15,08:30:00,179.7,416,6831,7247
2021/01/15,09:00:00,179.7,576,6905,7481
2021/01/15,09:30:00,179.33,728,6950,7678
2021/01/15,10:00:00,179.33,725,7159,7884
2021/01/15,10:30:00,179.51,939,7253,8192
2021/01/15,11:00:00,179.7,1063,7348,8411
2021/01/15,11:30:00,179.7,1237,7419,8656
2021/01/15,12:00:00,266.32,1026,7663,8689
2021/01/15,12:30:00,264.92,983,7779,8762
2021/01/15,13:00:00,265.61,904,7974,8878
2021/01/15,13:30:00,266.32,939,8104,9043
2021/01/15,14:00:00,265.61,1085,8133,9218
2021/01/15,14:30:00,264.27,998,8200,9198
2021/01/15,15:00:00,263.72,936,8345,9281
2021/01/15,15:30:00,263.72,735,8582,9317
2021/01/15,16:00:00,264.48,472,8738,9210
2021/01/15,16:30:00,265.27,225,8800,9025
2021/01/15,17:00:00,263.01,58,8873,8931
2021/01/15,17:30:00,264.48,0,9211,9211
2021/01/15,18:00:00,267.88,1,9244,9245
2021/01/15,18:30:00,265.27,0,9196,9196
2021/01/15,19:00:00,265.27,1,8997,8998
2021/01/15,19:30:00,197.76,0,8771,8771
2021/01/15,20:00:00,197.76,0,8559,8559
2021/01/15,20:30:00,197.76,0,8479,8479
2021/01/15,21:00:00,197.76,0,8365,8365
2021/01/15,21:30:00,197.76,0,8221,8221
2021/01/15,22:00:00,203.41,0,7999,7999
2021/01/15,22:30:00,204.23,0,7780,7780
2021/01/15,23:00:00,203.81,0,7461,7461
2021/01/15,23:30:00,203.81,0,7188,7188
2021/01/16,00:00:00,179.7,0,6860,6860
2021/01/16,00:30:00,179.33,0,6569,6569
2021/01/16,01:00:00,179.33,0,6300,6300
2021/01/16,01:30:00,179.7,0,6093,6093
2021/01/16,02:00:00,179.7,0,5928,5928
2021/01/16,02:30:00,179.51,0,5792,5792
2021/01/16,03:00:00,179.7,0,5712,5712
2021/01/16,03:30:00,179.7,0,5659,5659
2021/01/16,04:00:00,179.51,0,5684,5684
2021/01/16,04:30:00,179.7,0,5732,5732
2021/01/16,05:00:00,179.7,0,5786,5786
2021/01/16,05:30:00,179.16,0,5956,5956
2021/01/16,06:00:00,179.7,0,6006,6006
2021/01/16,06:30:00,179.51,0,5999,5999
2021/01/16,07:00:00,179.51,0,5923,5923
2021/01/16,07:30:00,179.51,120,5999,6119
2021/01/16,08:00:00,179.7,212,6099,6311
2021/01/16,08:30:00,179.88,323,6221,6544
2021/01/16,09:00:00,232.33,474,6314,6788
2021/01/16,09:30:00,232.33,665,6345,7010
2021/01/16,10:00:00,233.01,803,6380,7183
2021/01/16,10:30:00,179.51,972,6312,7284
2021/01/16,11:00:00,179.7,1158,6243,7401
2021/01/16,11:30:00,179.7,1218,6303,7521
2021/01/16,12:00:00,179.7,1146,6467,7613
2021/01/16,12:30:00,233.01,1111,6542,7653
2021/01/16,13:00:00,234.48,1047,6577,7624
2021/01/16,13:30:00,233.01,1037,6595,7632
2021/01/16,14:00:00,179.88,879,6685,7564
2021/01/16,14:30:00,179.16,727,6846,7573
2021/01/16,15:00:00,178.98,643,6900,7543
2021/01/16,15:30:00,179.16,475,7149,7624
2021/01/16,16:00:00,178.98,354,7352,7706
2021/01/16,16:30:00,179.16,170,7763,7933
2021/01/16,17:00:00,179.87,17,8147,8164
2021/01/16,17:30:00,199.6,10,8779,8789
2021/01/16,18:00:00,200.38,3,9281,9284
2021/01/16,18:30:00,233.01,2,9575,9577
2021/01/16,19:00:00,234.48,1,9603,9604
2021/01/16,19:30:00,232.48,3,9582,9585
2021/01/16,20:00:00,232.33,2,9469,9471
2021/01/16,20:30:00,230.77,2,9369,9371
2021/01/16,21:00:00,230.09,2,9161,9163
2021/01/16,21:30:00,230.77,4,9039,9043
2021/01/16,22:00:00,230.77,5,8799,8804
2021/01/16,22:30:00,231.49,2,8512,8514
2021/01/16,23:00:00,179.16,3,8136,8139
2021/01/16,23:30:00,178.98,4,7706,7710
2021/01/17,00:00:00,188.19,4,7188,7192
2021/01/17,00:30:00,179.16,3,6751,6754
2021/01/17,01:00:00,178.98,2,6382,6384
2021/01/17,01:30:00,179.7,6,6097,6103
2021/01/17,02:00:00,179.88,9,5865,5874
2021/01/17,02:30:00,180.07,8,5727,5735
2021/01/17,03:00:00,179.7,6,5606,5612
2021/01/17,03:30:00,179.88,5,5614,5619
2021/01/17,04:00:00,179.51,6,5622,5628
2021/01/17,04:30:00,179.88,10,5730,5740
2021/01/17,05:00:00,179.7,10,5924,5934
2021/01/17,05:30:00,179.88,11,6219,6230
2021/01/17,06:00:00,179.88,11,6364,6375
2021/01/17,06:30:00,179.88,13,6680,6693
2021/01/17,07:00:00,179.88,13,7017,7030
2021/01/17,07:30:00,179.33,202,7362,7564
2021/01/17,08:00:00,179.16,480,7508,7988
2021/01/17,08:30:00,245.96,763,7641,8404
2021/01/17,09:00:00,248.36,996,7679,8675
2021/01/17,09:30:00,249.86,1161,7672,8833
2021/01/17,10:00:00,179.16,1196,7698,8894
2021/01/17,10:30:00,179.16,1158,7789,8947
2021/01/17,11:00:00,179.16,1012,7976,8988
2021/01/17,11:30:00,179.16,1026,8004,9030
2021/01/17,12:00:00,179.16,860,8209,9069
2021/01/17,12:30:00,185.52,839,8254,9093
2021/01/17,13:00:00,182.54,830,8283,9113
2021/01/17,13:30:00,213.31,750,8340,9090
2021/01/17,14:00:00,210.23,677,8363,9040
2021/01/17,14:30:00,213.31,586,8458,9044
2021/01/17,15:00:00,213.31,445,8672,9117
2021/01/17,15:30:00,213.31,288,8930,9218
2021/01/17,16:00:00,249.86,151,9107,9258
2021/01/17,16:30:00,249.86,72,9407,9479
2021/01/17,17:00:00,247.67,18,9960,9978
2021/01/17,17:30:00,247,14,10527,10541
2021/01/17,18:00:00,249.1,7,10859,10866
2021/01/17,18:30:00,248.36,15,10938,10953
2021/01/17,19:00:00,248.36,19,10934,10953
2021/01/17,19:30:00,249.86,15,10903,10918
2021/01/17,20:00:00,249.1,17,10746,10763
2021/01/17,20:30:00,249.1,18,10482,10500
2021/01/17,21:00:00,246.69,18,10216,10234
2021/01/17,21:30:00,246.69,14,9844,9858
2021/01/17,22:00:00,182.89,13,9398,9411
2021/01/17,22:30:00,189.47,13,9077,9090
2021/01/17,23:00:00,189.09,6,8584,8590
2021/01/17,23:30:00,189.09,10,8001,8011
2021/01/18,00:00:00,200.11,11,7455,7466
2021/01/18,00:30:00,179.7,9,6974,6983
2021/01/18,01:00:00,179.16,6,6597,6603
2021/01/18,01:30:00,179.33,3,6315,6318
2021/01/18,02:00:00,178.98,3,6097,6100
2021/01/18,02:30:00,179.7,8,5987,5995
2021/01/18,03:00:00,179.33,3,5897,5900
2021/01/18,03:30:00,178.98,1,5865,5866
2021/01/18,04:00:00,179.33,0,5901,5901
2021/01/18,04:30:00,178.98,5,6010,6015
2021/01/18,05:00:00,179.33,5,6222,6227
2021/01/18,05:30:00,179.16,6,6514,6520
2021/01/18,06:00:00,179.16,4,6688,6692
2021/01/18,06:30:00,179.16,3,7062,7065
2021/01/18,07:00:00,179.16,56,7415,7471
2021/01/18,07:30:00,178.98,167,7855,8022
2021/01/18,08:00:00,179.16,245,8240,8485
2021/01/18,08:30:00,258.76,383,8736,9119
2021/01/18,09:00:00,243.21,460,8972,9432
2021/01/18,09:30:00,243.72,568,9092,9660
2021/01/18,10:00:00,244.37,666,9113,9779
2021/01/18,10:30:00,263.88,882,9028,9910
2021/01/18,11:00:00,258.83,804,9000,9804
2021/01/18,11:30:00,193.38,875,8799,9674
2021/01/18,12:00:00,225.43,888,8856,9744
2021/01/18,12:30:00,224.94,896,8878,9774
2021/01/18,13:00:00,225.18,998,8934,9932
2021/01/18,13:30:00,225.18,850,9099,9949
2021/01/18,14:00:00,225.18,791,9180,9971
2021/01/18,14:30:00,225.18,659,9297,9956
2021/01/18,15:00:00,220.5,549,9434,9983
2021/01/18,15:30:00,218.92,457,9563,10020
2021/01/18,16:00:00,225.18,311,9606,9917
2021/01/18,16:30:00,225.18,141,9916,10057
2021/01/18,17:00:00,225.18,8,10413,10421
2021/01/18,17:30:00,225.18,4,10935,10939
2021/01/18,18:00:00,251.96,5,11183,11188
2021/01/18,18:30:00,262.29,5,11235,11240
2021/01/18,19:00:00,262.89,5,11240,11245
2021/01/18,19:30:00,263.06,2,11168,11170
2021/01/18,20:00:00,263.88,2,10997,10999
2021/01/18,20:30:00,263.83,4,10761,10765
2021/01/18,21:00:00,263.88,2,10559,10561
2021/01/18,21:30:00,263.06,3,10189,10192
2021/01/18,22:00:00,225.18,2,9769,9771
2021/01/18,22:30:00,225.18,3,9400,9403
2021/01/18,23:00:00,193.98,13,8871,8884
2021/01/18,23:30:00,199.33,13,8266,8279
2021/01/19,00:00:00,197.97,16,7692,7708
2021/01/19,00:30:00,179.16,18,7218,7236
2021/01/19,01:00:00,179.16,19,6812,6831
2021/01/19,01:30:00,179.16,17,6541,6558
2021/01/19,02:00:00,179.16,16,6344,6360
2021/01/19,02:30:00,179.33,18,6170,6188
2021/01/19,03:00:00,179.16,14,6097,6111
2021/01/19,03:30:00,179.16,17,6059,6076
2021/01/19,04:00:00,179.16,18,6059,6077
2021/01/19,04:30:00,179.16,18,6186,6204
2021/01/19,05:00:00,179.33,18,6383,6401
2021/01/19,05:30:00,179.16,18,6715,6733
2021/01/19,06:00:00,179.33,18,6937,6955
2021/01/19,06:30:00,178.98,17,7276,7293
2021/01/19,07:00:00,198.82,19,7631,7650
2021/01/19,07:30:00,199.22,229,7897,8126
2021/01/19,08:00:00,198.82,489,8145,8634
2021/01/19,08:30:00,192.84,819,8316,9135
2021/01/19,09:00:00,192.84,1109,8385,9494
2021/01/19,09:30:00,192.84,1308,8375,9683
2021/01/19,10:00:00,192.84,1489,8306,9795
2021/01/19,10:30:00,192.84,1603,8270,9873
2021/01/19,11:00:00,192.92,1634,8359,9993
2021/01/19,11:30:00,192.77,1675,8393,10068
2021/01/19,12:00:00,258.97,1674,8664,10338
2021/01/19,12:30:00,256.76,1466,8826,10292
2021/01/19,13:00:00,256.09,1133,9235,10368
2021/01/19,13:30:00,261.5,737,9681,10418
2021/01/19,14:00:00,259.29,686,9750,10436
2021/01/19,14:30:00,259.29,658,9892,10550
2021/01/19,15:00:00,258.63,733,9972,10705
2021/01/19,15:30:00,259.99,534,10153,10687
2021/01/19,16:00:00,258.2,289,10242,10531
2021/01/19,16:30:00,256.09,119,10588,10707
2021/01/19,17:00:00,257.46,4,11026,11030
2021/01/19,17:30:00,259.29,3,11461,11464
2021/01/19,18:00:00,259.46,1,11630,11631
2021/01/19,18:30:00,259.99,2,11698,11700
2021/01/19,19:00:00,259.46,1,11672,11673
2021/01/19,19:30:00,260.16,1,11578,11579
2021/01/19,20:00:00,260.73,0,11443,11443
2021/01/19,20:30:00,260.16,7,11218,11225
2021/01/19,21:00:00,260.16,7,10915,10922
2021/01/19,21:30:00,260.16,2,10551,10553
2021/01/19,22:00:00,260.9,1,10103,10104
2021/01/19,22:30:00,223.98,5,9743,9748
2021/01/19,23:00:00,193.08,3,9167,9170
2021/01/19,23:30:00,199.43,3,8536,8539
2021/01/20,00:00:00,179.81,2,7910,7912
2021/01/20,00:30:00,180,3,7373,7376
2021/01/20,01:00:00,180,2,6969,6971
2021/01/20,01:30:00,180,2,6674,6676
2021/01/20,02:00:00,180,1,6482,6483
2021/01/20,02:30:00,180,1,6351,6352
2021/01/20,03:00:00,180,1,6199,6200
2021/01/20,03:30:00,180,4,6175,6179
2021/01/20,04:00:00,180,11,6213,6224
2021/01/20,04:30:00,180,10,6326,6336
2021/01/20,05:00:00,180.8,8,6492,6500
2021/01/20,05:30:00,179.81,9,6809,6818
2021/01/20,06:00:00,180.59,6,7002,7008
2021/01/20,06:30:00,180.59,10,7392,7402
2021/01/20,07:00:00,180.39,9,7800,7809
2021/01/20,07:30:00,180.39,70,8413,8483
2021/01/20,08:00:00,180.39,147,8838,8985
2021/01/20,08:30:00,180.39,263,9218,9481
2021/01/20,09:00:00,220.77,360,9332,9692
2021/01/20,09:30:00,220.13,687,9333,10020
2021/01/20,10:00:00,217.01,414,9861,10275
2021/01/20,10:30:00,209.92,615,10022,10637
2021/01/20,11:00:00,220.92,671,9766,10437
2021/01/20,11:30:00,219.66,753,10020,10773
2021/01/20,12:00:00,219.66,1160,9729,10889
2021/01/20,12:30:00,219.66,694,9882,10576
2021/01/20,13:00:00,220.13,714,9983,10697
2021/01/20,13:30:00,220.92,761,9975,10736
2021/01/20,14:00:00,220.27,804,9835,10639
2021/01/20,14:30:00,220.77,780,9887,10667
2021/01/20,15:00:00,219.66,604,10034,10638
2021/01/20,15:30:00,220.77,509,10261,10770
2021/01/20,16:00:00,219.66,269,10411,10680
2021/01/20,16:30:00,219.07,110,10669,10779
2021/01/20,17:00:00,218.52,4,11155,11159
2021/01/20,17:30:00,219.07,3,11737,11740
2021/01/20,18:00:00,219.66,1,11988,11989
2021/01/20,18:30:00,219.66,1,12165,12166
2021/01/20,19:00:00,219.66,2,12087,12089
2021/01/20,19:30:00,219.07,3,12080,12083
2021/01/20,20:00:00,219.07,0,11935,11935
2021/01/20,20:30:00,219.66,0,11697,11697
2021/01/20,21:00:00,220.27,0,11435,11435
2021/01/20,21:30:00,219.66,1,11009,11010
2021/01/20,22:00:00,219.66,2,10563,10565
2021/01/20,22:30:00,219.07,3,10183,10186
2021/01/20,23:00:00,220.27,1,9608,9609
2021/01/20,23:30:00,180.8,5,8974,8979
2021/01/21,00:00:00,217.89,3,8266,8269
2021/01/21,00:30:00,217.89,2,7733,7735
2021/01/21,01:00:00,217.89,1,7257,7258
2021/01/21,01:30:00,217.89,1,6937,6938
2021/01/21,02:00:00,217.89,0,6673,6673
2021/01/21,02:30:00,217.89,0,6511,6511
2021/01/21,03:00:00,217.89,0,6420,6420
2021/01/21,03:30:00,217.89,0,6373,6373
2021/01/21,04:00:00,217.89,0,6372,6372
2021/01/21,04:30:00,217.64,0,6516,6516
2021/01/21,05:00:00,218.14,0,6684,6684
2021/01/21,05:30:00,218.14,0,7017,7017
2021/01/21,06:00:00,218.14,0,7226,7226
2021/01/21,06:30:00,218.14,0,7593,7593
2021/01/21,07:00:00,218.14,24,7991,8015
2021/01/21,07:30:00,217.64,181,8406,8587
2021/01/21,08:00:00,217.89,429,8495,8924
2021/01/21,08:30:00,217.89,741,8651,9392
2021/01/21,09:00:00,217.89,878,8594,9472
2021/01/21,09:30:00,217.89,1186,8280,9466
2021/01/21,10:00:00,217.89,1359,8151,9510
2021/01/21,10:30:00,217.89,1508,7962,9470
2021/01/21,11:00:00,218.14,1657,7774,9431
2021/01/21,11:30:00,217.64,1723,7642,9365
2021/01/21,12:00:00,218.14,1765,7550,9315
2021/01/21,12:30:00,218.14,1773,7546,9319
2021/01/21,13:00:00,217.64,1742,7552,9294
2021/01/21,13:30:00,218.14,1693,7553,9246
2021/01/21,14:00:00,217.64,1585,7564,9149
2021/01/21,14:30:00,217.64,1474,7684,9158
2021/01/21,15:00:00,217.64,1291,7907,9198
2021/01/21,15:30:00,218.4,1004,8319,9323
2021/01/21,16:00:00,217.89,655,8651,9306
2021/01/21,16:30:00,241.37,315,9200,9515
2021/01/21,17:00:00,264.27,132,9913,10045
2021/01/21,17:30:00,260.72,0,10991,10991
2021/01/21,18:00:00,261.53,0,11429,11429
2021/01/21,18:30:00,264.44,0,11660,11660
2021/01/21,19:00:00,262.21,0,11756,11756
2021/01/21,19:30:00,262.21,0,11761,11761
2021/01/21,20:00:00,262.92,0,11631,11631
2021/01/21,20:30:00,262.92,0,11510,11510
2021/01/21,21:00:00,262.21,0,11263,11263
2021/01/21,21:30:00,262.92,0,10987,10987
2021/01/21,22:00:00,262.21,0,10565,10565
2021/01/21,22:30:00,263.66,1,10302,10303
2021/01/21,23:00:00,264.44,2,9820,9822
2021/01/21,23:30:00,246.58,1,9197,9198
2021/01/22,00:00:00,203.31,2,8549,8551
2021/01/22,00:30:00,208.89,3,8014,8017
2021/01/22,01:00:00,180.05,2,7514,7516
2021/01/22,01:30:00,179.88,3,7136,7139
2021/01/22,02:00:00,180.07,3,6855,6858
2021/01/22,02:30:00,180.07,3,6644,6647
2021/01/22,03:00:00,180.07,4,6499,6503
2021/01/22,03:30:00,180.07,3,6411,6414
2021/01/22,04:00:00,180.07,4,6387,6391
2021/01/22,04:30:00,179.88,5,6437,6442
2021/01/22,05:00:00,179.88,5,6602,6607
2021/01/22,05:30:00,179.88,7,6805,6812
2021/01/22,06:00:00,179.88,5,6970,6975
2021/01/22,06:30:00,180.07,6,7126,7132
2021/01/22,07:00:00,180.05,41,7210,7251
2021/01/22,07:30:00,180.48,243,7383,7626
2021/01/22,08:00:00,180.48,528,7373,7901
2021/01/22,08:30:00,180.89,936,7322,8258
2021/01/22,09:00:00,202.62,1250,7185,8435
2021/01/22,09:30:00,180.89,1490,7144,8634
2021/01/22,10:00:00,181.66,1617,7127,8744
2021/01/22,10:30:00,202.47,1702,7216,8918
2021/01/22,11:00:00,181.28,1751,7203,8954
2021/01/22,11:30:00,182.02,1774,7193,8967
2021/01/22,12:00:00,212.15,1785,7119,8904
2021/01/22,12:30:00,202.47,1776,7191,8967
2021/01/22,13:00:00,202.62,1734,7207,8941
2021/01/22,13:30:00,182.37,1664,7241,8905
2021/01/22,14:00:00,209.5,1584,7376,8960
2021/01/22,14:30:00,209.91,1452,7564,9016
2021/01/22,15:00:00,209.91,1261,7870,9131
2021/01/22,15:30:00,203.47,1005,8396,9401
2021/01/22,16:00:00,274.56,657,8883,9540
2021/01/22,16:30:00,274.56,320,9398,9718
2021/01/22,17:00:00,273.05,59,9768,9827
2021/01/22,17:30:00,264.31,35,10425,10460
2021/01/22,18:00:00,270.04,6,10721,10727
2021/01/22,18:30:00,271.21,6,10747,10753
2021/01/22,19:00:00,271.21,7,10608,10615
2021/01/22,19:30:00,270.61,6,10394,10400
2021/01/22,20:00:00,270.61,8,10211,10219
2021/01/22,20:30:00,266.13,7,10102,10109
2021/01/22,21:00:00,267.61,5,9960,9965
2021/01/22,21:30:00,270.04,6,9748,9754
2021/01/22,22:00:00,264.27,7,9457,9464
2021/01/22,22:30:00,263.69,6,9155,9161
2021/01/22,23:00:00,271.21,5,8707,8712
2021/01/22,23:30:00,203.87,6,8262,8268
2021/01/23,00:00:00,193.89,5,7853,7858
2021/01/23,00:30:00,193.7,6,7408,7414
2021/01/23,01:00:00,193.15,6,7064,7070
2021/01/23,01:30:00,193.15,7,6803,6810
2021/01/23,02:00:00,180.07,7,6560,6567
2021/01/23,02:30:00,180.07,6,6435,6441
2021/01/23,03:00:00,180.07,5,6302,6307
2021/01/23,03:30:00,180.07,5,6235,6240
2021/01/23,04:00:00,180.07,7,6217,6224
2021/01/23,04:30:00,180.07,7,6261,6268
2021/01/23,05:00:00,179.7,4,6358,6362
2021/01/23,05:30:00,180.07,4,6481,6485
2021/01/23,06:00:00,193.15,6,6576,6582
2021/01/23,06:30:00,193.37,6,6569,6575
2021/01/23,07:00:00,193.37,41,6531,6572
2021/01/23,07:30:00,179.7,249,6529,6778
2021/01/23,08:00:00,179.88,602,6411,7013
2021/01/23,08:30:00,180.07,992,6307,7299
2021/01/23,09:00:00,180.07,1280,6267,7547
2021/01/23,09:30:00,179.88,1476,6276,7752
2021/01/23,10:00:00,179.88,1610,6325,7935
2021/01/23,10:30:00,179.88,1702,6292,7994
2021/01/23,11:00:00,179.88,1753,6237,7990
2021/01/23,11:30:00,179.88,1775,6185,7960
2021/01/23,12:00:00,179.88,1765,6106,7871
2021/01/23,12:30:00,179.88,1750,6061,7811
2021/01/23,13:00:00,180.07,1719,6036,7755
2021/01/23,13:30:00,180.07,1662,6044,7706
2021/01/23,14:00:00,192.09,1576,6087,7663
2021/01/23,14:30:00,193.51,1477,6198,7675
2021/01/23,15:00:00,193.7,1311,6422,7733
2021/01/23,15:30:00,193.32,1047,6845,7892
2021/01/23,16:00:00,187.17,716,7358,8074
2021/01/23,16:30:00,192.68,374,7979,8353
2021/01/23,17:00:00,187.06,108,8578,8686
2021/01/23,17:30:00,254.39,109,9456,9565
2021/01/23,18:00:00,253.67,110,10119,10229
2021/01/23,18:30:00,242.28,110,10542,10652
2021/01/23,19:00:00,241.68,110,10721,10831
2021/01/23,19:30:00,243.31,109,10743,10852
2021/01/23,20:00:00,244.39,88,10745,10833
2021/01/23,20:30:00,242.71,41,10698,10739
2021/01/23,21:00:00,244.55,4,10511,10515
2021/01/23,21:30:00,244.58,6,10337,10343
2021/01/23,22:00:00,244.55,6,10049,10055
2021/01/23,22:30:00,246.6,6,9688,9694
2021/01/23,23:00:00,253.67,7,9171,9178
2021/01/23,23:30:00,236.09,9,8608,8617
2021/01/24,00:00:00,268.08,8,7983,7991
2021/01/24,00:30:00,205.84,7,7469,7476
2021/01/24,01:00:00,212.25,8,6982,6990
2021/01/24,01:30:00,210.06,7,6673,6680
2021/01/24,02:00:00,202.31,7,6383,6390
2021/01/24,02:30:00,202.47,6,6233,6239
2021/01/24,03:00:00,202.47,5,6131,6136
2021/01/24,03:30:00,202.62,4,6046,6050
2021/01/24,04:00:00,202.47,4,6070,6074
2021/01/24,04:30:00,202.47,2,6165,6167
2021/01/24,05:00:00,179.7,4,6396,6400
2021/01/24,05:30:00,179.7,2,6729,6731
2021/01/24,06:00:00,179.7,2,6928,6930
2021/01/24,06:30:00,179.7,2,7297,7299
2021/01/24,07:00:00,179.7,5,7676,7681
2021/01/24,07:30:00,179.7,211,7997,8208
2021/01/24,08:00:00,179.51,541,8056,8597
2021/01/24,08:30:00,268.63,908,8076,8984
2021/01/24,09:00:00,268.8,1242,7853,9095
2021/01/24,09:30:00,268.8,1407,7753,9160
2021/01/24,10:00:00,268.8,1562,7572,9134
2021/01/24,10:30:00,198.74,1674,7392,9066
2021/01/24,11:00:00,198.42,1732,7255,8987
2021/01/24,11:30:00,198.65,1763,7150,8913
2021/01/24,12:00:00,198.65,1781,7060,8841
2021/01/24,12:30:00,204.76,1720,7110,8830
2021/01/24,13:00:00,205.84,1643,7120,8763
2021/01/24,13:30:00,205.84,1534,7181,8715
2021/01/24,14:00:00,206.05,1458,7225,8683
2021/01/24,14:30:00,206.05,1330,7284,8614
2021/01/24,15:00:00,205.84,1164,7489,8653
2021/01/24,15:30:00,231.45,892,7827,8719
2021/01/24,16:00:00,228.09,575,8189,8764
2021/01/24,16:30:00,233.14,263,8718,8981
2021/01/24,17:00:00,232.83,342,9432,9774
2021/01/24,17:30:00,259.52,0,10391,10391
2021/01/24,18:00:00,256.39,0,10911,10911
2021/01/24,18:30:00,258.4,0,11166,11166
2021/01/24,19:00:00,259.3,0,11304,11304
2021/01/24,19:30:00,268.08,0,11313,11313
2021/01/24,20:00:00,269.39,0,11243,11243
2021/01/24,20:30:00,269.56,0,11085,11085
2021/01/24,21:00:00,268.08,0,10871,10871
2021/01/24,21:30:00,268.08,0,10549,10549
2021/01/24,22:00:00,267.21,0,10129,10129
2021/01/24,22:30:00,225.34,1,9776,9777
2021/01/24,23:00:00,204.76,0,9187,9187
2021/01/24,23:30:00,204.76,1,8541,8542
2021/01/25,00:00:00,178.98,2,7944,7946
2021/01/25,00:30:00,180.07,2,7355,7357
2021/01/25,01:00:00,180.07,3,6979,6982
2021/01/25,01:30:00,180.07,2,6637,6639
2021/01/25,02:00:00,179.88,2,6430,6432
2021/01/25,02:30:00,180.07,1,6244,6245
2021/01/25,03:00:00,179.88,1,6188,6189
2021/01/25,03:30:00,180.07,2,6120,6122
2021/01/25,04:00:00,180.07,2,6155,6157
2021/01/25,04:30:00,180.07,3,6299,6302
2021/01/25,05:00:00,197.96,3,6495,6498
2021/01/25,05:30:00,180.07,4,6836,6840
2021/01/25,06:00:00,180.26,3,7055,7058
2021/01/25,06:30:00,209.07,3,7376,7379
2021/01/25,07:00:00,199.34,6,7691,7697
2021/01/25,07:30:00,179.88,204,7995,8199
2021/01/25,08:00:00,180.07,490,8070,8560
2021/01/25,08:30:00,180.07,817,8071,8888
2021/01/25,09:00:00,180.07,1123,7863,8986
2021/01/25,09:30:00,179.88,1329,7700,9029
2021/01/25,10:00:00,179.88,1444,7503,8947
2021/01/25,10:30:00,180.07,1528,7362,8890
2021/01/25,11:00:00,180.07,1585,7249,8834
2021/01/25,11:30:00,180.07,1580,7317,8897
2021/01/25,12:00:00,180.26,1567,7313,8880
2021/01/25,12:30:00,180.07,1594,7230,8824
2021/01/25,13:00:00,180.07,1570,7111,8681
2021/01/25,13:30:00,179.88,1511,7138,8649
2021/01/25,14:00:00,180.07,1412,7292,8704
2021/01/25,14:30:00,179.88,1283,7391,8674
2021/01/25,15:00:00,180.07,1123,7531,8654
2021/01/25,15:30:00,180.26,841,7890,8731
2021/01/25,16:00:00,180.07,520,8173,8693
2021/01/25,16:30:00,193.09,240,8659,8899
2021/01/25,17:00:00,193.09,412,9395,9807
2021/01/25,17:30:00,242.38,1,10302,10303
2021/01/25,18:00:00,239.85,3,10865,10868
2021/01/25,18:30:00,238.63,2,11132,11134
2021/01/25,19:00:00,242.38,2,11213,11215
2021/01/25,19:30:00,225.24,2,11285,11287
2021/01/25,20:00:00,242.38,2,11210,11212
2021/01/25,20:30:00,232.5,0,11019,11019
2021/01/25,21:00:00,226.27,0,10814,10814
2021/01/25,21:30:00,226.41,0,10425,10425
2021/01/25,22:00:00,225.06,0,10028,10028
2021/01/25,22:30:00,226.41,0,9672,9672
2021/01/25,23:00:00,225.72,0,9113,9113
2021/01/25,23:30:00,227.89,0,8491,8491
2021/01/26,00:00:00,180.07,0,7869,7869
2021/01/26,00:30:00,180.07,0,7288,7288
2021/01/26,01:00:00,180.07,0,6940,6940
2021/01/26,01:30:00,179.88,0,6633,6633
2021/01/26,02:00:00,179.88,0,6396,6396
2021/01/26,02:30:00,179.88,0,6259,6259
2021/01/26,03:00:00,180.07,0,6168,6168
2021/01/26,03:30:00,180.07,0,6104,6104
2021/01/26,04:00:00,179.88,0,6141,6141
2021/01/26,04:30:00,179.88,0,6289,6289
2021/01/26,05:00:00,180.26,0,6463,6463
2021/01/26,05:30:00,179.88,0,6800,6800
2021/01/26,06:00:00,180.07,0,6981,6981
2021/01/26,06:30:00,180.07,0,7369,7369
2021/01/26,07:00:00,204.7,45,7669,7714
2021/01/26,07:30:00,225.99,228,7960,8188
2021/01/26,08:00:00,223.07,552,7991,8543
2021/01/26,08:30:00,224.46,910,7939,8849
2021/01/26,09:00:00,223.07,1025,7905,8930
2021/01/26,09:30:00,223.75,1149,7808,8957
2021/01/26,10:00:00,223.75,1193,7725,8918
2021/01/26,10:30:00,179.88,1391,7498,8889
2021/01/26,11:00:00,178.81,1447,7377,8824
2021/01/26,11:30:00,178.81,1493,7296,8789
2021/01/26,12:00:00,179.88,1430,7353,8783
2021/01/26,12:30:00,180.07,1439,7259,8698
2021/01/26,13:00:00,180.07,1279,7315,8594
2021/01/26,13:30:00,179.88,1213,7516,8729
2021/01/26,14:00:00,180.26,939,7652,8591
2021/01/26,14:30:00,180.26,892,7762,8654
2021/01/26,15:00:00,180.07,885,7844,8729
2021/01/26,15:30:00,177.67,749,8117,8866
2021/01/26,16:00:00,180.07,557,8303,8860
2021/01/26,16:30:00,180.07,272,8731,9003
2021/01/26,17:00:00,217.12,2,9860,9862
2021/01/26,17:30:00,221.8,3,10278,10281
2021/01/26,18:00:00,223.21,3,10702,10705
2021/01/26,18:30:00,221.94,3,10954,10957
2021/01/26,19:00:00,222.56,5,11045,11050
2021/01/26,19:30:00,223.21,5,11062,11067
2021/01/26,20:00:00,222.56,4,10977,10981
2021/01/26,20:30:00,223.21,5,10838,10843
2021/01/26,21:00:00,223.89,4,10613,10617
2021/01/26,21:30:00,224.61,2,10262,10264
2021/01/26,22:00:00,233.71,5,9811,9816
2021/01/26,22:30:00,179.51,3,9494,9497
2021/01/26,23:00:00,179.7,3,8957,8960
2021/01/26,23:30:00,179.51,4,8339,8343
2021/01/27,00:00:00,180.07,4,7758,7762
2021/01/27,00:30:00,180.07,4,7238,7242
2021/01/27,01:00:00,180.07,5,6842,6847
2021/01/27,01:30:00,180.07,5,6552,6557
2021/01/27,02:00:00,180.07,5,6334,6339
2021/01/27,02:30:00,180.07,4,6189,6193
2021/01/27,03:00:00,180.07,3,6111,6114
2021/01/27,03:30:00,180.07,4,6056,6060
2021/01/27,04:00:00,180.07,3,6068,6071
2021/01/27,04:30:00,180.07,3,6196,6199
2021/01/27,05:00:00,180.07,2,6369,6371
2021/01/27,05:30:00,180.07,2,6682,6684
2021/01/27,06:00:00,180.07,3,6857,6860
2021/01/27,06:30:00,180.07,2,7112,7114
2021/01/27,07:00:00,180.07,5,7433,7438
2021/01/27,07:30:00,180.07,233,7649,7882
2021/01/27,08:00:00,180.07,362,7824,8186
2021/01/27,08:30:00,218.93,467,8035,8502
2021/01/27,09:00:00,217.35,665,8043,8708
2021/01/27,09:30:00,218.93,934,7878,8812
2021/01/27,10:00:00,217.41,1065,7707,8772
2021/01/27,10:30:00,177.67,1207,7525,8732
2021/01/27,11:00:00,177.52,1372,7327,8699
2021/01/27,11:30:00,180.07,1491,7163,8654
2021/01/27,12:00:00,180.26,1577,7091,8668
2021/01/27,12:30:00,180.07,1563,7012,8575
2021/01/27,13:00:00,180.07,1512,7043,8555
2021/01/27,13:30:00,179.88,1353,7208,8561
2021/01/27,14:00:00,179.88,1295,7208,8503
2021/01/27,14:30:00,180.07,1087,7444,8531
2021/01/27,15:00:00,180.26,836,7718,8554
2021/01/27,15:30:00,180.07,667,7950,8617
2021/01/27,16:00:00,179.88,370,8384,8754
2021/01/27,16:30:00,173.32,179,8703,8882
2021/01/27,17:00:00,213.72,100,9210,9310
2021/01/27,17:30:00,217.56,3,9955,9958
2021/01/27,18:00:00,218.31,4,10316,10320
2021/01/27,18:30:00,216.11,6,10470,10476
2021/01/27,19:00:00,216.98,6,10544,10550
2021/01/27,19:30:00,216.9,7,10507,10514
2021/01/27,20:00:00,219.52,6,10398,10404
2021/01/27,20:30:00,219.52,1,10280,10281
2021/01/27,21:00:00,220.13,2,10086,10088
2021/01/27,21:30:00,183.22,1,9804,9805
2021/01/27,22:00:00,179.88,3,9406,9409
2021/01/27,22:30:00,180.8,3,9120,9123
2021/01/27,23:00:00,180.8,4,8680,8684
2021/01/27,23:30:00,180.8,4,8124,8128
2021/01/28,00:00:00,179.88,4,7604,7608
2021/01/28,00:30:00,179.88,5,7122,7127
2021/01/28,01:00:00,180.07,5,6707,6712
2021/01/28,01:30:00,179.88,7,6426,6433
2021/01/28,02:00:00,180.07,3,6220,6223
2021/01/28,02:30:00,180.07,2,6112,6114
2021/01/28,03:00:00,179.88,3,6018,6021
2021/01/28,03:30:00,179.88,1,5943,5944
2021/01/28,04:00:00,179.88,1,5990,5991
2021/01/28,04:30:00,180.07,1,6074,6075
2021/01/28,05:00:00,180.26,1,6306,6307
2021/01/28,05:30:00,180.07,1,6582,6583
2021/01/28,06:00:00,179.88,2,6754,6756
2021/01/28,06:30:00,180.07,1,7010,7011
2021/01/28,07:00:00,179.88,1,7254,7255
2021/01/28,07:30:00,180.07,100,7697,7797
2021/01/28,08:00:00,179.16,228,7947,8175
2021/01/28,08:30:00,195.35,396,8121,8517
2021/01/28,09:00:00,195.27,663,8091,8754
2021/01/28,09:30:00,202.29,891,7929,8820
2021/01/28,10:00:00,202.09,1017,7890,8907
2021/01/28,10:30:00,202.09,1145,7787,8932
2021/01/28,11:00:00,202.29,1141,7894,9035
2021/01/28,11:30:00,202.5,1104,8035,9139
2021/01/28,12:00:00,202.5,1288,8152,9440
2021/01/28,12:30:00,202.7,1220,8332,9552
2021/01/28,13:00:00,202.09,1173,8470,9643
2021/01/28,13:30:00,202.5,1099,8703,9802
2021/01/28,14:00:00,196.29,1000,8844,9844
2021/01/28,14:30:00,264.17,1077,8818,9895
2021/01/28,15:00:00,263.35,857,8969,9826
2021/01/28,15:30:00,260.43,776,9186,9962
2021/01/28,16:00:00,265.32,527,9347,9874
2021/01/28,16:30:00,264.57,302,9604,9906
2021/01/28,17:00:00,264.57,2,10631,10633
2021/01/28,17:30:00,263.86,1,10671,10672
2021/01/28,18:00:00,264.57,1,10980,10981
2021/01/28,18:30:00,265.93,1,11050,11051
2021/01/28,19:00:00,266.1,2,11066,11068
2021/01/28,19:30:00,265.93,6,11020,11026
2021/01/28,20:00:00,266.1,4,10928,10932
2021/01/28,20:30:00,266.1,4,10746,10750
2021/01/28,21:00:00,266.1,0,10544,10544
2021/01/28,21:30:00,265.15,0,10204,10204
2021/01/28,22:00:00,266.75,0,9766,9766
2021/01/28,22:30:00,265.93,0,9533,9533
2021/01/28,23:00:00,264.4,2,9084,9086
2021/01/28,23:30:00,201.51,2,8520,8522
2021/01/29,00:00:00,191.4,3,8018,8021
2021/01/29,00:30:00,179.88,5,7495,7500
2021/01/29,01:00:00,178.64,3,7105,7108
2021/01/29,01:30:00,179.88,3,6786,6789
2021/01/29,02:00:00,180.07,4,6498,6502
2021/01/29,02:30:00,179.88,5,6308,6313
2021/01/29,03:00:00,179.88,5,6190,6195
2021/01/29,03:30:00,179.7,13,6130,6143
2021/01/29,04:00:00,180.07,16,6146,6162
2021/01/29,04:30:00,180.07,12,6224,6236
2021/01/29,05:00:00,179.7,11,6359,6370
2021/01/29,05:30:00,196.89,16,6553,6569
2021/01/29,06:00:00,196.89,17,6710,6727
2021/01/29,06:30:00,185.5,19,6813,6832
2021/01/29,07:00:00,184.77,18,7004,7022
2021/01/29,07:30:00,184.77,63,7447,7510
2021/01/29,08:00:00,209.22,131,7907,8038
2021/01/29,08:30:00,250.59,229,8434,8663
2021/01/29,09:00:00,248.09,335,8899,9234
2021/01/29,09:30:00,250.59,321,9304,9625
2021/01/29,10:00:00,252.98,456,9352,9808
2021/01/29,10:30:00,252.86,746,9392,10138
2021/01/29,11:00:00,251.55,558,9663,10221
2021/01/29,11:30:00,251.55,583,9657,10240
2021/01/29,12:00:00,252.86,544,9775,10319
2021/01/29,12:30:00,252.19,936,9507,10443
2021/01/29,13:00:00,254.31,1083,9410,10493
2021/01/29,13:30:00,252.86,922,9358,10280
2021/01/29,14:00:00,251.55,709,9602,10311
2021/01/29,14:30:00,252.19,568,9780,10348
2021/01/29,15:00:00,252.19,569,9844,10413
2021/01/29,15:30:00,252.86,375,10152,10527
2021/01/29,16:00:00,252.19,341,10230,10571
2021/01/29,16:30:00,252.86,190,10465,10655
2021/01/29,17:00:00,252.86,152,10458,10610
2021/01/29,17:30:00,253.57,2,10814,10816
2021/01/29,18:00:00,253.57,2,10882,10884
2021/01/29,18:30:00,253.57,1,10812,10813
2021/01/29,19:00:00,254.31,4,10604,10608
2021/01/29,19:30:00,254.31,5,10328,10333
2021/01/29,20:00:00,254.31,3,10068,10071
2021/01/29,20:30:00,254.31,16,9959,9975
2021/01/29,21:00:00,254.31,14,9757,9771
2021/01/29,21:30:00,253.57,3,9540,9543
2021/01/29,22:00:00,254.31,4,9244,9248
2021/01/29,22:30:00,253.57,8,9000,9008
2021/01/29,23:00:00,254.31,3,8585,8588
2021/01/29,23:30:00,188.06,2,8147,8149
2021/01/30,00:00:00,187.84,3,7759,7762
2021/01/30,00:30:00,187.84,7,7356,7363
2021/01/30,01:00:00,180.07,3,7027,7030
2021/01/30,01:30:00,180.07,12,6749,6761
2021/01/30,02:00:00,179.7,5,6526,6531
2021/01/30,02:30:00,180.07,5,6418,6423
2021/01/30,03:00:00,180.07,5,6286,6291
2021/01/30,03:30:00,180.07,9,6215,6224
2021/01/30,04:00:00,179.7,6,6205,6211
2021/01/30,04:30:00,179.7,7,6203,6210
2021/01/30,05:00:00,179.7,5,6336,6341
2021/01/30,05:30:00,179.7,5,6504,6509
2021/01/30,06:00:00,179.88,2,6557,6559
2021/01/30,06:30:00,179.7,1,6555,6556
2021/01/30,07:00:00,179.7,46,6576,6622
2021/01/30,07:30:00,179.88,166,6687,6853
2021/01/30,08:00:00,179.88,380,6761,7141
2021/01/30,08:30:00,179.88,677,6867,7544
2021/01/30,09:00:00,203.84,819,7190,8009
2021/01/30,09:30:00,223.06,1073,7405,8478
2021/01/30,10:00:00,223.06,1341,7651,8992
2021/01/30,10:30:00,223.19,1435,7840,9275
2021/01/30,11:00:00,223.19,1570,7932,9502
2021/01/30,11:30:00,223.06,1578,8099,9677
2021/01/30,12:00:00,223.06,1496,8176,9672
2021/01/30,12:30:00,206.98,1473,8125,9598
2021/01/30,13:00:00,179.7,1505,7997,9502
2021/01/30,13:30:00,187.47,1367,8031,9398
2021/01/30,14:00:00,187.47,1444,7895,9339
2021/01/30,14:30:00,186.93,1308,7812,9120
2021/01/30,15:00:00,188.64,1181,7838,9019
2021/01/30,15:30:00,188.45,1017,7932,8949
2021/01/30,16:00:00,188.83,637,8272,8909
2021/01/30,16:30:00,188.64,325,8611,8936
2021/01/30,17:00:00,208.06,3,9044,9047
2021/01/30,17:30:00,221.79,4,9750,9754
2021/01/30,18:00:00,245.57,4,10234,10238
2021/01/30,18:30:00,245.57,4,10677,10681
2021/01/30,19:00:00,247.81,2,10802,10804
2021/01/30,19:30:00,249.8,1,10814,10815
2021/01/30,20:00:00,248.44,3,10768,10771
2021/01/30,20:30:00,248.44,7,10671,10678
2021/01/30,21:00:00,248.44,6,10473,10479
2021/01/30,21:30:00,248.29,5,10240,10245
2021/01/30,22:00:00,246.86,3,9931,9934
2021/01/30,22:30:00,247.56,1,9536,9537
2021/01/30,23:00:00,245.57,2,9081,9083
2021/01/30,23:30:00,243.17,4,8534,8538
2021/01/31,00:00:00,191.83,9,7943,7952
2021/01/31,00:30:00,179.88,11,7360,7371
2021/01/31,01:00:00,179.88,9,6896,6905
2021/01/31,01:30:00,179.88,6,6555,6561
2021/01/31,02:00:00,179.88,6,6292,6298
2021/01/31,02:30:00,179.88,12,6083,6095
2021/01/31,03:00:00,179.88,18,5999,6017
2021/01/31,03:30:00,179.51,18,5941,5959
2021/01/31,04:00:00,179.7,17,5953,5970
2021/01/31,04:30:00,179.7,17,6032,6049
2021/01/31,05:00:00,179.7,16,6256,6272
2021/01/31,05:30:00,180.07,15,6570,6585
2021/01/31,06:00:00,179.88,13,6853,6866
2021/01/31,06:30:00,179.88,13,7122,7135
2021/01/31,07:00:00,191.21,56,7421,7477
2021/01/31,07:30:00,185.33,266,7846,8112
2021/01/31,08:00:00,183.81,599,7947,8546
2021/01/31,08:30:00,184.01,965,8074,9039
2021/01/31,09:00:00,183.73,1209,7989,9198
2021/01/31,09:30:00,183.62,1442,7879,9321
2021/01/31,10:00:00,250.47,1581,7853,9434
2021/01/31,10:30:00,251.85,1654,7836,9490
2021/01/31,11:00:00,251.14,1730,7760,9490
2021/01/31,11:30:00,251.14,1756,7671,9427
2021/01/31,12:00:00,185.49,1756,7652,9408
2021/01/31,12:30:00,185.49,1763,7634,9397
2021/01/31,13:00:00,185.66,1751,7651,9402
2021/01/31,13:30:00,185.33,1668,7741,9409
2021/01/31,14:00:00,185.18,1593,7781,9374
2021/01/31,14:30:00,191.27,1483,7800,9283
2021/01/31,15:00:00,191.45,1341,7877,9218
2021/01/31,15:30:00,186.07,1082,8104,9186
2021/01/31,16:00:00,186.15,732,8252,8984
2021/01/31,16:30:00,216.36,400,8636,9036
2021/01/31,17:00:00,225.16,420,9195,9615
2021/01/31,17:30:00,251.14,37,9995,10032
2021/01/31,18:00:00,253.42,0,10485,10485
2021/01/31,18:30:00,254.13,0,10697,10697
2021/01/31,19:00:00,254.87,0,10751,10751
2021/01/31,19:30:00,253.42,0,10762,10762
2021/01/31,20:00:00,254.13,0,10677,10677
2021/01/31,20:30:00,253.42,0,10534,10534
2021/01/31,21:00:00,254.87,0,10355,10355
2021/01/31,21:30:00,255.65,0,10016,10016
2021/01/31,22:00:00,254.13,0,9559,9559
2021/01/31,22:30:00,254.13,1,9369,9370
2021/01/31,23:00:00,254.87,0,8889,8889
2021/01/31,23:30:00,191.02,0,8303,8303
2021/02/01,00:00:00,157.06,0,6473,6473
2021/02/01,00:30:00,157.03,0,6197,6197
2021/02/01,01:00:00,157.02,1,5976,5977
2021/02/01,01:30:00,156.99,1,5779,5780
2021/02/01,02:00:00,157.24,1,5623,5624
2021/02/01,02:30:00,157.06,1,5526,5527
2021/02/01,03:00:00,157.24,2,5418,5420
2021/02/01,03:30:00,157.24,2,5390,5392
2021/02/01,04:00:00,157.03,2,5412,5414
2021/02/01,04:30:00,156.99,3,5449,5452
2021/02/01,05:00:00,157.19,3,5540,5543
2021/02/01,05:30:00,157.47,2,5667,5669
2021/02/01,06:00:00,156.99,1,5715,5716
2021/02/01,06:30:00,157.02,1,5686,5687
2021/02/01,07:00:00,157.44,1,5627,5628
2021/02/01,07:30:00,157.07,144,5637,5781
2021/02/01,08:00:00,158.63,365,5585,5950
2021/02/01,08:30:00,158.21,451,5736,6187
2021/02/01,09:00:00,157.98,615,5668,6283
2021/02/01,09:30:00,157.66,816,5620,6436
2021/02/01,10:00:00,157.34,1011,5612,6623
2021/02/01,10:30:00,157.24,1211,5517,6728
2021/02/01,11:00:00,157.56,1269,5503,6772
2021/02/01,11:30:00,158.05,1264,5559,6823
2021/02/01,12:00:00,158.05,1238,5566,6804
2021/02/01,12:30:00,157.74,1268,5505,6773
2021/02/01,13:00:00,157.56,1349,5410,6759
2021/02/01,13:30:00,157.61,1321,5385,6706
2021/02/01,14:00:00,158.39,1247,5401,6648
2021/02/01,14:30:00,159.13,1157,5560,6717
2021/02/01,15:00:00,158.41,1035,5827,6862
2021/02/01,15:30:00,158.59,872,6195,7067
2021/02/01,16:00:00,181.85,483,6572,7055
2021/02/01,16:30:00,182.04,60,7085,7145
2021/02/01,17:00:00,191.57,3,7605,7608
2021/02/01,17:30:00,181.85,4,8087,8091
2021/02/01,18:00:00,195.2,5,8538,8543
2021/02/01,18:30:00,195.31,6,8736,8742
2021/02/01,19:00:00,176.19,5,8770,8775
2021/02/01,19:30:00,183.31,6,8778,8784
2021/02/01,20:00:00,175.98,5,8707,8712
2021/02/01,20:30:00,175.98,8,8580,8588
2021/02/01,21:00:00,182.6,7,8417,8424
2021/02/01,21:30:00,182.6,8,8334,8342
2021/02/01,22:00:00,182.6,3,8066,8069
2021/02/01,22:30:00,182.6,4,7774,7778
2021/02/01,23:00:00,180.79,6,7450,7456
2021/02/01,23:30:00,160.21,7,7022,7029
2021/02/02,00:00:00,158.99,10,7213,7223
2021/02/02,00:30:00,161.47,11,6754,6765
2021/02/02,01:00:00,161.47,9,6432,6441
2021/02/02,01:30:00,161.47,7,6198,6205
2021/02/02,02:00:00,162.08,9,5998,6007
2021/02/02,02:30:00,162.08,10,5873,5883
2021/02/02,03:00:00,162.08,10,5778,5788
2021/02/02,03:30:00,161.47,10,5754,5764
2021/02/02,04:00:00,161.47,10,5774,5784
2021/02/02,04:30:00,161.47,10,5900,5910
2021/02/02,05:00:00,162.08,12,6064,6076
2021/02/02,05:30:00,161.47,13,6354,6367
2021/02/02,06:00:00,161.47,13,6506,6519
2021/02/02,06:30:00,162.08,13,6668,6681
2021/02/02,07:00:00,162.08,46,6889,6935
2021/02/02,07:30:00,161.47,186,7122,7308
2021/02/02,08:00:00,161.47,446,7062,7508
2021/02/02,08:30:00,144.11,755,7092,7847
2021/02/02,09:00:00,148.51,1012,6907,7919
2021/02/02,09:30:00,217.1,1239,6725,7964
2021/02/02,10:00:00,147.74,1407,6553,7960
2021/02/02,10:30:00,148.51,1538,6380,7918
2021/02/02,11:00:00,147.74,1595,6306,7901
2021/02/02,11:30:00,147.74,1643,6233,7876
2021/02/02,12:00:00,147.74,1656,6167,7823
2021/02/02,12:30:00,146.97,1639,6171,7810
2021/02/02,13:00:00,148.51,1582,6197,7779
2021/02/02,13:30:00,146.97,1506,6326,7832
2021/02/02,14:00:00,146.97,1404,6393,7797
2021/02/02,14:30:00,147.74,1241,6516,7757
2021/02/02,15:00:00,148.51,1083,6633,7716
2021/02/02,15:30:00,160,833,6864,7697
2021/02/02,16:00:00,160,538,7055,7593
2021/02/02,16:30:00,170.71,274,7421,7695
2021/02/02,17:00:00,170.71,47,7892,7939
2021/02/02,17:30:00,225.23,7,8560,8567
2021/02/02,18:00:00,224.71,7,8967,8974
2021/02/02,18:30:00,223.36,7,9059,9066
2021/02/02,19:00:00,221.63,8,9138,9146
2021/02/02,19:30:00,221.17,11,9137,9148
2021/02/02,20:00:00,221.14,12,9048,9060
2021/02/02,20:30:00,221.13,10,8876,8886
2021/02/02,21:00:00,165.1,7,8703,8710
2021/02/02,21:30:00,164.05,9,8489,8498
2021/02/02,22:00:00,153.3,10,8198,8208
2021/02/02,22:30:00,145.11,6,8022,8028
2021/02/02,23:00:00,145.31,6,7655,7661
2021/02/02,23:30:00,149.27,6,7239,7245
2021/02/03,00:00:00,144.82,8,6804,6812
2021/02/03,00:30:00,145.17,8,6449,6457
2021/02/03,01:00:00,144.87,9,6148,6157
2021/02/03,01:30:00,144.98,9,5900,5909
2021/02/03,02:00:00,144.87,8,5751,5759
2021/02/03,02:30:00,144.93,12,5609,5621
2021/02/03,03:00:00,144.72,13,5546,5559
2021/02/03,03:30:00,144.82,9,5530,5539
2021/02/03,04:00:00,144.98,9,5556,5565
2021/02/03,04:30:00,145.11,11,5648,5659
2021/02/03,05:00:00,144.93,13,5848,5861
2021/02/03,05:30:00,151.74,12,6138,6150
2021/02/03,06:00:00,152.9,14,6241,6255
2021/02/03,06:30:00,155.15,9,6416,6425
2021/02/03,07:00:00,157.37,56,6589,6645
2021/02/03,07:30:00,157.54,247,6784,7031
2021/02/03,08:00:00,222.39,575,6728,7303
2021/02/03,08:30:00,223.02,924,6660,7584
2021/02/03,09:00:00,224.41,1228,6415,7643
2021/02/03,09:30:00,223.81,1469,6243,7712
2021/02/03,10:00:00,223.81,1590,6099,7689
2021/02/03,10:30:00,225.04,1683,6047,7730
2021/02/03,11:00:00,144.39,1738,5978,7716
2021/02/03,11:30:00,144.11,1766,5907,7673
2021/02/03,12:00:00,157.53,1776,5862,7638
2021/02/03,12:30:00,154.04,1751,5862,7613
2021/02/03,13:00:00,154.45,1729,5928,7657
2021/02/03,13:30:00,154.04,1650,6001,7651
2021/02/03,14:00:00,154.84,1478,6202,7680
2021/02/03,14:30:00,154.25,1301,6319,7620
2021/02/03,15:00:00,154.65,1145,6503,7648
2021/02/03,15:30:00,170.88,941,6666,7607
2021/02/03,16:00:00,170.88,659,6785,7444
2021/02/03,16:30:00,167.58,365,7156,7521
2021/02/03,17:00:00,164.7,65,7542,7607
2021/02/03,17:30:00,253.82,44,8232,8276
2021/02/03,18:00:00,252.65,4,8627,8631
2021/02/03,18:30:00,223.02,4,8722,8726
2021/02/03,19:00:00,222.39,5,8782,8787
2021/02/03,19:30:00,218.06,6,8777,8783
2021/02/03,20:00:00,178.69,5,8649,8654
2021/02/03,20:30:00,215.83,8,8585,8593
2021/02/03,21:00:00,216.89,9,8425,8434
2021/02/03,21:30:00,216.89,8,8185,8193
2021/02/03,22:00:00,220.03,8,7917,7925
2021/02/03,22:30:00,180.54,9,7793,7802
2021/02/03,23:00:00,180.67,8,7435,7443
2021/02/03,23:30:00,170.88,8,7080,7088
2021/02/04,00:00:00,168.01,10,6685,6695
2021/02/04,00:30:00,168.25,10,6357,6367
2021/02/04,01:00:00,156.7,11,6064,6075
2021/02/04,01:30:00,144.69,8,5854,5862
2021/02/04,02:00:00,144.99,5,5688,5693
2021/02/04,02:30:00,144.69,8,5569,5577
2021/02/04,03:00:00,144.99,7,5475,5482
2021/02/04,03:30:00,144.99,7,5485,5492
2021/02/04,04:00:00,144.84,6,5500,5506
2021/02/04,04:30:00,144.84,6,5613,5619
2021/02/04,05:00:00,144.99,8,5790,5798
2021/02/04,05:30:00,145.8,8,6079,6087
2021/02/04,06:00:00,145.37,6,6171,6177
2021/02/04,06:30:00,144.69,7,6333,6340
2021/02/04,07:00:00,144.84,8,6622,6630
2021/02/04,07:30:00,244.89,128,6956,7084
2021/02/04,08:00:00,244.16,366,7055,7421
2021/02/04,08:30:00,247.88,666,7097,7763
2021/02/04,09:00:00,247.12,853,6963,7816
2021/02/04,09:30:00,159.27,1192,6667,7859
2021/02/04,10:00:00,167.49,1370,6601,7971
2021/02/04,10:30:00,167.75,1214,6571,7785
2021/02/04,11:00:00,168.01,1481,6427,7908
2021/02/04,11:30:00,168.01,1377,6489,7866
2021/02/04,12:00:00,168.49,998,6808,7806
2021/02/04,12:30:00,179.04,687,7221,7908
2021/02/04,13:00:00,168.23,599,7490,8089
2021/02/04,13:30:00,187.33,519,7841,8360
2021/02/04,14:00:00,243.47,466,8165,8631
2021/02/04,14:30:00,247.88,498,8329,8827
2021/02/04,15:00:00,254.54,345,8626,8971
2021/02/04,15:30:00,251.29,302,8733,9035
2021/02/04,16:00:00,254.54,215,8758,8973
2021/02/04,16:30:00,252.89,107,8878,8985
2021/02/04,17:00:00,249.73,12,9163,9175
2021/02/04,17:30:00,245.04,8,9609,9617
2021/02/04,18:00:00,246.39,1,9755,9756
2021/02/04,18:30:00,247.12,0,9811,9811
2021/02/04,19:00:00,247.12,0,9737,9737
2021/02/04,19:30:00,247.12,0,9620,9620
2021/02/04,20:00:00,247.12,0,9458,9458
2021/02/04,20:30:00,247.12,0,9264,9264
2021/02/04,21:00:00,246.39,0,9058,9058
2021/02/04,21:30:00,246.39,0,8951,8951
2021/02/04,22:00:00,246.39,0,8620,8620
2021/02/04,22:30:00,246.39,0,8466,8466
2021/02/04,23:00:00,244.41,0,8118,8118
2021/02/04,23:30:00,181.49,0,7579,7579
2021/02/05,00:00:00,170.88,0,7192,7192
2021/02/05,00:30:00,159.18,0,6825,6825
2021/02/05,01:00:00,144.84,1,6500,6501
2021/02/05,01:30:00,144.69,0,6257,6257
2021/02/05,02:00:00,144.84,0,6052,6052
2021/02/05,02:30:00,144.69,1,5873,5874
2021/02/05,03:00:00,144.69,1,5782,5783
2021/02/05,03:30:00,144.69,1,5729,5730
2021/02/05,04:00:00,144.69,0,5749,5749
2021/02/05,04:30:00,144.54,0,5805,5805
2021/02/05,05:00:00,181.87,0,5932,5932
2021/02/05,05:30:00,197.9,0,6062,6062
2021/02/05,06:00:00,179.24,0,6218,6218
2021/02/05,06:30:00,178.47,0,6294,6294
2021/02/05,07:00:00,178.86,0,6361,6361
2021/02/05,07:30:00,202.16,58,6622,6680
2021/02/05,08:00:00,203.69,119,6829,6948
2021/02/05,08:30:00,204.74,188,7021,7209
2021/02/05,09:00:00,203.47,260,7145,7405
2021/02/05,09:30:00,197.9,362,7210,7572
2021/02/05,10:00:00,207.34,532,7210,7742
2021/02/05,10:30:00,203.9,637,7320,7957
2021/02/05,11:00:00,203.69,808,7273,8081
2021/02/05,11:30:00,208.85,873,7297,8170
2021/02/05,12:00:00,199.37,792,7490,8282
2021/02/05,12:30:00,193.67,782,7318,8100
2021/02/05,13:00:00,181.14,777,7412,8189
2021/02/05,13:30:00,179.63,795,7427,8222
2021/02/05,14:00:00,193.11,705,7371,8076
2021/02/05,14:30:00,237.04,549,7600,8149
2021/02/05,15:00:00,216.36,517,7776,8293
2021/02/05,15:30:00,216.31,333,8052,8385
2021/02/05,16:00:00,216.09,257,8146,8403
2021/02/05,16:30:00,215.54,126,8399,8525
2021/02/05,17:00:00,226.34,6,8418,8424
2021/02/05,17:30:00,223.58,3,8679,8682
2021/02/05,18:00:00,226.31,3,8860,8863
2021/02/05,18:30:00,251.85,2,8783,8785
2021/02/05,19:00:00,176,2,8617,8619
2021/02/05,19:30:00,221.79,0,8381,8381
2021/02/05,20:00:00,222.39,0,8181,8181
2021/02/05,20:30:00,221.79,0,8080,8080
2021/02/05,21:00:00,222.39,0,7974,7974
2021/02/05,21:30:00,224.41,0,7823,7823
2021/02/05,22:00:00,226.39,0,7608,7608
2021/02/05,22:30:00,165.84,0,7438,7438
2021/02/05,23:00:00,165.71,0,7180,7180
2021/02/05,23:30:00,160,0,6848,6848
2021/02/06,00:00:00,144.69,0,6592,6592
2021/02/06,00:30:00,144.54,0,6347,6347
2021/02/06,01:00:00,144.54,0,6110,6110
2021/02/06,01:30:00,144.69,0,5924,5924
2021/02/06,02:00:00,144.54,0,5757,5757
2021/02/06,02:30:00,144.39,0,5645,5645
2021/02/06,03:00:00,144.39,0,5584,5584
2021/02/06,03:30:00,144.69,0,5548,5548
2021/02/06,04:00:00,144.54,0,5529,5529
2021/02/06,04:30:00,144.69,0,5592,5592
2021/02/06,05:00:00,144.69,0,5691,5691
2021/02/06,05:30:00,144.69,1,5795,5796
2021/02/06,06:00:00,144.69,0,5867,5867
2021/02/06,06:30:00,144.39,0,5815,5815
2021/02/06,07:00:00,144.54,35,5817,5852
2021/02/06,07:30:00,144.69,123,5844,5967
2021/02/06,08:00:00,144.54,280,5803,6083
2021/02/06,08:30:00,144.69,562,5682,6244
2021/02/06,09:00:00,144.54,659,5706,6365
2021/02/06,09:30:00,144.69,889,5556,6445
2021/02/06,10:00:00,144.69,969,5596,6565
2021/02/06,10:30:00,144.54,1151,5490,6641
2021/02/06,11:00:00,144.54,1192,5446,6638
2021/02/06,11:30:00,144.69,1297,5375,6672
2021/02/06,12:00:00,144.39,1230,5408,6638
2021/02/06,12:30:00,144.69,1326,5269,6595
2021/02/06,13:00:00,144.69,1286,5386,6672
2021/02/06,13:30:00,144.69,1244,5397,6641
2021/02/06,14:00:00,144.69,1231,5360,6591
2021/02/06,14:30:00,144.54,1113,5446,6559
2021/02/06,15:00:00,144.54,1009,5700,6709
2021/02/06,15:30:00,144.54,814,5999,6813
2021/02/06,16:00:00,165.1,581,6299,6880
2021/02/06,16:30:00,165.58,310,6793,7103
2021/02/06,17:00:00,166.99,11,7203,7214
2021/02/06,17:30:00,178.4,9,7794,7803
2021/02/06,18:00:00,254.69,7,8259,8266
2021/02/06,18:30:00,252.46,10,8596,8606
2021/02/06,19:00:00,253.56,10,8699,8709
2021/02/06,19:30:00,223.81,7,8731,8738
2021/02/06,20:00:00,224.41,5,8664,8669
2021/02/06,20:30:00,223.81,4,8552,8556
2021/02/06,21:00:00,223.81,4,8427,8431
2021/02/06,21:30:00,224.41,4,8347,8351
2021/02/06,22:00:00,224.41,4,8065,8069
2021/02/06,22:30:00,225.04,4,7805,7809
2021/02/06,23:00:00,223.81,3,7536,7539
2021/02/06,23:30:00,224.41,3,7148,7151
2021/02/07,00:00:00,169.47,2,6768,6770
2021/02/07,00:30:00,144.54,4,6404,6408
2021/02/07,01:00:00,144.54,3,6037,6040
2021/02/07,01:30:00,144.39,3,5833,5836
2021/02/07,02:00:00,144.39,1,5668,5669
2021/02/07,02:30:00,144.54,1,5510,5511
2021/02/07,03:00:00,144.54,1,5425,5426
2021/02/07,03:30:00,144.54,1,5399,5400
2021/02/07,04:00:00,144.69,1,5440,5441
2021/02/07,04:30:00,144.69,0,5541,5541
2021/02/07,05:00:00,182.24,0,5726,5726
2021/02/07,05:30:00,176,0,6031,6031
2021/02/07,06:00:00,176,0,6222,6222
2021/02/07,06:30:00,183,0,6460,6460
2021/02/07,07:00:00,212.34,62,6733,6795
2021/02/07,07:30:00,182.24,293,6879,7172
2021/02/07,08:00:00,176,602,6851,7453
2021/02/07,08:30:00,144.54,951,6811,7762
2021/02/07,09:00:00,197.39,1198,6664,7862
2021/02/07,09:30:00,188.01,1438,6487,7925
2021/02/07,10:00:00,154.04,1564,6347,7911
2021/02/07,10:30:00,154.04,1613,6335,7948
2021/02/07,11:00:00,154.04,1703,6204,7907
2021/02/07,11:30:00,153.83,1755,6124,7879
2021/02/07,12:00:00,145.71,1790,6057,7847
2021/02/07,12:30:00,145.76,1794,6035,7829
2021/02/07,13:00:00,144.54,1736,6074,7810
2021/02/07,13:30:00,144.54,1674,6114,7788
2021/02/07,14:00:00,144.54,1616,6188,7804
2021/02/07,14:30:00,144.69,1502,6267,7769
2021/02/07,15:00:00,170.88,1290,6359,7649
2021/02/07,15:30:00,165.58,1114,6656,7770
2021/02/07,16:00:00,165.77,777,6857,7634
2021/02/07,16:30:00,165.77,410,7261,7671
2021/02/07,17:00:00,199.61,67,7759,7826
2021/02/07,17:30:00,254.48,46,8506,8552
2021/02/07,18:00:00,253.35,1,9049,9050
2021/02/07,18:30:00,252.25,1,9270,9271
2021/02/07,19:00:00,254.48,0,9320,9320
2021/02/07,19:30:00,253.35,0,9335,9335
2021/02/07,20:00:00,253.35,0,9303,9303
2021/02/07,20:30:00,252.69,0,9183,9183
2021/02/07,21:00:00,225.04,0,9018,9018
2021/02/07,21:30:00,224.41,0,8791,8791
2021/02/07,22:00:00,224.41,0,8449,8449
2021/02/07,22:30:00,224.41,0,8237,8237
2021/02/07,23:00:00,225.04,0,7870,7870
2021/02/07,23:30:00,225.7,0,7372,7372
2021/02/08,00:00:00,152.64,0,6960,6960
2021/02/08,00:30:00,144.54,0,6554,6554
2021/02/08,01:00:00,144.54,0,6240,6240
2021/02/08,01:30:00,144.69,1,6024,6025
2021/02/08,02:00:00,144.54,1,5849,5850
2021/02/08,02:30:00,144.69,1,5707,5708
2021/02/08,03:00:00,144.54,1,5651,5652
2021/02/08,03:30:00,144.69,1,5608,5609
2021/02/08,04:00:00,144.69,1,5662,5663
2021/02/08,04:30:00,144.69,1,5749,5750
2021/02/08,05:00:00,144.69,0,5941,5941
2021/02/08,05:30:00,176,0,6234,6234
2021/02/08,06:00:00,176,0,6440,6440
2021/02/08,06:30:00,176,0,6645,6645
2021/02/08,07:00:00,183,91,6823,6914
2021/02/08,07:30:00,144.54,328,6983,7311
2021/02/08,08:00:00,176,641,6854,7495
2021/02/08,08:30:00,144.69,969,6815,7784
2021/02/08,09:00:00,144.54,1337,6503,7840
2021/02/08,09:30:00,144.54,1525,6294,7819
2021/02/08,10:00:00,217.1,1647,6156,7803
2021/02/08,10:30:00,144.54,1730,5994,7724
2021/02/08,11:00:00,144.54,1782,5950,7732
2021/02/08,11:30:00,144.39,1767,5896,7663
2021/02/08,12:00:00,144.54,1786,5840,7626
2021/02/08,12:30:00,144.54,1731,5828,7559
2021/02/08,13:00:00,144.69,1668,5886,7554
2021/02/08,13:30:00,144.54,1486,6076,7562
2021/02/08,14:00:00,144.54,1415,6152,7567
2021/02/08,14:30:00,217.1,1291,6294,7585
2021/02/08,15:00:00,227.46,1167,6379,7546
2021/02/08,15:30:00,221.22,979,6658,7637
2021/02/08,16:00:00,223.67,581,6959,7540
2021/02/08,16:30:00,221.79,277,7253,7530
2021/02/08,17:00:00,221.22,52,7675,7727
2021/02/08,17:30:00,214.38,0,8296,8296
2021/02/08,18:00:00,223.81,0,8681,8681
2021/02/08,18:30:00,223.24,0,8818,8818
2021/02/08,19:00:00,223.81,0,8865,8865
2021/02/08,19:30:00,224.41,0,8856,8856
2021/02/08,20:00:00,224.41,0,8791,8791
2021/02/08,20:30:00,222.7,1,8680,8681
2021/02/08,21:00:00,223.24,1,8529,8530
2021/02/08,21:30:00,224.41,2,8295,8297
2021/02/08,22:00:00,223.24,1,7981,7982
2021/02/08,22:30:00,223.81,1,7820,7821
2021/02/08,23:00:00,224.41,1,7478,7479
2021/02/08,23:30:00,224.41,1,7045,7046
2021/02/09,00:00:00,223.24,2,6669,6671
2021/02/09,00:30:00,153.83,2,6323,6325
2021/02/09,01:00:00,144.99,2,6045,6047
2021/02/09,01:30:00,144.84,2,5836,5838
2021/02/09,02:00:00,144.84,2,5665,5667
2021/02/09,02:30:00,144.84,0,5573,5573
2021/02/09,03:00:00,144.69,1,5481,5482
2021/02/09,03:30:00,144.69,0,5488,5488
2021/02/09,04:00:00,144.84,0,5519,5519
2021/02/09,04:30:00,144.84,0,5636,5636
2021/02/09,05:00:00,144.84,0,5790,5790
2021/02/09,05:30:00,144.84,0,6077,6077
2021/02/09,06:00:00,144.84,0,6254,6254
2021/02/09,06:30:00,144.84,1,6419,6420
2021/02/09,07:00:00,144.84,37,6704,6741
2021/02/09,07:30:00,144.84,145,6886,7031
2021/02/09,08:00:00,223.02,269,6917,7186
2021/02/09,08:30:00,221.79,664,6805,7469
2021/02/09,09:00:00,220.68,730,6731,7461
2021/02/09,09:30:00,224.37,899,6488,7387
2021/02/09,10:00:00,216.89,1078,6390,7468
2021/02/09,10:30:00,144.69,1210,6196,7406
2021/02/09,11:00:00,144.84,1366,6118,7484
2021/02/09,11:30:00,145.15,1481,5958,7439
2021/02/09,12:00:00,144.84,1432,5996,7428
2021/02/09,12:30:00,144.84,1370,6004,7374
2021/02/09,13:00:00,144.84,1466,5948,7414
2021/02/09,13:30:00,144.69,1366,6007,7373
2021/02/09,14:00:00,144.84,1417,5925,7342
2021/02/09,14:30:00,178.86,1359,5942,7301
2021/02/09,15:00:00,194.23,1299,6037,7336
2021/02/09,15:30:00,193.39,1115,6264,7379
2021/02/09,16:00:00,191.38,732,6478,7210
2021/02/09,16:30:00,195.58,287,6888,7175
2021/02/09,17:00:00,202.6,59,7241,7300
2021/02/09,17:30:00,204.32,0,7841,7841
2021/02/09,18:00:00,225.98,0,8230,8230
2021/02/09,18:30:00,225.32,0,8442,8442
2021/02/09,19:00:00,224.41,0,8474,8474
2021/02/09,19:30:00,225.98,0,8485,8485
2021/02/09,20:00:00,226.67,0,8425,8425
2021/02/09,20:30:00,226.67,0,8342,8342
2021/02/09,21:00:00,225.32,0,8235,8235
2021/02/09,21:30:00,225.98,0,8041,8041
2021/02/09,22:00:00,225.98,0,7791,7791
2021/02/09,22:30:00,225.98,0,7633,7633
2021/02/09,23:00:00,225.32,0,7347,7347
2021/02/09,23:30:00,225.98,0,6947,6947
2021/02/10,00:00:00,154.04,0,6607,6607
2021/02/10,00:30:00,144.69,0,6299,6299
2021/02/10,01:00:00,144.69,0,6014,6014
2021/02/10,01:30:00,144.69,0,5816,5816
2021/02/10,02:00:00,148.19,0,5667,5667
2021/02/10,02:30:00,152.15,0,5549,5549
2021/02/10,03:00:00,152.83,0,5471,5471
2021/02/10,03:30:00,148.19,0,5459,5459
2021/02/10,04:00:00,147.06,0,5525,5525
2021/02/10,04:30:00,145.98,0,5630,5630
2021/02/10,05:00:00,144.54,0,5765,5765
2021/02/10,05:30:00,144.84,0,6052,6052
2021/02/10,06:00:00,144.54,0,6207,6207
2021/02/10,06:30:00,145.63,0,6327,6327
2021/02/10,07:00:00,144.54,53,6536,6589
2021/02/10,07:30:00,146.71,256,6667,6923
2021/02/10,08:00:00,145.42,584,6532,7116
2021/02/10,08:30:00,148.34,946,6411,7357
2021/02/10,09:00:00,151.12,1249,6180,7429
2021/02/10,09:30:00,152.29,1433,5978,7411
2021/02/10,10:00:00,155.75,1603,5857,7460
2021/02/10,10:30:00,155.75,1726,5685,7411
2021/02/10,11:00:00,155.75,1807,5611,7418
2021/02/10,11:30:00,151.16,1832,5536,7368
2021/02/10,12:00:00,149,1872,5503,7375
2021/02/10,12:30:00,148.08,1835,5494,7329
2021/02/10,13:00:00,147.91,1830,5506,7336
2021/02/10,13:30:00,147.91,1783,5619,7402
2021/02/10,14:00:00,146.45,1703,5704,7407
2021/02/10,14:30:00,145.25,1584,5842,7426
2021/02/10,15:00:00,170.88,1423,6050,7473
2021/02/10,15:30:00,170.55,1199,6280,7479
2021/02/10,16:00:00,170.55,860,6546,7406
2021/02/10,16:30:00,179.76,488,6888,7376
2021/02/10,17:00:00,172.44,92,7423,7515
2021/02/10,17:30:00,226.68,69,7969,8038
2021/02/10,18:00:00,223.53,17,8509,8526
2021/02/10,18:30:00,221.79,13,8676,8689
2021/02/10,19:00:00,224.44,9,8726,8735
2021/02/10,19:30:00,228.43,6,8757,8763
2021/02/10,20:00:00,225.98,4,8723,8727
2021/02/10,20:30:00,226.67,3,8618,8621
2021/02/10,21:00:00,224.7,6,8485,8491
2021/02/10,21:30:00,225.32,4,8312,8316
2021/02/10,22:00:00,225.32,4,8010,8014
2021/02/10,22:30:00,178.76,3,7875,7878
2021/02/10,23:00:00,182.92,4,7542,7546
2021/02/10,23:30:00,205.97,5,7153,7158
2021/02/11,00:00:00,205.56,6,6718,6724
2021/02/11,00:30:00,186.06,4,6408,6412
2021/02/11,01:00:00,193.95,2,6247,6249
2021/02/11,01:30:00,190.19,3,6176,6179
2021/02/11,02:00:00,194.23,1,6007,6008
2021/02/11,02:30:00,193.39,1,5921,5922
2021/02/11,03:00:00,192.54,1,5858,5859
2021/02/11,03:30:00,192.54,1,5842,5843
2021/02/11,04:00:00,198.15,1,5878,5879
2021/02/11,04:30:00,201.71,0,5979,5979
2021/02/11,05:00:00,204.11,0,6159,6159
2021/02/11,05:30:00,208.29,0,6432,6432
2021/02/11,06:00:00,204.74,0,6583,6583
2021/02/11,06:30:00,234.41,0,6772,6772
2021/02/11,07:00:00,233.76,83,7019,7102
2021/02/11,07:30:00,233.76,329,7113,7442
2021/02/11,08:00:00,233.76,623,7021,7644
2021/02/11,08:30:00,235.1,897,6996,7893
2021/02/11,09:00:00,216.55,1258,6719,7977
2021/02/11,09:30:00,220.91,1510,6537,8047
2021/02/11,10:00:00,220.63,1709,6182,7891
2021/02/11,10:30:00,221.19,1816,6048,7864
2021/02/11,11:00:00,222.45,1883,5937,7820
2021/02/11,11:30:00,218.08,1902,5923,7825
2021/02/11,12:00:00,153.5,1920,5819,7739
2021/02/11,12:30:00,152.78,1913,5767,7680
2021/02/11,13:00:00,152.88,1868,5816,7684
2021/02/11,13:30:00,153.55,1817,5849,7666
2021/02/11,14:00:00,154.14,1739,5800,7539
2021/02/11,14:30:00,153.24,1625,5931,7556
2021/02/11,15:00:00,151.96,1474,6176,7650
2021/02/11,15:30:00,153.37,1280,6427,7707
2021/02/11,16:00:00,153.33,972,6549,7521
2021/02/11,16:30:00,165.39,592,6932,7524
2021/02/11,17:00:00,203.8,88,7503,7591
2021/02/11,17:30:00,251.25,48,8149,8197
2021/02/11,18:00:00,250.15,1,8692,8693
2021/02/11,18:30:00,251.25,1,8876,8877
2021/02/11,19:00:00,250.15,1,9094,9095
2021/02/11,19:30:00,250.15,1,8988,8989
2021/02/11,20:00:00,228.17,1,8918,8919
2021/02/11,20:30:00,226.2,3,8690,8693
2021/02/11,21:00:00,226.83,3,8576,8579
2021/02/11,21:30:00,202.38,3,8375,8378
2021/02/11,22:00:00,202.16,3,8091,8094
2021/02/11,22:30:00,201.93,3,7975,7978
2021/02/11,23:00:00,202.16,3,7699,7702
2021/02/11,23:30:00,201.93,3,7365,7368
2021/02/12,00:00:00,244.8,4,6962,6966
2021/02/12,00:30:00,197.6,3,6619,6622
2021/02/12,01:00:00,197.6,3,6354,6357
2021/02/12,01:30:00,170.35,3,6121,6124
2021/02/12,02:00:00,170.38,2,5903,5905
2021/02/12,02:30:00,170.51,2,5749,5751
2021/02/12,03:00:00,170.41,1,5677,5678
2021/02/12,03:30:00,170.31,1,5648,5649
2021/02/12,04:00:00,170.29,1,5621,5622
2021/02/12,04:30:00,170.39,1,5714,5715
2021/02/12,05:00:00,170.45,1,5821,5822
2021/02/12,05:30:00,170.53,1,5989,5990
2021/02/12,06:00:00,171.9,1,6128,6129
2021/02/12,06:30:00,170.53,0,6065,6065
2021/02/12,07:00:00,171.06,62,6178,6240
2021/02/12,07:30:00,171.14,221,6259,6480
2021/02/12,08:00:00,171.54,372,6221,6593
2021/02/12,08:30:00,172.6,546,6249,6795
2021/02/12,09:00:00,172.52,803,6095,6898
2021/02/12,09:30:00,172.61,1035,5969,7004
2021/02/12,10:00:00,170.57,1295,5918,7213
2021/02/12,10:30:00,170.53,1347,5854,7201
2021/02/12,11:00:00,170.4,1421,5768,7189
2021/02/12,11:30:00,170.51,1635,5592,7227
2021/02/12,12:00:00,170.52,1707,5458,7165
2021/02/12,12:30:00,170.31,1797,5333,7130
2021/02/12,13:00:00,170.29,1776,5322,7098
2021/02/12,13:30:00,170.29,1696,5340,7036
2021/02/12,14:00:00,170.31,1600,5482,7082
2021/02/12,14:30:00,170.3,1489,5606,7095
2021/02/12,15:00:00,170.32,1335,5808,7143
2021/02/12,15:30:00,172.39,1125,6178,7303
2021/02/12,16:00:00,171.69,776,6590,7366
2021/02/12,16:30:00,197.65,427,7129,7556
2021/02/12,17:00:00,183.27,74,7523,7597
2021/02/12,17:30:00,200.24,15,7898,7913
2021/02/12,18:00:00,212.01,9,8246,8255
2021/02/12,18:30:00,197.27,11,8234,8245
2021/02/12,19:00:00,196.92,10,8120,8130
2021/02/12,19:30:00,196.92,8,7931,7939
2021/02/12,20:00:00,196.92,8,7756,7764
2021/02/12,20:30:00,196.92,6,7741,7747
2021/02/12,21:00:00,196.92,8,7647,7655
2021/02/12,21:30:00,196.56,8,7559,7567
2021/02/12,22:00:00,196.56,6,7412,7418
2021/02/12,22:30:00,196.56,9,7201,7210
2021/02/12,23:00:00,196.56,5,6970,6975
2021/02/12,23:30:00,196.56,5,6707,6712
2021/02/13,00:00:00,196.56,4,6458,6462
2021/02/13,00:30:00,170.31,3,6203,6206
2021/02/13,01:00:00,171.31,3,5979,5982
2021/02/13,01:30:00,170.57,3,5838,5841
2021/02/13,02:00:00,170.37,2,5684,5686
2021/02/13,02:30:00,170.42,2,5580,5582
2021/02/13,03:00:00,170.53,3,5507,5510
2021/02/13,03:30:00,170.57,4,5476,5480
2021/02/13,04:00:00,170.56,2,5482,5484
2021/02/13,04:30:00,170.41,3,5534,5537
2021/02/13,05:00:00,170.04,1,5621,5622
2021/02/13,05:30:00,169.81,1,5733,5734
2021/02/13,06:00:00,170.09,1,5797,5798
2021/02/13,06:30:00,292.92,1,5743,5744
2021/02/13,07:00:00,293.83,86,5677,5763
2021/02/13,07:30:00,170.56,360,5589,5949
2021/02/13,08:00:00,170.54,690,5502,6192
2021/02/13,08:30:00,170.52,999,5543,6542
2021/02/13,09:00:00,170.54,1328,5357,6685
2021/02/13,09:30:00,170.35,1564,5191,6755
2021/02/13,10:00:00,170.36,1667,5150,6817
2021/02/13,10:30:00,170.29,1746,5063,6809
2021/02/13,11:00:00,170.3,1832,4988,6820
2021/02/13,11:30:00,197.01,1904,4925,6829
2021/02/13,12:00:00,197.75,1926,4888,6814
2021/02/13,12:30:00,192.77,1916,4869,6785
2021/02/13,13:00:00,195.56,1876,4858,6734
2021/02/13,13:30:00,192.1,1792,4880,6672
2021/02/13,14:00:00,194.15,1737,4901,6638
2021/02/13,14:30:00,197.01,1621,5013,6634
2021/02/13,15:00:00,194.85,1471,5230,6701
2021/02/13,15:30:00,170.32,1240,5483,6723
2021/02/13,16:00:00,170.31,925,5738,6663
2021/02/13,16:30:00,170.29,516,6257,6773
2021/02/13,17:00:00,250.59,76,6576,6652
2021/02/13,17:30:00,251.51,32,7220,7252
2021/02/13,18:00:00,292.92,28,7749,7777
2021/02/13,18:30:00,290.43,31,8224,8255
2021/02/13,19:00:00,292.92,37,8406,8443
2021/02/13,19:30:00,292.92,39,8477,8516
2021/02/13,20:00:00,292.92,39,8464,8503
2021/02/13,20:30:00,291.22,39,8388,8427
2021/02/13,21:00:00,292.05,34,8286,8320
2021/02/13,21:30:00,292.05,1,8290,8291
2021/02/13,22:00:00,282.46,1,8096,8097
2021/02/13,22:30:00,282.46,1,7866,7867
2021/02/13,23:00:00,212.67,1,7552,7553
2021/02/13,23:30:00,203.47,2,7139,7141
2021/02/14,00:00:00,186.81,1,6755,6756
2021/02/14,00:30:00,157.26,1,6374,6375
2021/02/14,01:00:00,157.27,2,6092,6094
2021/02/14,01:30:00,157.14,3,5875,5878
2021/02/14,02:00:00,157.07,3,5688,5691
2021/02/14,02:30:00,157.28,2,5719,5721
2021/02/14,03:00:00,157.26,3,5622,5625
2021/02/14,03:30:00,157.15,3,5616,5619
2021/02/14,04:00:00,157.3,4,5651,5655
2021/02/14,04:30:00,157.18,3,5750,5753
2021/02/14,05:00:00,158.03,3,5958,5961
2021/02/14,05:30:00,167.06,4,6242,6246
2021/02/14,06:00:00,167.55,5,6449,6454
2021/02/14,06:30:00,184.36,2,6713,6715
2021/02/14,07:00:00,197.14,99,6969,7068
2021/02/14,07:30:00,181.78,375,6914,7289
2021/02/14,08:00:00,182.38,766,6684,7450
2021/02/14,08:30:00,182.38,1100,6539,7639
2021/02/14,09:00:00,182.67,1426,6678,8104
2021/02/14,09:30:00,182.95,1591,6548,8139
2021/02/14,10:00:00,182.95,1701,6376,8077
2021/02/14,10:30:00,183.47,1791,6311,8102
2021/02/14,11:00:00,183.72,1843,6140,7983
2021/02/14,11:30:00,157.27,1867,6113,7980
2021/02/14,12:00:00,157.11,1851,6023,7874
2021/02/14,12:30:00,157.1,1856,6002,7858
2021/02/14,13:00:00,157.15,1777,6036,7813
2021/02/14,13:30:00,157.07,1756,6081,7837
2021/02/14,14:00:00,157.07,1675,6190,7865
2021/02/14,14:30:00,157.13,1566,6294,7860
2021/02/14,15:00:00,157.31,1408,6429,7837
2021/02/14,15:30:00,157.32,1166,6434,7600
2021/02/14,16:00:00,157.09,858,6576,7434
2021/02/14,16:30:00,157.32,498,6973,7471
2021/02/14,17:00:00,157.29,111,7520,7631
2021/02/14,17:30:00,208.85,85,8162,8247
2021/02/14,18:00:00,261.66,79,8754,8833
2021/02/14,18:30:00,261.66,78,9037,9115
2021/02/14,19:00:00,261.66,80,9138,9218
2021/02/14,19:30:00,260.87,78,9186,9264
2021/02/14,20:00:00,182.67,77,9175,9252
2021/02/14,20:30:00,182.09,87,9007,9094
2021/02/14,21:00:00,182.09,89,8833,8922
2021/02/14,21:30:00,181.78,66,8592,8658
2021/02/14,22:00:00,181.78,8,8306,8314
2021/02/14,22:30:00,181.46,7,8134,8141
2021/02/14,23:00:00,181.46,5,7761,7766
2021/02/14,23:30:00,181.78,5,7307,7312
2021/02/15,00:00:00,144.39,5,6886,6891
2021/02/15,00:30:00,144.39,3,6522,6525
2021/02/15,01:00:00,144.54,3,6237,6240
2021/02/15,01:30:00,144.39,4,6146,6150
2021/02/15,02:00:00,144.54,3,6118,6121
2021/02/15,02:30:00,144.39,3,6014,6017
2021/02/15,03:00:00,144.39,2,5937,5939
2021/02/15,03:30:00,144.39,2,5927,5929
2021/02/15,04:00:00,144.39,2,5971,5973
2021/02/15,04:30:00,144.39,2,6080,6082
2021/02/15,05:00:00,144.25,2,6285,6287
2021/02/15,05:30:00,144.71,1,6556,6557
2021/02/15,06:00:00,148.68,1,6717,6718
2021/02/15,06:30:00,144.25,1,6957,6958
2021/02/15,07:00:00,202.16,87,7210,7297
2021/02/15,07:30:00,235.36,333,7333,7666
2021/02/15,08:00:00,243.46,667,7316,7983
2021/02/15,08:30:00,237.42,780,7382,8162
2021/02/15,09:00:00,176,1017,7201,8218
2021/02/15,09:30:00,176,1317,7001,8318
2021/02/15,10:00:00,144.39,1428,6945,8373
2021/02/15,10:30:00,144.39,1534,6750,8284
2021/02/15,11:00:00,144.39,1605,6641,8246
2021/02/15,11:30:00,144.54,1684,6492,8176
2021/02/15,12:00:00,174.38,1693,6335,8028
2021/02/15,12:30:00,144.39,1785,6288,8073
2021/02/15,13:00:00,144.39,1775,6218,7993
2021/02/15,13:30:00,144.54,1699,6168,7867
2021/02/15,14:00:00,144.39,1672,6175,7847
2021/02/15,14:30:00,144.11,1560,6111,7671
2021/02/15,15:00:00,144.25,1423,6253,7676
2021/02/15,15:30:00,144.69,1215,6449,7664
2021/02/15,16:00:00,144.84,919,6599,7518
2021/02/15,16:30:00,144.69,565,7032,7597
2021/02/15,17:00:00,144.25,130,7545,7675
2021/02/15,17:30:00,158.29,77,8264,8341
2021/02/15,18:00:00,197.14,104,8904,9008
2021/02/15,18:30:00,245.4,99,9200,9299
2021/02/15,19:00:00,243.93,54,9362,9416
2021/02/15,19:30:00,244.65,5,9455,9460
2021/02/15,20:00:00,246.19,2,9394,9396
2021/02/15,20:30:00,243.62,1,9305,9306
2021/02/15,21:00:00,187.05,1,9143,9144
2021/02/15,21:30:00,165.89,2,8921,8923
2021/02/15,22:00:00,165.89,2,8568,8570
2021/02/15,22:30:00,155.04,1,8345,8346
2021/02/15,23:00:00,154.98,1,7923,7924
2021/02/15,23:30:00,154.4,1,7440,7441
2021/02/16,00:00:00,144.11,1,6991,6992
2021/02/16,00:30:00,144.25,1,6631,6632
2021/02/16,01:00:00,144.25,1,6319,6320
2021/02/16,01:30:00,144.11,1,6121,6122
2021/02/16,02:00:00,144.11,1,6085,6086
2021/02/16,02:30:00,144.11,1,5968,5969
2021/02/16,03:00:00,144.11,1,5884,5885
2021/02/16,03:30:00,144.11,1,5844,5845
2021/02/16,04:00:00,144.11,0,5879,5879
2021/02/16,04:30:00,144.11,0,6002,6002
2021/02/16,05:00:00,144.11,0,6208,6208
2021/02/16,05:30:00,144.25,0,6492,6492
2021/02/16,06:00:00,144.11,0,6723,6723
2021/02/16,06:30:00,144.11,0,6900,6900
2021/02/16,07:00:00,143.97,76,7115,7191
2021/02/16,07:30:00,143.97,221,7296,7517
2021/02/16,08:00:00,144.25,581,7094,7675
2021/02/16,08:30:00,152.5,921,6927,7848
2021/02/16,09:00:00,152.91,1226,6700,7926
2021/02/16,09:30:00,152.89,1462,6757,8219
2021/02/16,10:00:00,152.87,1662,6604,8266
2021/02/16,10:30:00,155.25,1776,6535,8311
2021/02/16,11:00:00,153.54,1800,6470,8270
2021/02/16,11:30:00,153.69,1806,6415,8221
2021/02/16,12:00:00,153.73,1804,6420,8224
2021/02/16,12:30:00,153.57,1701,6590,8291
2021/02/16,13:00:00,153.97,1675,6448,8123
2021/02/16,13:30:00,153.8,1547,6579,8126
2021/02/16,14:00:00,153.49,1349,6746,8095
2021/02/16,14:30:00,153.3,828,7187,8015
2021/02/16,15:00:00,160.43,558,7598,8156
2021/02/16,15:30:00,162.37,456,7818,8274
2021/02/16,16:00:00,166.26,315,8104,8419
2021/02/16,16:30:00,165.92,253,8562,8815
2021/02/16,17:00:00,232.96,84,9173,9257
2021/02/16,17:30:00,237.08,20,9780,9800
2021/02/16,18:00:00,239.92,17,10271,10288
2021/02/16,18:30:00,240.22,20,10441,10461
2021/02/16,19:00:00,240.22,19,10479,10498
2021/02/16,19:30:00,239.55,19,10513,10532
2021/02/16,20:00:00,239.92,6,10423,10429
2021/02/16,20:30:00,239.2,17,10222,10239
2021/02/16,21:00:00,233.82,18,9958,9976
2021/02/16,21:30:00,233.08,18,9696,9714
2021/02/16,22:00:00,233.08,16,9311,9327
2021/02/16,22:30:00,233.13,16,9008,9024
2021/02/16,23:00:00,233.13,19,8522,8541
2021/02/16,23:30:00,162.33,11,8049,8060
2021/02/17,00:00:00,184.02,1,7557,7558
2021/02/17,00:30:00,155.64,2,7134,7136
2021/02/17,01:00:00,156.24,6,7049,7055
2021/02/17,01:30:00,156.24,12,6799,6811
2021/02/17,02:00:00,155.58,13,6622,6635
2021/02/17,02:30:00,155.64,11,6513,6524
2021/02/17,03:00:00,155.64,15,6389,6404
2021/02/17,03:30:00,155.64,12,6387,6399
2021/02/17,04:00:00,155.64,16,6396,6412
2021/02/17,04:30:00,155.58,6,6556,6562
2021/02/17,05:00:00,155.64,10,6797,6807
2021/02/17,05:30:00,155.64,17,7097,7114
2021/02/17,06:00:00,154.31,16,7302,7318
2021/02/17,06:30:00,156.24,13,7681,7694
2021/02/17,07:00:00,164.43,94,8111,8205
2021/02/17,07:30:00,166.95,381,8592,8973
2021/02/17,08:00:00,201.43,567,8817,9384
2021/02/17,08:30:00,263.17,867,9001,9868
2021/02/17,09:00:00,263.91,972,9416,10388
2021/02/17,09:30:00,265.51,692,9813,10505
2021/02/17,10:00:00,264.7,1087,9793,10880
2021/02/17,10:30:00,264.7,1045,9992,11037
2021/02/17,11:00:00,263.91,1093,10037,11130
2021/02/17,11:30:00,264.7,955,10250,11205
2021/02/17,12:00:00,265.51,1088,10271,11359
2021/02/17,12:30:00,266.37,897,10427,11324
2021/02/17,13:00:00,262.83,828,10523,11351
2021/02/17,13:30:00,263.17,1135,10544,11679
2021/02/17,14:00:00,261.79,1050,10556,11606
2021/02/17,14:30:00,263.17,654,10837,11491
2021/02/17,15:00:00,263.91,392,11028,11420
2021/02/17,15:30:00,263.91,438,11175,11613
2021/02/17,16:00:00,263.17,339,11259,11598
2021/02/17,16:30:00,263.17,265,11473,11738
2021/02/17,17:00:00,263.17,19,11847,11866
2021/02/17,17:30:00,261.79,11,12403,12414
2021/02/17,18:00:00,263.17,6,12746,12752
2021/02/17,18:30:00,263.17,9,12821,12830
2021/02/17,19:00:00,262.46,12,12784,12796
2021/02/17,19:30:00,263.17,5,12704,12709
2021/02/17,20:00:00,263.17,8,12534,12542
2021/02/17,20:30:00,262.83,6,12270,12276
2021/02/17,21:00:00,262.83,5,12015,12020
2021/02/17,21:30:00,261.18,5,11537,11542
2021/02/17,22:00:00,260.43,1,11011,11012
2021/02/17,22:30:00,259.72,1,10612,10613
2021/02/17,23:00:00,260.43,3,9992,9995
2021/02/17,23:30:00,201.23,2,9326,9328
2021/02/18,00:00:00,218.2,0,8663,8663
2021/02/18,00:30:00,194.54,0,8307,8307
2021/02/18,01:00:00,194.09,5,7871,7876
2021/02/18,01:30:00,171.53,3,7547,7550
2021/02/18,02:00:00,170.97,3,7326,7329
2021/02/18,02:30:00,170.97,1,7115,7116
2021/02/18,03:00:00,171.53,1,6987,6988
2021/02/18,03:30:00,171.53,2,6994,6996
2021/02/18,04:00:00,172.09,3,6997,7000
2021/02/18,04:30:00,170.97,2,7178,7180
2021/02/18,05:00:00,167.65,2,7394,7396
2021/02/18,05:30:00,170.29,2,7696,7698
2021/02/18,06:00:00,170.3,2,7922,7924
2021/02/18,06:30:00,223.58,2,8284,8286
2021/02/18,07:00:00,223.58,90,8789,8879
2021/02/18,07:30:00,219.29,311,9366,9677
2021/02/18,08:00:00,297.91,240,9807,10047
2021/02/18,08:30:00,291.22,353,10143,10496
2021/02/18,09:00:00,291.22,379,10208,10587
2021/02/18,09:30:00,291.22,491,10302,10793
2021/02/18,10:00:00,291.22,780,10366,11146
2021/02/18,10:30:00,281.9,724,10668,11392
2021/02/18,11:00:00,283.22,622,10737,11359
2021/02/18,11:30:00,282.2,560,10814,11374
2021/02/18,12:00:00,284.44,655,10593,11248
2021/02/18,12:30:00,283.22,573,10629,11202
2021/02/18,13:00:00,289.68,591,10512,11103
2021/02/18,13:30:00,290.43,464,10508,10972
2021/02/18,14:00:00,295.78,393,10320,10713
2021/02/18,14:30:00,284.59,481,10226,10707
2021/02/18,15:00:00,287.38,451,10196,10647
2021/02/18,15:30:00,287.38,401,10371,10772
2021/02/18,16:00:00,286.63,353,10243,10596
2021/02/18,16:30:00,286.63,255,10472,10727
2021/02/18,17:00:00,286.63,10,10885,10895
2021/02/18,17:30:00,286.63,2,11455,11457
2021/02/18,18:00:00,291.22,4,12045,12049
2021/02/18,18:30:00,290.43,5,12251,12256
2021/02/18,19:00:00,291.22,3,12246,12249
2021/02/18,19:30:00,291.22,3,12244,12247
2021/02/18,20:00:00,291.22,7,12109,12116
2021/02/18,20:30:00,290.43,1,11921,11922
2021/02/18,21:00:00,291.22,1,11644,11645
2021/02/18,21:30:00,291.22,1,11317,11318
2021/02/18,22:00:00,292.05,0,10827,10827
2021/02/18,22:30:00,292.92,2,10548,10550
2021/02/18,23:00:00,292.54,1,10018,10019
2021/02/18,23:30:00,259.41,1,9445,9446
2021/02/19,00:00:00,258.86,1,8794,8795
2021/02/19,00:30:00,219.29,1,8236,8237
2021/02/19,01:00:00,194.98,1,8066,8067
2021/02/19,01:30:00,170.55,1,7687,7688
2021/02/19,02:00:00,170.44,2,7408,7410
2021/02/19,02:30:00,173.68,2,7184,7186
2021/02/19,03:00:00,182.34,1,7024,7025
2021/02/19,03:30:00,181.84,1,6950,6951
2021/02/19,04:00:00,181.84,3,6899,6902
2021/02/19,04:30:00,181.84,3,6993,6996
2021/02/19,05:00:00,182.34,3,7144,7147
2021/02/19,05:30:00,182.34,4,7318,7322
2021/02/19,06:00:00,182.84,3,7489,7492
2021/02/19,06:30:00,182.34,2,7614,7616
2021/02/19,07:00:00,170.31,100,7860,7960
2021/02/19,07:30:00,170.57,289,8237,8526
2021/02/19,08:00:00,223.35,495,8656,9151
2021/02/19,08:30:00,283.29,569,9105,9674
2021/02/19,09:00:00,281.67,689,9425,10114
2021/02/19,09:30:00,290.84,796,9707,10503
2021/02/19,10:00:00,292.05,879,10051,10930
2021/02/19,10:30:00,292.92,1065,10246,11311
2021/02/19,11:00:00,291.22,1144,10347,11491
2021/02/19,11:30:00,292.92,1148,10616,11764
2021/02/19,12:00:00,290.43,906,10846,11752
2021/02/19,12:30:00,292.05,868,11025,11893
2021/02/19,13:00:00,292.05,565,11210,11775
2021/02/19,13:30:00,292.92,499,11086,11585
2021/02/19,14:00:00,291.22,432,10818,11250
2021/02/19,14:30:00,291.22,326,10797,11123
2021/02/19,15:00:00,292.05,284,10860,11144
2021/02/19,15:30:00,291.22,235,10959,11194
2021/02/19,16:00:00,291.22,148,10983,11131
2021/02/19,16:30:00,291.22,135,11230,11365
2021/02/19,17:00:00,288.28,9,11366,11375
2021/02/19,17:30:00,290.84,2,11332,11334
2021/02/19,18:00:00,291.22,3,11530,11533
2021/02/19,18:30:00,292.92,3,11363,11366
2021/02/19,19:00:00,290.43,2,11108,11110
2021/02/19,19:30:00,291.22,3,10809,10812
2021/02/19,20:00:00,288.17,1,10529,10530
2021/02/19,20:30:00,259.99,0,10439,10439
2021/02/19,21:00:00,217.08,1,10282,10283
2021/02/19,21:30:00,216.89,0,10134,10134
2021/02/19,22:00:00,216.98,0,9871,9871
2021/02/19,22:30:00,217.08,0,9564,9564
2021/02/19,23:00:00,216.7,0,9122,9122
2021/02/19,23:30:00,221.49,0,8711,8711
2021/02/20,00:00:00,180.25,1,8228,8229
2021/02/20,00:30:00,179.77,1,7816,7817
2021/02/20,01:00:00,179.77,1,7449,7450
2021/02/20,01:30:00,181.65,0,7169,7169
2021/02/20,02:00:00,181.19,0,6902,6902
2021/02/20,02:30:00,180.72,0,6726,6726
2021/02/20,03:00:00,181.19,0,6569,6569
2021/02/20,03:30:00,181.65,0,6502,6502
2021/02/20,04:00:00,181.19,0,6780,6780
2021/02/20,04:30:00,181.19,0,6850,6850
2021/02/20,05:00:00,181.19,0,6969,6969
2021/02/20,05:30:00,180.25,0,7095,7095
2021/02/20,06:00:00,181.19,0,7156,7156
2021/02/20,06:30:00,181.19,0,7103,7103
2021/02/20,07:00:00,181.19,104,7147,7251
2021/02/20,07:30:00,181.65,296,7183,7479
2021/02/20,08:00:00,181.19,564,7137,7701
2021/02/20,08:30:00,181.19,914,7180,8094
2021/02/20,09:00:00,181.19,1123,7113,8236
2021/02/20,09:30:00,181.65,1305,7025,8330
2021/02/20,10:00:00,181.19,1632,6824,8456
2021/02/20,10:30:00,181.19,1678,6886,8564
2021/02/20,11:00:00,181.19,1519,7116,8635
2021/02/20,11:30:00,182.11,1556,7070,8626
2021/02/20,12:00:00,181.65,1561,7064,8625
2021/02/20,12:30:00,181.65,1383,7109,8492
2021/02/20,13:00:00,182.1,1188,7173,8361
2021/02/20,13:30:00,182.1,1060,7189,8249
2021/02/20,14:00:00,181.64,1084,7168,8252
2021/02/20,14:30:00,182.1,1122,7154,8276
2021/02/20,15:00:00,181.64,1085,7234,8319
2021/02/20,15:30:00,223.35,947,7454,8401
2021/02/20,16:00:00,223.35,686,7874,8560
2021/02/20,16:30:00,216.13,367,8436,8803
2021/02/20,17:00:00,215.39,13,8623,8636
2021/02/20,17:30:00,254.17,2,9290,9292
2021/02/20,18:00:00,291.22,2,10070,10072
2021/02/20,18:30:00,289.68,2,10699,10701
2021/02/20,19:00:00,287.64,1,10948,10949
2021/02/20,19:30:00,292.05,1,11042,11043
2021/02/20,20:00:00,291.22,0,11013,11013
2021/02/20,20:30:00,288.58,0,10908,10908
2021/02/20,21:00:00,289.3,0,10813,10813
2021/02/20,21:30:00,290.05,0,10644,10644
2021/02/20,22:00:00,286.63,0,10363,10363
2021/02/20,22:30:00,248.12,0,10039,10039
2021/02/20,23:00:00,223.35,0,9529,9529
2021/02/20,23:30:00,223.58,0,8954,8954
2021/02/21,00:00:00,223.35,0,8292,8292
2021/02/21,00:30:00,182.55,0,7699,7699
2021/02/21,01:00:00,181.64,0,7255,7255
2021/02/21,01:30:00,182.1,0,7177,7177
2021/02/21,02:00:00,181.64,0,6905,6905
2021/02/21,02:30:00,181.64,0,6687,6687
2021/02/21,03:00:00,181.64,0,6566,6566
2021/02/21,03:30:00,181.18,0,6524,6524
2021/02/21,04:00:00,181.18,0,6541,6541
2021/02/21,04:30:00,181.64,0,6659,6659
2021/02/21,05:00:00,180.24,0,6892,6892
2021/02/21,05:30:00,167.58,0,7251,7251
2021/02/21,06:00:00,168.84,1,7506,7507
2021/02/21,06:30:00,168.53,2,7998,8000
2021/02/21,07:00:00,168.76,178,8296,8474
2021/02/21,07:30:00,168,530,8388,8918
2021/02/21,08:00:00,169.67,909,8129,9038
2021/02/21,08:30:00,170.07,1202,8085,9287
2021/02/21,09:00:00,169.91,1493,7887,9380
2021/02/21,09:30:00,179.76,1670,7718,9388
2021/02/21,10:00:00,179.76,1754,7529,9283
2021/02/21,10:30:00,179.76,1850,7360,9210
2021/02/21,11:00:00,180.24,1887,7229,9116
2021/02/21,11:30:00,179.76,1914,7164,9078
2021/02/21,12:00:00,185.76,1946,7084,9030
2021/02/21,12:30:00,185.06,1923,7052,8975
2021/02/21,13:00:00,222.49,1857,7058,8915
2021/02/21,13:30:00,223.35,1857,7079,8936
2021/02/21,14:00:00,223.35,1721,7219,8940
2021/02/21,14:30:00,223.35,1619,7324,8943
2021/02/21,15:00:00,223.35,1517,7517,9034
2021/02/21,15:30:00,223.35,1339,7712,9051
2021/02/21,16:00:00,223.58,1057,7874,8931
2021/02/21,16:30:00,223.13,692,8451,9143
2021/02/21,17:00:00,220.41,325,9131,9456
2021/02/21,17:30:00,226,97,9949,10046
2021/02/21,18:00:00,296.82,98,10868,10966
2021/02/21,18:30:00,293.45,109,11251,11360
2021/02/21,19:00:00,292.92,111,11469,11580
2021/02/21,19:30:00,292.92,111,11573,11684
2021/02/21,20:00:00,293.45,112,11572,11684
2021/02/21,20:30:00,293.83,112,11450,11562
2021/02/21,21:00:00,293.83,70,11322,11392
2021/02/21,21:30:00,293.45,29,11043,11072
2021/02/21,22:00:00,289.87,1,10623,10624
2021/02/21,22:30:00,289,2,10213,10215
2021/02/21,23:00:00,223.35,3,9577,9580
2021/02/21,23:30:00,223.35,3,8825,8828
2021/02/22,00:00:00,159.55,5,8147,8152
2021/02/22,00:30:00,153.88,7,7596,7603
2021/02/22,01:00:00,153.88,7,7177,7184
2021/02/22,01:30:00,154.47,11,6863,6874
2021/02/22,02:00:00,155.06,11,6920,6931
2021/02/22,02:30:00,153.88,16,6790,6806
2021/02/22,03:00:00,153.88,13,6659,6672
2021/02/22,03:30:00,153.88,14,6639,6653
2021/02/22,04:00:00,154.47,12,6700,6712
2021/02/22,04:30:00,154.47,14,6808,6822
2021/02/22,05:00:00,147.26,13,7062,7075
2021/02/22,05:30:00,147.85,16,7399,7415
2021/02/22,06:00:00,147.63,16,7632,7648
2021/02/22,06:30:00,147.78,17,8059,8076
2021/02/22,07:00:00,187.21,174,8204,8378
2021/02/22,07:30:00,254.84,475,8360,8835
2021/02/22,08:00:00,249.63,841,8076,8917
2021/02/22,08:30:00,250.27,1195,7957,9152
2021/02/22,09:00:00,162.56,1415,7770,9185
2021/02/22,09:30:00,161.76,1574,7657,9231
2021/02/22,10:00:00,162.72,1637,7460,9097
2021/02/22,10:30:00,162.16,1783,7370,9153
2021/02/22,11:00:00,159.04,1765,7224,8989
2021/02/22,11:30:00,159.27,1801,7156,8957
2021/02/22,12:00:00,159.34,1706,7271,8977
2021/02/22,12:30:00,163.88,1697,7203,8900
2021/02/22,13:00:00,160.1,1550,7267,8817
2021/02/22,13:30:00,161.27,1251,7484,8735
2021/02/22,14:00:00,191.58,1262,7489,8751
2021/02/22,14:30:00,192.84,1055,7825,8880
2021/02/22,15:00:00,187.29,1000,7763,8763
2021/02/22,15:30:00,190.85,884,7990,8874
2021/02/22,16:00:00,191.78,648,8190,8838
2021/02/22,16:30:00,191.78,419,8510,8929
2021/02/22,17:00:00,230.5,191,9030,9221
2021/02/22,17:30:00,263.13,54,9806,9860
2021/02/22,18:00:00,250.27,10,10524,10534
2021/02/22,18:30:00,249.63,9,10902,10911
2021/02/22,19:00:00,250.27,12,11073,11085
2021/02/22,19:30:00,251.65,12,11133,11145
2021/02/22,20:00:00,250.95,15,11092,11107
2021/02/22,20:30:00,251.65,18,11035,11053
2021/02/22,21:00:00,250.95,17,10823,10840
2021/02/22,21:30:00,250.95,18,10538,10556
2021/02/22,22:00:00,250.95,18,10051,10069
2021/02/22,22:30:00,195.69,17,9721,9738
2021/02/22,23:00:00,191.78,14,9174,9188
2021/02/22,23:30:00,191.58,15,8516,8531
2021/02/23,00:00:00,192.71,16,7872,7888
2021/02/23,00:30:00,153.88,11,7355,7366
2021/02/23,01:00:00,153.28,13,7105,7118
2021/02/23,01:30:00,153.88,9,6912,6921
2021/02/23,02:00:00,154.47,15,6733,6748
2021/02/23,02:30:00,153.88,10,6526,6536
2021/02/23,03:00:00,153.88,13,6478,6491
2021/02/23,03:30:00,153.28,13,6430,6443
2021/02/23,04:00:00,153.88,10,6430,6440
2021/02/23,04:30:00,154.47,11,6561,6572
2021/02/23,05:00:00,145.64,10,6792,6802
2021/02/23,05:30:00,146.25,13,7115,7128
2021/02/23,06:00:00,156.63,10,7297,7307
2021/02/23,06:30:00,156.76,15,7752,7767
2021/02/23,07:00:00,190.42,123,8185,8308
2021/02/23,07:30:00,190.42,251,8240,8491
2021/02/23,08:00:00,180.96,400,8077,8477
2021/02/23,08:30:00,180.63,457,8082,8539
2021/02/23,09:00:00,209.68,593,8038,8631
2021/02/23,09:30:00,204.65,778,7903,8681
2021/02/23,10:00:00,190.42,1127,7584,8711
2021/02/23,10:30:00,190.73,1386,7367,8753
2021/02/23,11:00:00,159.01,1440,7275,8715
2021/02/23,11:30:00,156.79,1491,7230,8721
2021/02/23,12:00:00,157.33,1433,7266,8699
2021/02/23,12:30:00,157.33,1282,7324,8606
2021/02/23,13:00:00,156.79,1381,7358,8739
2021/02/23,13:30:00,192.14,1188,7571,8759
2021/02/23,14:00:00,192.32,1050,7662,8712
2021/02/23,14:30:00,191.77,1042,7761,8803
2021/02/23,15:00:00,192.14,873,8040,8913
2021/02/23,15:30:00,192.51,660,8339,8999
2021/02/23,16:00:00,187.05,516,8421,8937
2021/02/23,16:30:00,187.13,306,8841,9147
2021/02/23,17:00:00,185.41,170,9345,9515
2021/02/23,17:30:00,248.83,13,9950,9963
2021/02/23,18:00:00,252.12,9,10573,10582
2021/02/23,18:30:00,252.12,7,10764,10771
2021/02/23,19:00:00,252.12,6,10823,10829
2021/02/23,19:30:00,252.12,4,10830,10834
2021/02/23,20:00:00,252.12,4,10751,10755
2021/02/23,20:30:00,252.83,4,10592,10596
2021/02/23,21:00:00,252.12,5,10387,10392
2021/02/23,21:30:00,250.8,4,10041,10045
2021/02/23,22:00:00,185.35,4,9659,9663
2021/02/23,22:30:00,186.74,5,9387,9392
2021/02/23,23:00:00,192.51,6,8826,8832
2021/02/23,23:30:00,192.71,3,8248,8251
2021/02/24,00:00:00,178.21,1,7696,7697
2021/02/24,00:30:00,156.79,2,7190,7192
2021/02/24,01:00:00,156.79,2,6952,6954
2021/02/24,01:30:00,156.79,2,6804,6806
2021/02/24,02:00:00,157.36,2,6618,6620
2021/02/24,02:30:00,156.79,2,6480,6482
2021/02/24,03:00:00,156.79,2,6364,6366
2021/02/24,03:30:00,156.79,1,6336,6337
2021/02/24,04:00:00,157.36,2,6362,6364
2021/02/24,04:30:00,157.36,3,6480,6483
2021/02/24,05:00:00,156.79,2,6687,6689
2021/02/24,05:30:00,157.36,1,7012,7013
2021/02/24,06:00:00,156.79,0,7214,7214
2021/02/24,06:30:00,157.36,0,7522,7522
2021/02/24,07:00:00,157.36,117,7879,7996
2021/02/24,07:30:00,157.36,364,7935,8299
2021/02/24,08:00:00,157.36,643,7642,8285
2021/02/24,08:30:00,151.45,949,7494,8443
2021/02/24,09:00:00,153.28,1208,7163,8371
2021/02/24,09:30:00,152.67,1438,6938,8376
2021/02/24,10:00:00,152.06,1624,6686,8310
2021/02/24,10:30:00,151.45,1763,6505,8268
2021/02/24,11:00:00,152.06,1845,6445,8290
2021/02/24,11:30:00,151.45,1868,6330,8198
2021/02/24,12:00:00,152.67,1904,6283,8187
2021/02/24,12:30:00,153.28,1882,6277,8159
2021/02/24,13:00:00,152.06,1864,6321,8185
2021/02/24,13:30:00,152.06,1784,6287,8071
2021/02/24,14:00:00,152.67,1721,6347,8068
2021/02/24,14:30:00,152.67,1551,6536,8087
2021/02/24,15:00:00,152.06,1258,6790,8048
2021/02/24,15:30:00,154.47,1057,7059,8116
2021/02/24,16:00:00,178.04,793,7148,7941
2021/02/24,16:30:00,178.21,504,7563,8067
2021/02/24,17:00:00,178.21,285,8079,8364
2021/02/24,17:30:00,218.14,116,8731,8847
2021/02/24,18:00:00,233.37,74,9540,9614
2021/02/24,18:30:00,232.24,43,9929,9972
2021/02/24,19:00:00,235.34,14,10051,10065
2021/02/24,19:30:00,233.99,14,10109,10123
2021/02/24,20:00:00,233.99,14,10070,10084
2021/02/24,20:30:00,234.65,14,9991,10005
2021/02/24,21:00:00,234.65,11,9832,9843
2021/02/24,21:30:00,223.98,10,9591,9601
2021/02/24,22:00:00,235.04,10,9205,9215
2021/02/24,22:30:00,233.99,10,8984,8994
2021/02/24,23:00:00,233.99,12,8584,8596
2021/02/24,23:30:00,233.07,9,8076,8085
2021/02/25,00:00:00,182.34,8,7539,7547
2021/02/25,00:30:00,155.64,7,7089,7096
2021/02/25,01:00:00,155.06,8,6752,6760
2021/02/25,01:30:00,154.47,8,6453,6461
2021/02/25,02:00:00,155.06,7,6239,6246
2021/02/25,02:30:00,155.06,4,6256,6260
2021/02/25,03:00:00,154.47,4,6133,6137
2021/02/25,03:30:00,155.06,3,6118,6121
2021/02/25,04:00:00,154.47,3,6151,6154
2021/02/25,04:30:00,154.47,2,6273,6275
2021/02/25,05:00:00,148.02,2,6464,6466
2021/02/25,05:30:00,153.88,1,6608,6609
2021/02/25,06:00:00,154.47,1,6691,6692
2021/02/25,06:30:00,146.43,1,6914,6915
2021/02/25,07:00:00,154.47,167,7053,7220
2021/02/25,07:30:00,155.06,446,7164,7610
2021/02/25,08:00:00,154.47,754,7019,7773
2021/02/25,08:30:00,157.89,1166,6930,8096
2021/02/25,09:00:00,154.47,1492,6806,8298
2021/02/25,09:30:00,152.06,1657,6712,8369
2021/02/25,10:00:00,150.83,1663,6718,8381
2021/02/25,10:30:00,152.06,1674,6692,8366
2021/02/25,11:00:00,151.45,1749,6702,8451
2021/02/25,11:30:00,150.83,1767,6589,8356
2021/02/25,12:00:00,151.45,1860,6556,8416
2021/02/25,12:30:00,151.45,1821,6540,8361
2021/02/25,13:00:00,152.06,1783,6594,8377
2021/02/25,13:30:00,151.45,1790,6599,8389
2021/02/25,14:00:00,150.83,1664,6677,8341
2021/02/25,14:30:00,150.2,1571,6761,8332
2021/02/25,15:00:00,150.2,1391,6730,8121
2021/02/25,15:30:00,152.06,1193,6984,8177
2021/02/25,16:00:00,150.83,951,7170,8121
2021/02/25,16:30:00,182.7,640,7609,8249
2021/02/25,17:00:00,182.7,334,8043,8377
2021/02/25,17:30:00,179.86,120,8520,8640
2021/02/25,18:00:00,237.65,116,9163,9279
2021/02/25,18:30:00,239.87,118,9355,9473
2021/02/25,19:00:00,238.36,118,9478,9596
2021/02/25,19:30:00,238.36,101,9577,9678
2021/02/25,20:00:00,238.36,41,9531,9572
2021/02/25,20:30:00,238.36,22,9452,9474
2021/02/25,21:00:00,238.36,0,9379,9379
2021/02/25,21:30:00,177.12,0,9115,9115
2021/02/25,22:00:00,177.12,1,8796,8797
2021/02/25,22:30:00,177.27,1,8619,8620
2021/02/25,23:00:00,177.12,1,8265,8266
2021/02/25,23:30:00,182.52,1,7862,7863
2021/02/26,00:00:00,160.38,1,7396,7397
2021/02/26,00:30:00,148.06,1,7039,7040
2021/02/26,01:00:00,148,1,6711,6712
2021/02/26,01:30:00,147.95,1,6402,6403
2021/02/26,02:00:00,144.69,1,6200,6201
2021/02/26,02:30:00,144.69,1,6216,6217
2021/02/26,03:00:00,144.54,1,6105,6106
2021/02/26,03:30:00,144.69,2,6043,6045
2021/02/26,04:00:00,144.69,2,6007,6009
2021/02/26,04:30:00,144.54,2,6096,6098
2021/02/26,05:00:00,144.54,1,6236,6237
2021/02/26,05:30:00,144.54,2,6444,6446
2021/02/26,06:00:00,148.36,2,6512,6514
2021/02/26,06:30:00,148.08,1,6603,6604
2021/02/26,07:00:00,147.99,177,6610,6787
2021/02/26,07:30:00,148,480,6584,7064
2021/02/26,08:00:00,148.15,853,6415,7268
2021/02/26,08:30:00,147.96,1212,6234,7446
2021/02/26,09:00:00,166.9,1188,6314,7502
2021/02/26,09:30:00,148.36,1348,6192,7540
2021/02/26,10:00:00,150.57,1468,6084,7552
2021/02/26,10:30:00,148.04,1556,5990,7546
2021/02/26,11:00:00,149.76,1606,5930,7536
2021/02/26,11:30:00,148.13,1636,5955,7591
2021/02/26,12:00:00,148.01,1646,5898,7544
2021/02/26,12:30:00,148.01,1643,5740,7383
2021/02/26,13:00:00,148.24,1617,5708,7325
2021/02/26,13:30:00,165.1,1559,5742,7301
2021/02/26,14:00:00,148.1,1458,5776,7234
2021/02/26,14:30:00,165.1,1341,5890,7231
2021/02/26,15:00:00,144.54,1204,5965,7169
2021/02/26,15:30:00,184.06,993,6256,7249
2021/02/26,16:00:00,156.1,757,6574,7331
2021/02/26,16:30:00,156.34,516,6923,7439
2021/02/26,17:00:00,184.06,227,7475,7702
2021/02/26,17:30:00,184.06,0,7787,7787
2021/02/26,18:00:00,201.99,0,8333,8333
2021/02/26,18:30:00,248.91,0,8519,8519
2021/02/26,19:00:00,249.59,0,8456,8456
2021/02/26,19:30:00,248.91,0,8336,8336
2021/02/26,20:00:00,249.59,0,8194,8194
2021/02/26,20:30:00,244.01,0,8165,8165
2021/02/26,21:00:00,204.72,0,8092,8092
2021/02/26,21:30:00,204.47,0,7969,7969
2021/02/26,22:00:00,197.17,1,7760,7761
2021/02/26,22:30:00,196.89,1,7531,7532
2021/02/26,23:00:00,164.43,1,7242,7243
2021/02/26,23:30:00,148.65,1,6914,6915
2021/02/27,00:00:00,144.69,2,6642,6644
2021/02/27,00:30:00,144.99,2,6352,6354
2021/02/27,01:00:00,144.69,2,6120,6122
2021/02/27,01:30:00,144.54,3,6172,6175
2021/02/27,02:00:00,144.54,2,6073,6075
2021/02/27,02:30:00,144.69,2,5980,5982
2021/02/27,03:00:00,144.69,1,5897,5898
2021/02/27,03:30:00,144.69,2,5851,5853
2021/02/27,04:00:00,144.54,2,5830,5832
2021/02/27,04:30:00,144.54,3,5918,5921
2021/02/27,05:00:00,144.54,2,6033,6035
2021/02/27,05:30:00,144.69,2,6110,6112
2021/02/27,06:00:00,144.69,2,6109,6111
2021/02/27,06:30:00,144.69,2,6045,6047
2021/02/27,07:00:00,144.54,178,5961,6139
2021/02/27,07:30:00,145.13,446,5815,6261
2021/02/27,08:00:00,144.84,839,5525,6364
2021/02/27,08:30:00,144.69,1140,5421,6561
2021/02/27,09:00:00,144.84,1394,5256,6650
2021/02/27,09:30:00,144.69,1612,5161,6773
2021/02/27,10:00:00,144.25,1731,4932,6663
2021/02/27,10:30:00,144.25,1802,4878,6680
2021/02/27,11:00:00,144.25,1854,4778,6632
2021/02/27,11:30:00,144.25,1779,4820,6599
2021/02/27,12:00:00,144.25,1687,4825,6512
2021/02/27,12:30:00,144.25,1611,4705,6316
2021/02/27,13:00:00,144.39,1603,4683,6286
2021/02/27,13:30:00,144.25,1561,4689,6250
2021/02/27,14:00:00,144.11,1362,4813,6175
2021/02/27,14:30:00,145.13,1235,4882,6117
2021/02/27,15:00:00,145.13,1065,5134,6199
2021/02/27,15:30:00,145.13,868,5377,6245
2021/02/27,16:00:00,145.13,564,5779,6343
2021/02/27,16:30:00,250.82,410,6075,6485
2021/02/27,17:00:00,250.82,268,6400,6668
2021/02/27,17:30:00,250.82,1,7026,7027
2021/02/27,18:00:00,226,1,7714,7715
2021/02/27,18:30:00,220.33,1,8198,8199
2021/02/27,19:00:00,220.2,1,8471,8472
2021/02/27,19:30:00,220.07,1,8610,8611
2021/02/27,20:00:00,223.81,1,8597,8598
2021/02/27,20:30:00,224.7,1,8540,8541
2021/02/27,21:00:00,225.32,0,8450,8450
2021/02/27,21:30:00,223.53,0,8389,8389
2021/02/27,22:00:00,224.1,0,8152,8152
2021/02/27,22:30:00,231.53,0,7882,7882
2021/02/27,23:00:00,182.22,0,7554,7554
2021/02/27,23:30:00,166.13,0,7180,7180
2021/02/28,00:00:00,170.79,0,6759,6759
2021/02/28,00:30:00,144.54,0,6397,6397
2021/02/28,01:00:00,144.25,1,6357,6358
2021/02/28,01:30:00,144.69,2,6155,6157
2021/02/28,02:00:00,144.39,1,5990,5991
2021/02/28,02:30:00,144.25,1,5830,5831
2021/02/28,03:00:00,144.25,0,5772,5772
2021/02/28,03:30:00,144.25,0,5749,5749
2021/02/28,04:00:00,144.25,0,5782,5782
2021/02/28,04:30:00,144.25,0,5912,5912
2021/02/28,05:00:00,144.25,1,6073,6074
2021/02/28,05:30:00,144.25,1,6039,6040
2021/02/28,06:00:00,144.64,1,6141,6142
2021/02/28,06:30:00,153.72,1,6488,6489
2021/02/28,07:00:00,176.17,124,6729,6853
2021/02/28,07:30:00,162.58,378,6835,7213
2021/02/28,08:00:00,156.98,571,6686,7257
2021/02/28,08:30:00,227.28,816,6721,7537
2021/02/28,09:00:00,226.58,990,6768,7758
2021/02/28,09:30:00,226.58,865,6874,7739
2021/02/28,10:00:00,166.26,1082,6775,7857
2021/02/28,10:30:00,163.15,1322,6585,7907
2021/02/28,11:00:00,163.2,1392,6526,7918
2021/02/28,11:30:00,163.2,1484,6370,7854
2021/02/28,12:00:00,165.47,1546,6292,7838
2021/02/28,12:30:00,165.49,1517,6278,7795
2021/02/28,13:00:00,165.53,1584,6301,7885
2021/02/28,13:30:00,173.18,1413,6311,7724
2021/02/28,14:00:00,172.85,1448,6408,7856
2021/02/28,14:30:00,173.36,1325,6562,7887
2021/02/28,15:00:00,203.5,1096,6762,7858
2021/02/28,15:30:00,204.23,1016,6866,7882
2021/02/28,16:00:00,183.7,795,6984,7779
2021/02/28,16:30:00,176.54,565,7360,7925
2021/02/28,17:00:00,183.7,302,7845,8147
2021/02/28,17:30:00,204.95,69,8292,8361
2021/02/28,18:00:00,227.62,14,9056,9070
2021/02/28,18:30:00,227.01,13,9388,9401
2021/02/28,19:00:00,227.62,12,9495,9507
2021/02/28,19:30:00,226.43,11,9548,9559
2021/02/28,20:00:00,227.62,9,9500,9509
2021/02/28,20:30:00,227.62,8,9388,9396
2021/02/28,21:00:00,227.01,8,9236,9244
2021/02/28,21:30:00,227.62,8,8967,8975
2021/02/28,22:00:00,227.62,7,8611,8618
2021/02/28,22:30:00,227.01,4,8381,8385
2021/02/28,23:00:00,227.62,5,7944,7949
2021/02/28,23:30:00,220.28,2,7447,7449
2021/03/01,00:00:00,220.38,1,6980,6981
2021/03/01,00:30:00,220.97,1,6621,6622
2021/03/01,01:00:00,169.93,2,6355,6357
2021/03/01,01:30:00,159.95,1,6121,6122
2021/03/01,02:00:00,159.95,1,6097,6098
2021/03/01,02:30:00,160.36,1,6013,6014
2021/03/01,03:00:00,160.36,2,6074,6076
2021/03/01,03:30:00,160.3,3,6038,6041
2021/03/01,04:00:00,160.06,3,6084,6087
2021/03/01,04:30:00,160.53,1,6218,6219
2021/03/01,05:00:00,160.24,1,6301,6302
2021/03/01,05:30:00,160.01,2,6548,6550
2021/03/01,06:00:00,160.53,3,6642,6645
2021/03/01,06:30:00,160.24,1,6891,6892
2021/03/01,07:00:00,194.2,174,7041,7215
2021/03/01,07:30:00,193.53,423,7177,7600
2021/03/01,08:00:00,193.87,622,7157,7779
2021/03/01,08:30:00,193.87,688,7293,7981
2021/03/01,09:00:00,207.33,911,7222,8133
2021/03/01,09:30:00,211.58,977,7439,8416
2021/03/01,10:00:00,211.81,1035,7524,8559
2021/03/01,10:30:00,211.13,1129,7612,8741
2021/03/01,11:00:00,211.13,1047,7695,8742
2021/03/01,11:30:00,224.05,1141,7644,8785
2021/03/01,12:00:00,224.05,1464,7589,9053
2021/03/01,12:30:00,222.89,1449,7803,9252
2021/03/01,13:00:00,225.33,1534,7852,9386
2021/03/01,13:30:00,223.46,1435,7985,9420
2021/03/01,14:00:00,226.74,1394,8018,9412
2021/03/01,14:30:00,224.68,1245,8124,9369
2021/03/01,15:00:00,224.05,1151,8129,9280
2021/03/01,15:30:00,224.68,937,8314,9251
2021/03/01,16:00:00,224.68,731,8432,9163
2021/03/01,16:30:00,222.89,502,8490,8992
2021/03/01,17:00:00,224.05,210,8792,9002
2021/03/01,17:30:00,247.33,36,9332,9368
2021/03/01,18:00:00,240.46,1,10037,10038
2021/03/01,18:30:00,232.56,2,10308,10310
2021/03/01,19:00:00,234.48,0,10392,10392
2021/03/01,19:30:00,236.48,0,10410,10410
2021/03/01,20:00:00,230.77,1,10303,10304
2021/03/01,20:30:00,236.48,0,10200,10200
2021/03/01,21:00:00,242.88,0,9969,9969
2021/03/01,21:30:00,241.02,0,9598,9598
2021/03/01,22:00:00,241.59,0,9313,9313
2021/03/01,22:30:00,219.3,0,8888,8888
2021/03/01,23:00:00,218.95,0,8370,8370
2021/03/01,23:30:00,222.25,0,7814,7814
2021/03/02,00:00:00,220.7,0,7314,7314
2021/03/02,00:30:00,219.01,0,6837,6837
2021/03/02,01:00:00,195.5,0,6487,6487
2021/03/02,01:30:00,195.5,0,6208,6208
2021/03/02,02:00:00,195.17,0,6199,6199
2021/03/02,02:30:00,160.65,0,6206,6206
2021/03/02,03:00:00,160.84,0,6119,6119
2021/03/02,03:30:00,160.9,0,6113,6113
2021/03/02,04:00:00,160.84,0,6125,6125
2021/03/02,04:30:00,160.65,0,6268,6268
2021/03/02,05:00:00,160.78,0,6505,6505
2021/03/02,05:30:00,160.9,0,6736,6736
2021/03/02,06:00:00,195.17,0,6848,6848
2021/03/02,06:30:00,212.04,0,7160,7160
2021/03/02,07:00:00,212.26,134,7417,7551
2021/03/02,07:30:00,212.04,298,7475,7773
2021/03/02,08:00:00,224.4,550,7323,7873
2021/03/02,08:30:00,225.06,778,7422,8200
2021/03/02,09:00:00,225.06,997,7348,8345
2021/03/02,09:30:00,225.06,1142,7224,8366
2021/03/02,10:00:00,160.9,1181,7245,8426
2021/03/02,10:30:00,160.78,1365,7133,8498
2021/03/02,11:00:00,160.84,1473,7093,8566
2021/03/02,11:30:00,161.15,1652,6895,8547
2021/03/02,12:00:00,161.08,1823,6717,8540
2021/03/02,12:30:00,161.08,1839,6725,8564
2021/03/02,13:00:00,160.53,1789,6727,8516
2021/03/02,13:30:00,160.84,1787,6748,8535
2021/03/02,14:00:00,169.55,1772,6720,8492
2021/03/02,14:30:00,169.55,1622,6840,8462
2021/03/02,15:00:00,169.55,1467,7007,8474
2021/03/02,15:30:00,169.72,1293,7164,8457
2021/03/02,16:00:00,169.89,1007,7181,8188
2021/03/02,16:30:00,169.72,652,7587,8239
2021/03/02,17:00:00,169.55,349,8128,8477
2021/03/02,17:30:00,247.38,409,8764,9173
2021/03/02,18:00:00,248.4,112,9587,9699
2021/03/02,18:30:00,246.97,108,9990,10098
2021/03/02,19:00:00,245.38,10,10221,10231
2021/03/02,19:30:00,220.84,7,10271,10278
2021/03/02,20:00:00,220.98,8,10230,10238
2021/03/02,20:30:00,221.55,10,10165,10175
2021/03/02,21:00:00,222.81,6,9961,9967
2021/03/02,21:30:00,221.98,8,9673,9681
2021/03/02,22:00:00,221.98,4,9381,9385
2021/03/02,22:30:00,191.3,2,8999,9001
2021/03/02,23:00:00,191.3,3,8526,8529
2021/03/02,23:30:00,191.3,2,7966,7968
2021/03/03,00:00:00,161.08,2,7377,7379
2021/03/03,00:30:00,161.4,1,6959,6960
2021/03/03,01:00:00,161.4,1,6599,6600
2021/03/03,01:30:00,167.1,1,6331,6332
2021/03/03,02:00:00,167.1,1,6406,6407
2021/03/03,02:30:00,161.46,1,6285,6286
2021/03/03,03:00:00,161.02,1,6230,6231
2021/03/03,03:30:00,161.27,0,6191,6191
2021/03/03,04:00:00,167.1,0,6199,6199
2021/03/03,04:30:00,161.33,0,6333,6333
2021/03/03,05:00:00,161.21,0,6554,6554
2021/03/03,05:30:00,167.1,0,6875,6875
2021/03/03,06:00:00,197.13,0,6963,6963
2021/03/03,06:30:00,196.81,0,7246,7246
2021/03/03,07:00:00,197.13,240,7499,7739
2021/03/03,07:30:00,197.13,479,7523,8002
2021/03/03,08:00:00,167.1,697,7504,8201
2021/03/03,08:30:00,167.1,937,7550,8487
2021/03/03,09:00:00,161.21,1241,7421,8662
2021/03/03,09:30:00,167.1,1282,7521,8803
2021/03/03,10:00:00,167.1,1401,7532,8933
2021/03/03,10:30:00,167.1,1445,7397,8842
2021/03/03,11:00:00,167.1,1254,7515,8769
2021/03/03,11:30:00,167.1,1261,7330,8591
2021/03/03,12:00:00,167.1,1475,7285,8760
2021/03/03,12:30:00,167.1,1432,7295,8727
2021/03/03,13:00:00,167.1,1343,7417,8760
2021/03/03,13:30:00,169.35,1337,7501,8838
2021/03/03,14:00:00,165.78,1399,7631,9030
2021/03/03,14:30:00,169.52,1339,7655,8994
2021/03/03,15:00:00,165.78,1194,7840,9034
2021/03/03,15:30:00,166.16,1015,8156,9171
2021/03/03,16:00:00,169.69,853,8430,9283
2021/03/03,16:30:00,165.93,607,8818,9425
2021/03/03,17:00:00,211.35,249,9274,9523
2021/03/03,17:30:00,211.58,63,9784,9847
2021/03/03,18:00:00,250.81,9,10513,10522
2021/03/03,18:30:00,223.74,7,10805,10812
2021/03/03,19:00:00,225.02,5,10874,10879
2021/03/03,19:30:00,224.36,5,10884,10889
2021/03/03,20:00:00,224.36,2,10801,10803
2021/03/03,20:30:00,225.02,1,10657,10658
2021/03/03,21:00:00,225.7,0,10403,10403
2021/03/03,21:30:00,222.77,0,10031,10031
2021/03/03,22:00:00,222.62,0,9700,9700
2021/03/03,22:30:00,221.94,0,9318,9318
2021/03/03,23:00:00,172.62,0,8777,8777
2021/03/03,23:30:00,171.73,0,8249,8249
2021/03/05,00:00:00,168.97,1,8196,8197
2021/03/05,00:30:00,168.97,1,7680,7681
2021/03/05,01:00:00,166.08,3,7260,7263
2021/03/05,01:30:00,172.88,2,6892,6894
2021/03/05,02:00:00,172.96,2,6679,6681
2021/03/05,02:30:00,172.8,2,6752,6754
2021/03/05,03:00:00,173.04,2,6653,6655
2021/03/05,03:30:00,172.96,3,6593,6596
2021/03/05,04:00:00,172.96,3,6578,6581
2021/03/05,04:30:00,172.96,2,6660,6662
2021/03/05,05:00:00,172.96,1,6829,6830
2021/03/05,05:30:00,172.96,2,7025,7027
2021/03/05,06:00:00,172.88,1,6902,6903
2021/03/05,06:30:00,172.88,2,6893,6895
2021/03/05,07:00:00,173.13,235,6853,7088
2021/03/05,07:30:00,173.21,439,6958,7397
2021/03/05,08:00:00,172.96,848,6800,7648
2021/03/05,08:30:00,172.96,1166,6806,7972
2021/03/05,09:00:00,172.96,1423,6838,8261
2021/03/05,09:30:00,172.96,1505,6828,8333
2021/03/05,10:00:00,172.96,1477,6943,8420
2021/03/05,10:30:00,173.13,1504,6981,8485
2021/03/05,11:00:00,173.13,1505,7006,8511
2021/03/05,11:30:00,168.65,1540,6885,8425
2021/03/05,12:00:00,170.34,1736,6613,8349
2021/03/05,12:30:00,169.05,1794,6600,8394
2021/03/05,13:00:00,173.13,1829,6478,8307
2021/03/05,13:30:00,173.29,1711,6533,8244
2021/03/05,14:00:00,173.13,1676,6559,8235
2021/03/05,14:30:00,173.04,1560,6581,8141
2021/03/05,15:00:00,173.21,1493,6689,8182
2021/03/05,15:30:00,173.04,1326,6943,8269
2021/03/05,16:00:00,173.04,1096,7281,8377
2021/03/05,16:30:00,173.21,774,7608,8382
2021/03/05,17:00:00,223.27,421,8095,8516
2021/03/05,17:30:00,223.27,115,8424,8539
2021/03/05,18:00:00,223.27,114,8984,9098
2021/03/05,18:30:00,223.87,115,9168,9283
2021/03/05,19:00:00,223.27,114,9072,9186
2021/03/05,19:30:00,223.87,106,8900,9006
2021/03/05,20:00:00,223.27,50,8844,8894
2021/03/05,20:30:00,223.27,4,8731,8735
2021/03/05,21:00:00,223.87,3,8595,8598
2021/03/05,21:30:00,223.27,3,8436,8439
2021/03/05,22:00:00,220.93,1,8237,8238
2021/03/05,22:30:00,220.93,1,8060,8061
2021/03/05,23:00:00,220.79,1,7809,7810
2021/03/05,23:30:00,220.79,0,7476,7476
2021/03/06,00:00:00,172.96,0,7130,7130
2021/03/06,00:30:00,174.32,0,6818,6818
2021/03/06,01:00:00,172.96,0,6548,6548
2021/03/06,01:30:00,172.96,0,6311,6311
2021/03/06,02:00:00,172.96,0,6153,6153
2021/03/06,02:30:00,173.13,0,6174,6174
2021/03/06,03:00:00,172.96,0,6100,6100
2021/03/06,03:30:00,173.13,0,6220,6220
2021/03/06,04:00:00,173.13,0,6212,6212
2021/03/06,04:30:00,172.96,0,6292,6292
2021/03/06,05:00:00,172.96,0,6375,6375
2021/03/06,05:30:00,172.88,0,6488,6488
2021/03/06,06:00:00,172.96,1,6281,6282
2021/03/06,06:30:00,172.96,73,6225,6298
2021/03/06,07:00:00,172.96,321,6075,6396
2021/03/06,07:30:00,172.96,695,5871,6566
2021/03/06,08:00:00,173.13,1154,5665,6819
2021/03/06,08:30:00,173.13,1439,5536,6975
2021/03/06,09:00:00,172.88,1619,5455,7074
2021/03/06,09:30:00,172.88,1760,5400,7160
2021/03/06,10:00:00,173.13,1861,5304,7165
2021/03/06,10:30:00,172.88,1938,5270,7208
2021/03/06,11:00:00,173.13,1980,5155,7135
2021/03/06,11:30:00,172.96,2000,5100,7100
2021/03/06,12:00:00,172.96,2000,5038,7038
2021/03/06,12:30:00,173.13,1992,4952,6944
2021/03/06,13:00:00,173.13,1980,4927,6907
2021/03/06,13:30:00,173.13,1936,4930,6866
2021/03/06,14:00:00,207.74,1833,4803,6636
2021/03/06,14:30:00,200.28,1750,4867,6617
2021/03/06,15:00:00,173.04,1607,4883,6490
2021/03/06,15:30:00,173.04,1407,5163,6570
2021/03/06,16:00:00,172.88,1156,5542,6698
2021/03/06,16:30:00,173.04,793,6052,6845
2021/03/06,17:00:00,171.73,429,6687,7116
2021/03/06,17:30:00,224.48,267,7325,7592
2021/03/06,18:00:00,223.85,120,8165,8285
2021/03/06,18:30:00,223.85,122,8713,8835
2021/03/06,19:00:00,225.82,124,9079,9203
2021/03/06,19:30:00,224.48,124,9224,9348
2021/03/06,20:00:00,224.48,124,9186,9310
2021/03/06,20:30:00,225.13,124,9171,9295
2021/03/06,21:00:00,225.13,124,9018,9142
2021/03/06,21:30:00,224.48,124,8875,8999
2021/03/06,22:00:00,227.28,123,8602,8725
2021/03/06,22:30:00,226.53,32,8413,8445
2021/03/06,23:00:00,225.95,0,8077,8077
2021/03/06,23:30:00,224.2,0,7582,7582
2021/03/07,00:00:00,169.46,0,7137,7137
2021/03/07,00:30:00,165.71,0,6712,6712
2021/03/07,01:00:00,166.16,1,6361,6362
2021/03/07,01:30:00,166.08,1,6211,6212
2021/03/07,02:00:00,165.71,0,6156,6156
2021/03/07,02:30:00,166.08,1,6014,6015
2021/03/07,03:00:00,165.56,1,5928,5929
2021/03/07,03:30:00,165.93,1,5922,5923
2021/03/07,04:00:00,165.93,3,5948,5951
2021/03/07,04:30:00,165.71,2,6095,6097
2021/03/07,05:00:00,165.48,1,6298,6299
2021/03/07,05:30:00,165.41,2,6296,6298
2021/03/07,06:00:00,165.63,2,6356,6358
2021/03/07,06:30:00,165.56,3,6690,6693
2021/03/07,07:00:00,165.33,171,7010,7181
2021/03/07,07:30:00,165.78,370,7146,7516
2021/03/07,08:00:00,165.93,616,6961,7577
2021/03/07,08:30:00,165.48,786,6924,7710
2021/03/07,09:00:00,166.01,1063,6852,7915
2021/03/07,09:30:00,165.56,1165,6719,7884
2021/03/07,10:00:00,166.08,1497,6402,7899
2021/03/07,10:30:00,165.78,1647,6256,7903
2021/03/07,11:00:00,172.47,1832,6270,8102
2021/03/07,11:30:00,173.29,1904,6162,8066
2021/03/07,12:00:00,173.29,1925,6083,8008
2021/03/07,12:30:00,173.13,1944,6064,8008
2021/03/07,13:00:00,173.21,1932,6086,8018
2021/03/07,13:30:00,172.96,1908,5971,7879
2021/03/07,14:00:00,172.96,1844,6045,7889
2021/03/07,14:30:00,172.96,1716,6018,7734
2021/03/07,15:00:00,173.04,1565,6187,7752
2021/03/07,15:30:00,172.88,1392,6357,7749
2021/03/07,16:00:00,172.88,1128,6746,7874
2021/03/07,16:30:00,222.72,818,7191,8009
2021/03/07,17:00:00,223.88,439,7789,8228
2021/03/07,17:30:00,221.67,712,8474,9186
2021/03/07,18:00:00,219.64,134,9276,9410
2021/03/07,18:30:00,211.05,139,9743,9882
2021/03/07,19:00:00,223.88,137,9906,10043
2021/03/07,19:30:00,220.35,132,10036,10168
2021/03/07,20:00:00,220.94,126,9989,10115
2021/03/07,20:30:00,223.28,123,9896,10019
2021/03/07,21:00:00,223.28,50,9774,9824
2021/03/07,21:30:00,223.88,1,9508,9509
2021/03/07,22:00:00,223.28,2,9190,9192
2021/03/07,22:30:00,223.88,1,8793,8794
2021/03/07,23:00:00,221.56,1,8355,8356
2021/03/07,23:30:00,228.51,2,7797,7799
2021/03/08,00:00:00,169.51,2,7265,7267
2021/03/08,00:30:00,169.68,1,6839,6840
2021/03/08,01:00:00,166.08,2,6510,6512
2021/03/08,01:30:00,166.85,4,6254,6258
2021/03/08,02:00:00,165.56,3,6210,6213
2021/03/08,02:30:00,165.56,2,6235,6237
2021/03/08,03:00:00,165.78,3,6166,6169
2021/03/08,03:30:00,165.93,3,6129,6132
2021/03/08,04:00:00,165.41,2,6157,6159
2021/03/08,04:30:00,165.63,2,6319,6321
2021/03/08,05:00:00,166.16,3,6366,6369
2021/03/08,05:30:00,165.33,4,6473,6477
2021/03/08,06:00:00,165.63,2,6523,6525
2021/03/08,06:30:00,165.33,9,6849,6858
2021/03/08,07:00:00,165.48,248,7077,7325
2021/03/08,07:30:00,165.93,512,7116,7628
2021/03/08,08:00:00,178.2,694,6907,7601
2021/03/08,08:30:00,178.2,910,6779,7689
2021/03/08,09:00:00,165.86,1187,6613,7800
2021/03/08,09:30:00,178.2,1301,6618,7919
2021/03/08,10:00:00,178.2,1522,6661,8183
2021/03/08,10:30:00,178.2,1673,6503,8176
2021/03/08,11:00:00,165.78,1815,6459,8274
2021/03/08,11:30:00,165.56,1850,6408,8258
2021/03/08,12:00:00,165.93,1818,6394,8212
2021/03/08,12:30:00,165.93,1826,6324,8150
2021/03/08,13:00:00,165.41,1782,6353,8135
2021/03/08,13:30:00,170.74,1802,6396,8198
2021/03/08,14:00:00,173.13,1715,6458,8173
2021/03/08,14:30:00,173.62,1649,6565,8214
2021/03/08,15:00:00,172.8,1515,6713,8228
2021/03/08,15:30:00,172.63,1309,6957,8266
2021/03/08,16:00:00,172.55,1052,7291,8343
2021/03/08,16:30:00,172.55,720,7370,8090
2021/03/08,17:00:00,172.3,411,7871,8282
2021/03/08,17:30:00,223.72,127,8466,8593
2021/03/08,18:00:00,228.27,128,9225,9353
2021/03/08,18:30:00,222.57,120,9656,9776
2021/03/08,19:00:00,223.13,123,9774,9897
2021/03/08,19:30:00,223.13,120,9849,9969
2021/03/08,20:00:00,223.13,110,9813,9923
2021/03/08,20:30:00,223.13,54,9776,9830
2021/03/08,21:00:00,223.13,2,9633,9635
2021/03/08,21:30:00,223.72,1,9362,9363
2021/03/08,22:00:00,223.72,1,9097,9098
2021/03/08,22:30:00,220.65,0,8712,8712
2021/03/08,23:00:00,222.07,0,8218,8218
2021/03/08,23:30:00,220.2,1,7747,7748
2021/03/09,00:00:00,220.94,1,7252,7253
2021/03/09,00:30:00,172.88,2,6817,6819
2021/03/09,01:00:00,173.04,1,6493,6494
2021/03/09,01:30:00,172.96,1,6221,6222
2021/03/09,02:00:00,173.04,1,6180,6181
2021/03/09,02:30:00,173.13,1,6190,6191
2021/03/09,03:00:00,172.96,0,6156,6156
2021/03/09,03:30:00,173.04,0,6135,6135
2021/03/09,04:00:00,172.96,0,6160,6160
2021/03/09,04:30:00,169.21,0,6312,6312
2021/03/09,05:00:00,165.93,0,6462,6462
2021/03/09,05:30:00,166.54,0,6484,6484
2021/03/09,06:00:00,174.1,0,6490,6490
2021/03/09,06:30:00,165.48,7,6789,6796
2021/03/09,07:00:00,165.93,236,6952,7188
2021/03/09,07:30:00,166.01,485,7038,7523
2021/03/09,08:00:00,165.56,814,6742,7556
2021/03/09,08:30:00,165.93,1127,6589,7716
2021/03/09,09:00:00,165.86,1369,6376,7745
2021/03/09,09:30:00,167.31,1558,6203,7761
2021/03/09,10:00:00,166.31,1652,6227,7879
2021/03/09,10:30:00,166.16,1747,6082,7829
2021/03/09,11:00:00,166.46,1792,6016,7808
2021/03/09,11:30:00,166.01,1779,5978,7757
2021/03/09,12:00:00,166.69,1795,5913,7708
2021/03/09,12:30:00,166.01,1734,5953,7687
2021/03/09,13:00:00,166.01,1756,5964,7720
2021/03/09,13:30:00,165.48,1667,6086,7753
2021/03/09,14:00:00,165.56,1595,6107,7702
2021/03/09,14:30:00,166.23,1450,6209,7659
2021/03/09,15:00:00,166.46,1282,6448,7730
2021/03/09,15:30:00,169.3,1028,6723,7751
2021/03/09,16:00:00,169.46,729,6985,7714
2021/03/09,16:30:00,219.9,454,7379,7833
2021/03/09,17:00:00,165.48,243,7648,7891
2021/03/09,17:30:00,165.26,33,8138,8171
2021/03/09,18:00:00,223.28,0,8860,8860
2021/03/09,18:30:00,216.8,0,9253,9253
2021/03/09,19:00:00,216.66,0,9363,9363
2021/03/09,19:30:00,222.72,0,9401,9401
2021/03/09,20:00:00,223.88,0,9366,9366
2021/03/09,20:30:00,223.88,0,9286,9286
2021/03/09,21:00:00,224.5,1,9112,9113
2021/03/09,21:30:00,220.2,6,8815,8821
2021/03/09,22:00:00,220.2,6,8524,8530
2021/03/09,22:30:00,221.42,3,8176,8179
2021/03/09,23:00:00,220.2,1,7814,7815
2021/03/09,23:30:00,220.2,1,7372,7373
2021/03/10,00:00:00,169.75,2,6945,6947
2021/03/10,00:30:00,161.4,1,6572,6573
2021/03/10,01:00:00,162.5,3,6282,6285
2021/03/10,01:30:00,161.4,3,6206,6209
2021/03/10,02:00:00,161.52,3,6172,6175
2021/03/10,02:30:00,161.97,2,6055,6057
2021/03/10,03:00:00,162.24,2,5988,5990
2021/03/10,03:30:00,162.5,4,5958,5962
2021/03/10,04:00:00,162.24,3,5977,5980
2021/03/10,04:30:00,161.4,2,5987,5989
2021/03/10,05:00:00,161.78,2,6120,6122
2021/03/10,05:30:00,161.71,2,6219,6221
2021/03/10,06:00:00,162.91,2,6099,6101
2021/03/10,06:30:00,223.44,69,6351,6420
2021/03/10,07:00:00,224.04,234,6542,6776
2021/03/10,07:30:00,223.44,495,6622,7117
2021/03/10,08:00:00,226.14,751,6474,7225
2021/03/10,08:30:00,178.2,971,6340,7311
2021/03/10,09:00:00,162.44,1235,6105,7340
2021/03/10,09:30:00,162.57,1467,6127,7594
2021/03/10,10:00:00,162.5,1497,6130,7627
2021/03/10,10:30:00,162.1,1587,6032,7619
2021/03/10,11:00:00,162.17,1680,5909,7589
2021/03/10,11:30:00,162.57,1816,5792,7608
2021/03/10,12:00:00,162.44,1732,5863,7595
2021/03/10,12:30:00,162.17,1684,5964,7648
2021/03/10,13:00:00,162.3,1641,6092,7733
2021/03/10,13:30:00,162.57,1576,6155,7731
2021/03/10,14:00:00,161.97,1544,6226,7770
2021/03/10,14:30:00,162.77,1325,6366,7691
2021/03/10,15:00:00,162.44,1226,6514,7740
2021/03/10,15:30:00,163.11,939,6597,7536
2021/03/10,16:00:00,161.21,754,6762,7516
2021/03/10,16:30:00,159.28,402,7101,7503
2021/03/10,17:00:00,159.07,261,7316,7577
2021/03/10,17:30:00,163.06,29,7637,7666
2021/03/10,18:00:00,159.3,0,8132,8132
2021/03/10,18:30:00,167.1,0,8377,8377
2021/03/10,19:00:00,159.67,2,8403,8405
2021/03/10,19:30:00,167.1,1,8407,8408
2021/03/10,20:00:00,159.28,1,8335,8336
2021/03/10,20:30:00,163.09,1,8316,8317
2021/03/10,21:00:00,163.09,2,8253,8255
2021/03/10,21:30:00,163.09,1,8021,8022
2021/03/10,22:00:00,159.39,2,7753,7755
2021/03/10,22:30:00,162.48,5,7500,7505
2021/03/10,23:00:00,163.76,6,7200,7206
2021/03/10,23:30:00,159.23,6,6889,6895
2021/03/11,00:00:00,159.39,2,6552,6554
2021/03/11,00:30:00,160.78,2,6211,6213
2021/03/11,01:00:00,162.77,1,6001,6002
2021/03/11,01:30:00,162.77,1,5797,5798
2021/03/11,02:00:00,163.53,6,5789,5795
2021/03/11,02:30:00,162.57,7,5722,5729
2021/03/11,03:00:00,162.64,11,5776,5787
2021/03/11,03:30:00,162.64,10,5764,5774
2021/03/11,04:00:00,162.64,10,5794,5804
2021/03/11,04:30:00,162.5,14,5937,5951
2021/03/11,05:00:00,162.37,17,6106,6123
2021/03/11,05:30:00,162.57,16,6313,6329
2021/03/11,06:00:00,162.77,8,6271,6279
2021/03/11,06:30:00,162.98,9,6440,6449
2021/03/11,07:00:00,162.24,183,6634,6817
2021/03/11,07:30:00,162.17,478,6703,7181
2021/03/11,08:00:00,162.37,675,6530,7205
2021/03/11,08:30:00,162.24,942,6508,7450
2021/03/11,09:00:00,162.64,1264,6316,7580
2021/03/11,09:30:00,162.77,1417,6278,7695
2021/03/11,10:00:00,162.44,1503,6236,7739
2021/03/11,10:30:00,162.17,1639,6082,7721
2021/03/11,11:00:00,162.44,1656,6084,7740
2021/03/11,11:30:00,162.84,1640,5936,7576
2021/03/11,12:00:00,159.89,1573,5933,7506
2021/03/11,12:30:00,159.39,1682,6005,7687
2021/03/11,13:00:00,158.86,1532,6204,7736
2021/03/11,13:30:00,158.86,1428,6443,7871
2021/03/11,14:00:00,169.68,1347,6528,7875
2021/03/11,14:30:00,169.51,1161,6542,7703
2021/03/11,15:00:00,169.68,1099,6743,7842
2021/03/11,15:30:00,169.68,827,7031,7858
2021/03/11,16:00:00,168.81,619,7283,7902
2021/03/11,16:30:00,169.68,386,7633,8019
2021/03/11,17:00:00,168.97,264,7990,8254
2021/03/11,17:30:00,168.65,100,8418,8518
2021/03/11,18:00:00,224.65,101,8914,9015
2021/03/11,18:30:00,223.94,107,9092,9199
2021/03/11,19:00:00,221,104,9039,9143
2021/03/11,19:30:00,225.04,66,9026,9092
2021/03/11,20:00:00,220.86,5,8961,8966
2021/03/11,20:30:00,178.2,5,8905,8910
2021/03/11,21:00:00,178.2,7,8714,8721
2021/03/11,21:30:00,219.5,7,8501,8508
2021/03/11,22:00:00,178.2,11,8129,8140
2021/03/11,22:30:00,178.2,10,7938,7948
2021/03/11,23:00:00,178.2,16,7592,7608
2021/03/11,23:30:00,178.2,19,7243,7262
2021/03/12,00:00:00,169.69,19,6924,6943
2021/03/12,00:30:00,169.69,19,6602,6621
2021/03/12,01:00:00,169.93,19,6329,6348
2021/03/12,01:30:00,169.61,20,6092,6112
2021/03/12,02:00:00,169.53,20,6199,6219
2021/03/12,02:30:00,169.93,11,6086,6097
2021/03/12,03:00:00,169.93,16,5985,6001
2021/03/12,03:30:00,169.93,13,5941,5954
2021/03/12,04:00:00,169.69,14,5939,5953
2021/03/12,04:30:00,169.93,10,5999,6009
2021/03/12,05:00:00,169.69,13,6137,6150
2021/03/12,05:30:00,169.53,18,6321,6339
2021/03/12,06:00:00,169.69,16,6318,6334
2021/03/12,06:30:00,169.53,105,6444,6549
2021/03/12,07:00:00,169.69,157,6635,6792
2021/03/12,07:30:00,169.69,244,6673,6917
2021/03/12,08:00:00,169.93,396,6756,7152
2021/03/12,08:30:00,164.53,839,6663,7502
2021/03/12,09:00:00,165.14,1078,6470,7548
2021/03/12,09:30:00,165.06,964,6658,7622
2021/03/12,10:00:00,165.29,1109,6523,7632
2021/03/12,10:30:00,165.06,1200,6595,7795
2021/03/12,11:00:00,164.69,1242,6786,8028
2021/03/12,11:30:00,164.62,1278,6852,8130
2021/03/12,12:00:00,162.98,1393,6779,8172
2021/03/12,12:30:00,162.64,1196,6940,8136
2021/03/12,13:00:00,162.84,1200,6848,8048
2021/03/12,13:30:00,162.37,1032,6895,7927
2021/03/12,14:00:00,161.97,1148,6878,8026
2021/03/12,14:30:00,162.17,1342,6742,8084
2021/03/12,15:00:00,162.37,1202,6898,8100
2021/03/12,15:30:00,223.88,835,7192,8027
2021/03/12,16:00:00,225.16,788,7362,8150
2021/03/12,16:30:00,225.85,492,7604,8096
2021/03/12,17:00:00,224.51,352,8001,8353
2021/03/12,17:30:00,232.37,193,8177,8370
2021/03/12,18:00:00,232.37,115,8506,8621
2021/03/12,18:30:00,232.37,87,8655,8742
2021/03/12,19:00:00,232.37,49,8556,8605
2021/03/12,19:30:00,232.37,36,8395,8431
2021/03/12,20:00:00,225.85,24,8178,8202
2021/03/12,20:30:00,223.88,1,8090,8091
2021/03/12,21:00:00,223.63,16,7911,7927
2021/03/12,21:30:00,222.77,36,7748,7784
2021/03/12,22:00:00,222.77,48,7572,7620
2021/03/12,22:30:00,222.77,45,7366,7411
2021/03/12,23:00:00,164.63,50,7139,7189
2021/03/12,23:30:00,164.77,45,6866,6911
2021/03/13,00:00:00,164.77,38,6622,6660
2021/03/13,00:30:00,168.31,40,6326,6366
2021/03/13,01:00:00,158.46,36,6092,6128
2021/03/13,01:30:00,158.2,31,5927,5958
2021/03/13,02:00:00,158.25,35,5780,5815
2021/03/13,02:30:00,161.45,32,5646,5678
2021/03/13,03:00:00,164.84,32,5585,5617
2021/03/13,03:30:00,166.52,36,5554,5590
2021/03/13,04:00:00,168.33,32,5592,5624
2021/03/13,04:30:00,168.65,34,5651,5685
2021/03/13,05:00:00,168.41,31,5738,5769
2021/03/13,05:30:00,168.65,35,5814,5849
2021/03/13,06:00:00,168.73,36,5721,5757
2021/03/13,06:30:00,168.81,130,5677,5807
2021/03/13,07:00:00,168.81,358,5541,5899
2021/03/13,07:30:00,169.05,638,5362,6000
2021/03/13,08:00:00,168.89,991,5278,6269
2021/03/13,08:30:00,168.73,1297,5249,6546
2021/03/13,09:00:00,168.41,1555,5174,6729
2021/03/13,09:30:00,168.57,1684,5213,6897
2021/03/13,10:00:00,168.65,1764,5306,7070
2021/03/13,10:30:00,168.49,1733,5321,7054
2021/03/13,11:00:00,168.49,1802,5176,6978
2021/03/13,11:30:00,168.89,1849,5089,6938
2021/03/13,12:00:00,168.81,1967,4910,6877
2021/03/13,12:30:00,168.73,2008,4782,6790
2021/03/13,13:00:00,168.73,1978,4770,6748
2021/03/13,13:30:00,168.89,1917,4804,6721
2021/03/13,14:00:00,169.38,1840,4836,6676
2021/03/13,14:30:00,170.27,1657,4793,6450
2021/03/13,15:00:00,170.52,1562,4973,6535
2021/03/13,15:30:00,170.44,1383,5151,6534
2021/03/13,16:00:00,170.52,1107,5376,6483
2021/03/13,16:30:00,170.27,768,5891,6659
2021/03/13,17:00:00,170.27,446,6474,6920
2021/03/13,17:30:00,178.2,294,7030,7324
2021/03/13,18:00:00,231.7,114,7738,7852
2021/03/13,18:30:00,231.7,115,8201,8316
2021/03/13,19:00:00,231.7,109,8562,8671
2021/03/13,19:30:00,231.7,115,8669,8784
2021/03/13,20:00:00,231.7,117,8622,8739
2021/03/13,20:30:00,231.7,117,8569,8686
2021/03/13,21:00:00,225.07,117,8443,8560
2021/03/13,21:30:00,228.94,116,8312,8428
2021/03/13,22:00:00,215.3,116,8100,8216
2021/03/13,22:30:00,211.4,116,7825,7941
2021/03/13,23:00:00,180.53,113,7551,7664
2021/03/13,23:30:00,180.53,82,7197,7279
2021/03/14,00:00:00,165.9,68,6800,6868
2021/03/14,00:30:00,165.82,1,6507,6508
2021/03/14,01:00:00,165.82,0,6209,6209
2021/03/14,01:30:00,164.84,0,5964,5964
2021/03/14,02:00:00,164.84,0,5746,5746
2021/03/14,02:30:00,164.84,0,5778,5778
2021/03/14,03:00:00,164.54,0,5847,5847
2021/03/14,03:30:00,165.14,0,5801,5801
2021/03/14,04:00:00,164.99,0,5863,5863
2021/03/14,04:30:00,164.84,1,5975,5976
2021/03/14,05:00:00,165.44,1,5881,5882
2021/03/14,05:30:00,165.06,1,6164,6165
2021/03/14,06:00:00,165.29,0,6128,6128
2021/03/14,06:30:00,165.21,89,6384,6473
2021/03/14,07:00:00,164.77,277,6541,6818
2021/03/14,07:30:00,165.29,551,6665,7216
2021/03/14,08:00:00,165.21,811,6461,7272
2021/03/14,08:30:00,165.44,1063,6289,7352
2021/03/14,09:00:00,165.37,1262,6111,7373
2021/03/14,09:30:00,165.21,1526,6086,7612
2021/03/14,10:00:00,165.21,1783,5840,7623
2021/03/14,10:30:00,165.52,1840,5794,7634
2021/03/14,11:00:00,164.99,1829,5733,7562
2021/03/14,11:30:00,165.75,1832,5929,7761
2021/03/14,12:00:00,165.44,1770,5923,7693
2021/03/14,12:30:00,165.06,1665,6078,7743
2021/03/14,13:00:00,165.21,1615,5943,7558
2021/03/14,13:30:00,165.29,1517,6005,7522
2021/03/14,14:00:00,219.9,1291,6238,7529
2021/03/14,14:30:00,165.44,1038,6435,7473
2021/03/14,15:00:00,224.85,907,6673,7580
2021/03/14,15:30:00,224.85,783,6910,7693
2021/03/14,16:00:00,224.85,644,7184,7828
2021/03/14,16:30:00,223.58,371,7604,7975
2021/03/14,17:00:00,226.26,218,7980,8198
2021/03/14,17:30:00,231.89,116,8457,8573
2021/03/14,18:00:00,231.89,116,9056,9172
2021/03/14,18:30:00,231.89,92,9388,9480
2021/03/14,19:00:00,231.89,84,9440,9524
2021/03/14,19:30:00,231.89,56,9465,9521
2021/03/14,20:00:00,231.89,47,9423,9470
2021/03/14,20:30:00,231.89,39,9318,9357
2021/03/14,21:00:00,231.89,37,9128,9165
2021/03/14,21:30:00,224.85,38,8860,8898
2021/03/14,22:00:00,224.2,37,8606,8643
2021/03/14,22:30:00,224.85,38,8292,8330
2021/03/14,23:00:00,223.18,38,7810,7848
2021/03/14,23:30:00,178.2,37,7355,7392
2021/03/15,00:00:00,178.2,37,6946,6983
2021/03/15,00:30:00,167.59,38,6604,6642
2021/03/15,01:00:00,169.68,38,6240,6278
2021/03/15,01:30:00,164.91,39,6041,6080
2021/03/15,02:00:00,164.84,38,5953,5991
2021/03/15,02:30:00,164.84,38,5908,5946
2021/03/15,03:00:00,165.14,38,5825,5863
2021/03/15,03:30:00,164.99,45,5832,5877
2021/03/15,04:00:00,164.54,38,5833,5871
2021/03/15,04:30:00,164.77,39,5955,5994
2021/03/15,05:00:00,164.99,40,6154,6194
2021/03/15,05:30:00,164.25,38,6429,6467
2021/03/15,06:00:00,165.82,42,6397,6439
2021/03/15,06:30:00,187.84,107,6510,6617
2021/03/15,07:00:00,223.95,209,6755,6964
2021/03/15,07:30:00,211.19,434,6789,7223
2021/03/15,08:00:00,164.54,726,6615,7341
2021/03/15,08:30:00,178.2,902,6455,7357
2021/03/15,09:00:00,178.2,1111,6251,7362
2021/03/15,09:30:00,178.2,1355,6211,7566
2021/03/15,10:00:00,178.2,1443,6264,7707
2021/03/15,10:30:00,178.2,1568,6124,7692
2021/03/15,11:00:00,178.2,1535,6085,7620
2021/03/15,11:30:00,178.2,1550,6072,7622
2021/03/15,12:00:00,178.2,1567,6101,7668
2021/03/15,12:30:00,178.2,1593,6041,7634
2021/03/15,13:00:00,178.2,1591,6038,7629
2021/03/15,13:30:00,178.2,1579,6165,7744
2021/03/15,14:00:00,178.2,1472,6249,7721
2021/03/15,14:30:00,178.2,1355,6397,7752
2021/03/15,15:00:00,178.2,1158,6411,7569
2021/03/15,15:30:00,164.99,895,6715,7610
2021/03/15,16:00:00,166.51,648,6879,7527
2021/03/15,16:30:00,215.03,389,7268,7657
2021/03/15,17:00:00,215.35,163,7652,7815
2021/03/15,17:30:00,223.35,15,8164,8179
2021/03/15,18:00:00,223.94,44,8747,8791
2021/03/15,18:30:00,221.63,44,9086,9130
2021/03/15,19:00:00,221.48,43,9175,9218
2021/03/15,19:30:00,223.75,45,9178,9223
2021/03/15,20:00:00,222.28,42,9130,9172
2021/03/15,20:30:00,221.63,40,9139,9179
2021/03/15,21:00:00,225.9,39,8963,9002
2021/03/15,21:30:00,224.56,38,8721,8759
2021/03/15,22:00:00,225.22,38,8394,8432
2021/03/15,22:30:00,224.56,37,8019,8056
2021/03/15,23:00:00,222.97,37,7603,7640
2021/03/15,23:30:00,221.48,37,7247,7284
2021/03/16,00:00:00,169.77,37,6783,6820
2021/03/16,00:30:00,164.62,38,6423,6461
2021/03/16,01:00:00,164.99,38,6190,6228
2021/03/16,01:30:00,165.06,37,5993,6030
2021/03/16,02:00:00,165.29,36,5786,5822
2021/03/16,02:30:00,164.99,37,5724,5761
2021/03/16,03:00:00,164.47,37,5620,5657
2021/03/16,03:30:00,165.37,37,5611,5648
2021/03/16,04:00:00,164.99,36,5665,5701
2021/03/16,04:30:00,164.69,37,5812,5849
2021/03/16,05:00:00,164.99,38,5908,5946
2021/03/16,05:30:00,165.37,38,6219,6257
2021/03/16,06:00:00,165.14,39,6136,6175
2021/03/16,06:30:00,194.44,104,6458,6562
2021/03/16,07:00:00,223.6,216,6646,6862
2021/03/16,07:30:00,208.61,361,6819,7180
2021/03/16,08:00:00,208.89,580,6581,7161
2021/03/16,08:30:00,223.01,828,6840,7668
2021/03/16,09:00:00,223.4,964,6735,7699
2021/03/16,09:30:00,191.67,1151,6614,7765
2021/03/16,10:00:00,192.47,1247,6572,7819
2021/03/16,10:30:00,165.29,1336,6484,7820
2021/03/16,11:00:00,166.21,1496,6296,7792
2021/03/16,11:30:00,165.44,1680,6086,7766
2021/03/16,12:00:00,219.9,1766,5964,7730
2021/03/16,12:30:00,167.3,1791,5848,7639
2021/03/16,13:00:00,169.6,1855,5842,7697
2021/03/16,13:30:00,219.9,1822,5876,7698
2021/03/16,14:00:00,169.77,1790,5944,7734
2021/03/16,14:30:00,169.94,1664,6044,7708
2021/03/16,15:00:00,169.94,1523,6271,7794
2021/03/16,15:30:00,169.77,1303,6480,7783
2021/03/16,16:00:00,166.52,1048,6666,7714
2021/03/16,16:30:00,166.98,743,6916,7659
2021/03/16,17:00:00,224.69,437,7411,7848
2021/03/16,17:30:00,225.34,327,7923,8250
2021/03/16,18:00:00,224.69,52,8595,8647
2021/03/16,18:30:00,224.69,44,9037,9081
2021/03/16,19:00:00,225.34,42,9129,9171
2021/03/16,19:30:00,226.03,40,9124,9164
2021/03/16,20:00:00,225.34,39,9120,9159
2021/03/16,20:30:00,222.26,39,9109,9148
2021/03/16,21:00:00,226.03,39,8970,9009
2021/03/16,21:30:00,226.03,39,8683,8722
2021/03/16,22:00:00,226.03,38,8404,8442
2021/03/16,22:30:00,223.81,37,8076,8113
2021/03/16,23:00:00,221.6,37,7703,7740
2021/03/16,23:30:00,220.98,38,7274,7312
2021/03/17,00:00:00,167.46,37,6846,6883
2021/03/17,00:30:00,167.06,38,6528,6566
2021/03/17,01:00:00,167.06,38,6275,6313
2021/03/17,01:30:00,166.67,38,6034,6072
2021/03/17,02:00:00,167.69,38,5889,5927
2021/03/17,02:30:00,167.38,38,5778,5816
2021/03/17,03:00:00,167.53,38,5653,5691
2021/03/17,03:30:00,166.98,38,5678,5716
2021/03/17,04:00:00,167.22,38,5693,5731
2021/03/17,04:30:00,166.91,32,5846,5878
2021/03/17,05:00:00,167.14,36,5961,5997
2021/03/17,05:30:00,166.83,37,6263,6300
2021/03/17,06:00:00,202.79,37,6151,6188
2021/03/17,06:30:00,167.14,142,6441,6583
2021/03/17,07:00:00,209.47,330,6523,6853
2021/03/17,07:30:00,166.36,670,6487,7157
2021/03/17,08:00:00,167.06,996,6430,7426
2021/03/17,08:30:00,167.85,1371,6230,7601
2021/03/17,09:00:00,167.61,1596,6099,7695
2021/03/17,09:30:00,167.22,1720,6015,7735
2021/03/17,10:00:00,166.98,1776,5958,7734
2021/03/17,10:30:00,167.3,1922,5870,7792
2021/03/17,11:00:00,166.91,1859,5881,7740
2021/03/17,11:30:00,167.53,1925,5803,7728
2021/03/17,12:00:00,166.98,1954,5737,7691
2021/03/17,12:30:00,166.83,1972,5745,7717
2021/03/17,13:00:00,166.98,1954,5797,7751
2021/03/17,13:30:00,167.14,1945,5856,7801
2021/03/17,14:00:00,166.83,1844,5966,7810
2021/03/17,14:30:00,166.67,1766,6006,7772
2021/03/17,15:00:00,166.67,1610,6174,7784
2021/03/17,15:30:00,166.75,1435,6381,7816
2021/03/17,16:00:00,166.75,1170,6659,7829
2021/03/17,16:30:00,167.3,842,6832,7674
2021/03/17,17:00:00,166.83,450,7347,7797
2021/03/17,17:30:00,178.2,253,7854,8107
2021/03/17,18:00:00,210.9,107,8492,8599
2021/03/17,18:30:00,212.82,115,8931,9046
2021/03/17,19:00:00,200.85,123,9056,9179
2021/03/17,19:30:00,201.41,119,9066,9185
2021/03/17,20:00:00,200.31,120,9031,9151
2021/03/17,20:30:00,212.55,115,9079,9194
2021/03/17,21:00:00,200.85,118,8932,9050
2021/03/17,21:30:00,202,122,8723,8845
2021/03/17,22:00:00,200.85,122,8401,8523
2021/03/17,22:30:00,200.31,122,8062,8184
2021/03/17,23:00:00,200.85,121,7712,7833
2021/03/17,23:30:00,200.85,121,7308,7429
2021/03/18,00:00:00,166.36,122,6869,6991
2021/03/18,00:30:00,166.67,109,6550,6659
2021/03/18,01:00:00,166.91,76,6213,6289
2021/03/18,01:30:00,166.59,45,6069,6114
2021/03/18,02:00:00,166.59,36,6056,6092
2021/03/18,02:30:00,167.3,31,5899,5930
2021/03/18,03:00:00,166.98,31,5889,5920
2021/03/18,03:30:00,167.53,29,5842,5871
2021/03/18,04:00:00,167.77,31,5865,5896
2021/03/18,04:30:00,166.91,30,6062,6092
2021/03/18,05:00:00,167.14,29,6162,6191
2021/03/18,05:30:00,167.3,31,6296,6327
2021/03/18,06:00:00,167.53,30,6241,6271
2021/03/18,06:30:00,167.14,136,6467,6603
2021/03/18,07:00:00,167.53,411,6622,7033
2021/03/18,07:30:00,167.46,644,6594,7238
2021/03/18,08:00:00,167.61,1104,6495,7599
2021/03/18,08:30:00,167.77,1358,6289,7647
2021/03/18,09:00:00,178.2,1312,6598,7910
2021/03/18,09:30:00,178.2,1175,6723,7898
2021/03/18,10:00:00,178.2,1444,6578,8022
2021/03/18,10:30:00,167.46,1514,6540,8054
2021/03/18,11:00:00,167.3,1553,6476,8029
2021/03/18,11:30:00,166.98,1545,6460,8005
2021/03/18,12:00:00,167.46,1483,6344,7827
2021/03/18,12:30:00,166.36,1636,6360,7996
2021/03/18,13:00:00,166.75,1631,6323,7954
2021/03/18,13:30:00,166.83,1660,6257,7917
2021/03/18,14:00:00,166.67,1499,6374,7873
2021/03/18,14:30:00,165.9,1432,6349,7781
2021/03/18,15:00:00,166.75,1295,6328,7623
2021/03/18,15:30:00,167.61,1277,6438,7715
2021/03/18,16:00:00,166.91,1060,6677,7737
2021/03/18,16:30:00,166.67,854,7009,7863
2021/03/18,17:00:00,166.59,518,7461,7979
2021/03/18,17:30:00,178.2,290,7970,8260
2021/03/18,18:00:00,205.19,119,8612,8731
2021/03/18,18:30:00,215.36,120,9011,9131
2021/03/18,19:00:00,202.96,118,9176,9294
2021/03/18,19:30:00,202.96,89,9164,9253
2021/03/18,20:00:00,202.45,53,9144,9197
2021/03/18,20:30:00,202.96,40,9155,9195
2021/03/18,21:00:00,203.5,34,8956,8990
2021/03/18,21:30:00,202.96,32,8725,8757
2021/03/18,22:00:00,202.45,31,8516,8547
2021/03/18,22:30:00,203.5,32,8178,8210
2021/03/18,23:00:00,203.5,34,7827,7861
2021/03/18,23:30:00,204.06,39,7448,7487
2021/03/19,00:00:00,178.2,40,7081,7121
2021/03/19,00:30:00,167.77,40,6704,6744
2021/03/19,01:00:00,167.46,39,6457,6496
2021/03/19,01:30:00,166.98,39,6215,6254
2021/03/19,02:00:00,167.53,40,6038,6078
2021/03/19,02:30:00,167.69,38,5841,5879
2021/03/19,03:00:00,167.3,37,5940,5977
2021/03/19,03:30:00,167.61,37,5927,5964
2021/03/19,04:00:00,167.61,37,5877,5914
2021/03/19,04:30:00,167.53,37,5990,6027
2021/03/19,05:00:00,167.3,37,5975,6012
2021/03/19,05:30:00,167.38,37,6018,6055
2021/03/19,06:00:00,167.69,36,6010,6046
2021/03/19,06:30:00,167.69,173,6017,6190
2021/03/19,07:00:00,167.38,383,5861,6244
2021/03/19,07:30:00,167.53,703,5763,6466
2021/03/19,08:00:00,167.46,1084,5670,6754
2021/03/19,08:30:00,167.46,1267,5701,6968
2021/03/19,09:00:00,167.3,1486,5833,7319
2021/03/19,09:30:00,167.3,1516,5880,7396
2021/03/19,10:00:00,166.52,1746,5752,7498
2021/03/19,10:30:00,167.22,1846,5691,7537
2021/03/19,11:00:00,167.61,1927,5663,7590
2021/03/19,11:30:00,166.59,1975,5609,7584
2021/03/19,12:00:00,166.98,1978,5524,7502
2021/03/19,12:30:00,166.67,1988,5446,7434
2021/03/19,13:00:00,166.83,1961,5411,7372
2021/03/19,13:30:00,166.67,1919,5430,7349
2021/03/19,14:00:00,166.98,1856,5444,7300
2021/03/19,14:30:00,166.91,1739,5555,7294
2021/03/19,15:00:00,166.91,1597,5688,7285
2021/03/19,15:30:00,166.75,1418,5945,7363
2021/03/19,16:00:00,166.44,1159,6208,7367
2021/03/19,16:30:00,166.75,863,6589,7452
2021/03/19,17:00:00,191.3,476,7202,7678
2021/03/19,17:30:00,178.2,336,7579,7915
2021/03/19,18:00:00,202.96,103,7897,8000
2021/03/19,18:30:00,203.5,101,8211,8312
2021/03/19,19:00:00,202.96,97,8153,8250
2021/03/19,19:30:00,202.96,97,8001,8098
2021/03/19,20:00:00,200.72,99,7824,7923
2021/03/19,20:30:00,200.72,107,7726,7833
2021/03/19,21:00:00,200.19,122,7616,7738
2021/03/19,21:30:00,167.1,121,7493,7614
2021/03/19,22:00:00,166.91,120,7331,7451
2021/03/19,22:30:00,166.83,120,7119,7239
2021/03/19,23:00:00,166.83,106,6905,7011
2021/03/19,23:30:00,167.06,55,6688,6743
2021/03/20,00:00:00,166.83,30,6443,6473
2021/03/20,00:30:00,167.06,20,6152,6172
2021/03/20,01:00:00,167.38,0,6011,6011
2021/03/20,01:30:00,167.22,0,5838,5838
2021/03/20,02:00:00,167.38,1,5667,5668
2021/03/20,02:30:00,166.75,1,5594,5595
2021/03/20,03:00:00,167.53,1,5509,5510
2021/03/20,03:30:00,167.22,1,5466,5467
2021/03/20,04:00:00,166.67,0,5506,5506
2021/03/20,04:30:00,166.83,18,5559,5577
2021/03/20,05:00:00,166.75,34,5627,5661
2021/03/20,05:30:00,166.91,37,5685,5722
2021/03/20,06:00:00,167.14,38,5563,5601
2021/03/20,06:30:00,166.75,127,5538,5665
2021/03/20,07:00:00,166.98,249,5431,5680
2021/03/20,07:30:00,167.53,568,5380,5948
2021/03/20,08:00:00,167.61,830,5389,6219
2021/03/20,08:30:00,167.46,1136,5221,6357
2021/03/20,09:00:00,166.75,1092,5415,6507
2021/03/20,09:30:00,167.22,1422,5155,6577
2021/03/20,10:00:00,167.53,1732,4961,6693
2021/03/20,10:30:00,167.85,1780,5022,6802
2021/03/20,11:00:00,166.98,1809,4901,6710
2021/03/20,11:30:00,165.59,1678,5145,6823
2021/03/20,12:00:00,166.83,1502,5215,6717
2021/03/20,12:30:00,167.53,1554,5192,6746
2021/03/20,13:00:00,167.38,1742,5069,6811
2021/03/20,13:30:00,167.22,1728,5011,6739
2021/03/20,14:00:00,167.3,1594,5042,6636
2021/03/20,14:30:00,166.83,1390,5175,6565
2021/03/20,15:00:00,167.22,1177,5421,6598
2021/03/20,15:30:00,167.06,1071,5554,6625
2021/03/20,16:00:00,167.38,867,5864,6731
2021/03/20,16:30:00,167.22,559,6243,6802
2021/03/20,17:00:00,166.44,339,6641,6980
2021/03/20,17:30:00,167.3,296,7029,7325
2021/03/20,18:00:00,204.06,110,7523,7633
2021/03/20,18:30:00,202.96,111,7990,8101
2021/03/20,19:00:00,203.5,87,8000,8087
2021/03/20,19:30:00,202.96,54,8114,8168
2021/03/20,20:00:00,202.45,39,8090,8129
2021/03/20,20:30:00,202.45,34,8071,8105
2021/03/20,21:00:00,202.45,36,7935,7971
2021/03/20,21:30:00,200.85,36,7815,7851
2021/03/20,22:00:00,202,32,7641,7673
2021/03/20,22:30:00,200.85,35,7423,7458
2021/03/20,23:00:00,201.41,33,7174,7207
2021/03/20,23:30:00,166.67,30,6906,6936
2021/03/21,00:00:00,166.59,31,6559,6590
2021/03/21,00:30:00,166.98,35,6247,6282
2021/03/21,01:00:00,166.98,36,5962,5998
2021/03/21,01:30:00,166.67,38,5772,5810
2021/03/21,02:00:00,166.67,37,5605,5642
2021/03/21,02:30:00,166.67,36,5499,5535
2021/03/21,03:00:00,166.91,37,5416,5453
2021/03/21,03:30:00,166.91,37,5414,5451
2021/03/21,04:00:00,166.98,36,5441,5477
2021/03/21,04:30:00,166.75,34,5550,5584
2021/03/21,05:00:00,166.75,37,5729,5766
2021/03/21,05:30:00,167.14,37,5925,5962
2021/03/21,06:00:00,167.06,38,5856,5894
2021/03/21,06:30:00,166.83,152,5994,6146
2021/03/21,07:00:00,166.83,340,6056,6396
2021/03/21,07:30:00,167.22,591,6051,6642
2021/03/21,08:00:00,167.14,877,5881,6758
2021/03/21,08:30:00,167.53,1122,5780,6902
2021/03/21,09:00:00,166.98,1363,5661,7024
2021/03/21,09:30:00,167.46,1528,5573,7101
2021/03/21,10:00:00,166.52,1679,5663,7342
2021/03/21,10:30:00,167.14,1762,5793,7555
2021/03/21,11:00:00,167.22,1775,5779,7554
2021/03/21,11:30:00,167.3,1760,5830,7590
2021/03/21,12:00:00,167.61,1738,5888,7626
2021/03/21,12:30:00,167.38,1607,5881,7488
2021/03/21,13:00:00,166.67,1604,5956,7560
2021/03/21,13:30:00,167.3,1474,6000,7474
2021/03/21,14:00:00,167.53,1352,6099,7451
2021/03/21,14:30:00,167.22,1065,6385,7450
2021/03/21,15:00:00,204.06,735,6664,7399
2021/03/21,15:30:00,204.06,638,6709,7347
2021/03/21,16:00:00,205.92,598,6883,7481
2021/03/21,16:30:00,202.96,376,7248,7624
2021/03/21,17:00:00,204.65,196,7430,7626
2021/03/21,17:30:00,204.06,224,7728,7952
2021/03/21,18:00:00,202.96,22,8117,8139
2021/03/21,18:30:00,205.27,29,8377,8406
2021/03/21,19:00:00,201.97,33,8354,8387
2021/03/21,19:30:00,178.2,34,8348,8382
2021/03/21,20:00:00,170,35,8234,8269
2021/03/21,20:30:00,170,32,8193,8225
2021/03/21,21:00:00,170,30,8058,8088
2021/03/21,21:30:00,167.69,33,7828,7861
2021/03/21,22:00:00,178.2,34,7698,7732
2021/03/21,22:30:00,178.2,34,7475,7509
2021/03/21,23:00:00,178.2,36,7180,7216
2021/03/21,23:30:00,178.2,34,6855,6889
2021/03/22,00:00:00,167.3,33,6490,6523
2021/03/22,00:30:00,167.53,31,6245,6276
2021/03/22,01:00:00,167.46,36,5987,6023
2021/03/22,01:30:00,167.61,36,5843,5879
2021/03/22,02:00:00,167.3,37,5695,5732
2021/03/22,02:30:00,167.38,1,5617,5618
2021/03/22,03:00:00,167.46,30,5558,5588
2021/03/22,03:30:00,167.93,34,5491,5525
2021/03/22,04:00:00,167.61,34,5521,5555
2021/03/22,04:30:00,167.61,34,5657,5691
2021/03/22,05:00:00,167.22,35,5822,5857
2021/03/22,05:30:00,219.9,37,5971,6008
2021/03/22,06:00:00,167.77,37,5967,6004
2021/03/22,06:30:00,167.46,38,6165,6203
2021/03/22,07:00:00,178.2,150,6343,6493
2021/03/22,07:30:00,198.72,215,6657,6872
2021/03/22,08:00:00,198.72,318,6735,7053
2021/03/22,08:30:00,202.34,502,6836,7338
2021/03/22,09:00:00,226.73,556,7035,7591
2021/03/22,09:30:00,226.54,605,7127,7732
2021/03/22,10:00:00,225.57,519,7280,7799
2021/03/22,10:30:00,214.45,563,7295,7858
2021/03/22,11:00:00,185.3,739,7214,7953
2021/03/22,11:30:00,178.2,958,7178,8136
2021/03/22,12:00:00,178.2,1039,7029,8068
2021/03/22,12:30:00,178.2,1197,6978,8175
2021/03/22,13:00:00,178.2,1278,6894,8172
2021/03/22,13:30:00,196.41,1206,7116,8322
2021/03/22,14:00:00,198.34,1020,7167,8187
2021/03/22,14:30:00,198.72,1018,7139,8157
2021/03/22,15:00:00,198.34,663,7340,8003
2021/03/22,15:30:00,219.16,515,7543,8058
2021/03/22,16:00:00,219.4,328,7746,8074
2021/03/22,16:30:00,178.2,198,7857,8055
2021/03/22,17:00:00,219.4,9,8031,8040
2021/03/22,17:30:00,219.16,1,8251,8252
2021/03/22,18:00:00,219.4,2,8597,8599
2021/03/22,18:30:00,219.16,34,8751,8785
2021/03/22,19:00:00,214.19,35,8679,8714
2021/03/22,19:30:00,164.54,36,8590,8626
2021/03/22,20:00:00,165.37,32,8556,8588
2021/03/22,20:30:00,165.44,29,8401,8430
2021/03/22,21:00:00,165.59,28,8217,8245
2021/03/22,21:30:00,165.44,29,8011,8040
2021/03/22,22:00:00,178.2,31,7788,7819
2021/03/22,22:30:00,206.66,35,7556,7591
2021/03/22,23:00:00,201.87,38,7202,7240
2021/03/22,23:30:00,203.14,35,7006,7041
2021/03/23,00:00:00,203.14,35,6653,6688
2021/03/23,00:30:00,201.87,33,6377,6410
2021/03/23,01:00:00,203.82,27,6110,6137
2021/03/23,01:30:00,165.9,28,6091,6119
2021/03/23,02:00:00,165.52,29,5925,5954
2021/03/23,02:30:00,166.05,30,5777,5807
2021/03/23,03:00:00,164.99,27,5733,5760
2021/03/23,03:30:00,165.21,27,5691,5718
2021/03/23,04:00:00,164.77,28,5747,5775
2021/03/23,04:30:00,164.99,30,5762,5792
2021/03/23,05:00:00,164.39,30,5888,5918
2021/03/23,05:30:00,164.17,31,5966,5997
2021/03/23,06:00:00,164.99,29,5877,5906
2021/03/23,06:30:00,164.47,23,5903,5926
2021/03/23,07:00:00,165.44,164,5929,6093
2021/03/23,07:30:00,164.47,214,5971,6185
2021/03/23,08:00:00,165.14,340,6040,6380
2021/03/23,08:30:00,165.29,502,6090,6592
2021/03/23,09:00:00,164.84,700,6146,6846
2021/03/23,09:30:00,165.21,875,6133,7008
2021/03/23,10:00:00,165.21,935,6277,7212
2021/03/23,10:30:00,164.84,943,6459,7402
2021/03/23,11:00:00,165.75,1085,6463,7548
2021/03/23,11:30:00,165.82,1055,6547,7602
2021/03/23,12:00:00,219.9,857,6819,7676
2021/03/23,12:30:00,219.9,845,6816,7661
2021/03/23,13:00:00,219.9,955,6878,7833
2021/03/23,13:30:00,219.9,778,7099,7877
2021/03/23,14:00:00,219.9,582,7160,7742
2021/03/23,14:30:00,219.9,474,7228,7702
2021/03/23,15:00:00,205.27,409,7291,7700
2021/03/23,15:30:00,205.27,330,7290,7620
2021/03/23,16:00:00,204.65,282,7342,7624
2021/03/23,16:30:00,204.65,202,7442,7644
2021/03/23,17:00:00,205.27,53,7577,7630
2021/03/23,17:30:00,202.45,44,7779,7823
2021/03/23,18:00:00,204.65,35,8104,8139
2021/03/23,18:30:00,204.06,32,8256,8288
2021/03/23,19:00:00,204.65,35,8256,8291
2021/03/23,19:30:00,200.72,35,8196,8231
2021/03/23,20:00:00,178.2,30,8140,8170
2021/03/23,20:30:00,178.2,33,8055,8088
2021/03/23,21:00:00,178.2,36,7846,7882
2021/03/23,21:30:00,178.2,34,7678,7712
2021/03/23,22:00:00,178.2,34,7496,7530
2021/03/23,22:30:00,178.2,34,7307,7341
2021/03/23,23:00:00,154.96,31,7016,7047
2021/03/23,23:30:00,154.96,33,6710,6743
2021/03/24,00:00:00,143.52,40,6452,6492
2021/03/24,00:30:00,143.86,43,6229,6272
2021/03/24,01:00:00,143.12,32,6108,6140
2021/03/24,01:30:00,143.39,30,5894,5924
2021/03/24,02:00:00,143.79,30,5744,5774
2021/03/24,02:30:00,143.45,27,5672,5699
2021/03/24,03:00:00,143.19,28,5613,5641
2021/03/24,03:30:00,143.25,29,5592,5621
2021/03/24,04:00:00,143.19,29,5614,5643
2021/03/24,04:30:00,143.25,31,5734,5765
2021/03/24,05:00:00,143.25,32,5860,5892
2021/03/24,05:30:00,143.99,33,5833,5866
2021/03/24,06:00:00,143.72,33,5810,5843
2021/03/24,06:30:00,143.99,149,6006,6155
2021/03/24,07:00:00,143.66,260,6136,6396
2021/03/24,07:30:00,143.32,492,6333,6825
2021/03/24,08:00:00,143.72,678,6413,7091
2021/03/24,08:30:00,143.79,841,6441,7282
2021/03/24,09:00:00,143.93,960,6416,7376
2021/03/24,09:30:00,143.79,1128,6575,7703
2021/03/24,10:00:00,178.2,1259,6464,7723
2021/03/24,10:30:00,178.2,1327,6462,7789
2021/03/24,11:00:00,178.2,1453,6407,7860
2021/03/24,11:30:00,178.2,1461,6409,7870
2021/03/24,12:00:00,143.52,1534,6307,7841
2021/03/24,12:30:00,143.32,1502,6501,8003
2021/03/24,13:00:00,143.19,1464,6561,8025
2021/03/24,13:30:00,142.65,1387,6674,8061
2021/03/24,14:00:00,140.52,1271,6795,8066
2021/03/24,14:30:00,171.58,1156,6933,8089
2021/03/24,15:00:00,169.7,1008,6946,7954
2021/03/24,15:30:00,167.38,827,7065,7892
2021/03/24,16:00:00,163.52,630,7284,7914
2021/03/24,16:30:00,201.87,443,7610,8053
2021/03/24,17:00:00,202.49,252,7944,8196
2021/03/24,17:30:00,201.41,171,8259,8430
2021/03/24,18:00:00,200.85,42,8758,8800
2021/03/24,18:30:00,204.06,36,9111,9147
2021/03/24,19:00:00,204.65,33,9174,9207
2021/03/24,19:30:00,204.65,40,9165,9205
2021/03/24,20:00:00,204.65,40,9020,9060
2021/03/24,20:30:00,204.65,38,8960,8998
2021/03/24,21:00:00,164.99,38,8741,8779
2021/03/24,21:30:00,164.84,38,8555,8593
2021/03/24,22:00:00,178.2,37,8231,8268
2021/03/24,22:30:00,164.54,37,8029,8066
2021/03/24,23:00:00,165.59,36,7690,7726
2021/03/24,23:30:00,165.14,30,7281,7311
2021/03/25,00:00:00,164.99,36,6872,6908
2021/03/25,00:30:00,165.21,40,6543,6583
2021/03/25,01:00:00,164.99,35,6280,6315
2021/03/25,01:30:00,165.59,39,6050,6089
2021/03/25,02:00:00,165.06,39,6018,6057
2021/03/25,02:30:00,164.62,35,5898,5933
2021/03/25,03:00:00,165.06,33,5820,5853
2021/03/25,03:30:00,165.59,36,5741,5777
2021/03/25,04:00:00,165.06,34,5772,5806
2021/03/25,04:30:00,164.62,34,5945,5979
2021/03/25,05:00:00,164.77,32,6087,6119
2021/03/25,05:30:00,164.99,32,6063,6095
2021/03/25,06:00:00,165.67,29,6030,6059
2021/03/25,06:30:00,165.29,125,6184,6309
2021/03/25,07:00:00,165.29,271,6286,6557
2021/03/25,07:30:00,164.99,532,6387,6919
2021/03/25,08:00:00,164.91,893,6410,7303
2021/03/25,08:30:00,165.29,1150,6354,7504
2021/03/25,09:00:00,168.41,1329,6389,7718
2021/03/25,09:30:00,168.49,1123,6662,7785
2021/03/25,10:00:00,168.97,1410,6440,7850
2021/03/25,10:30:00,168.97,1543,6666,8209
2021/03/25,11:00:00,168.33,1499,6785,8284
2021/03/25,11:30:00,168.09,1480,6835,8315
2021/03/25,12:00:00,168.73,1442,6865,8307
2021/03/25,12:30:00,168.65,1682,6684,8366
2021/03/25,13:00:00,168.89,1731,6732,8463
2021/03/25,13:30:00,168.65,1675,6737,8412
2021/03/25,14:00:00,169.3,1661,6696,8357
2021/03/25,14:30:00,165.59,1604,6878,8482
2021/03/25,15:00:00,165.59,1515,6966,8481
2021/03/25,15:30:00,166.67,1329,7013,8342
2021/03/25,16:00:00,166.67,1176,7160,8336
2021/03/25,16:30:00,166.36,812,7547,8359
2021/03/25,17:00:00,166.05,523,7829,8352
2021/03/25,17:30:00,202.96,263,8380,8643
2021/03/25,18:00:00,203.5,110,8829,8939
2021/03/25,18:30:00,204.65,115,9201,9316
2021/03/25,19:00:00,204.06,112,9243,9355
2021/03/25,19:30:00,204.65,112,9187,9299
2021/03/25,20:00:00,202,109,9133,9242
2021/03/25,20:30:00,201.28,109,9023,9132
2021/03/25,21:00:00,199.68,107,8883,8990
2021/03/25,21:30:00,200.72,110,8655,8765
2021/03/25,22:00:00,201.28,108,8415,8523
2021/03/25,22:30:00,201.28,108,8236,8344
2021/03/25,23:00:00,167.1,107,7886,7993
2021/03/25,23:30:00,166.59,107,7502,7609
2021/03/26,00:00:00,167.1,107,7105,7212
2021/03/26,00:30:00,160.43,68,6715,6782
2021/03/26,01:00:00,161.06,52,6423,6475
2021/03/26,01:30:00,159.7,45,6231,6277
2021/03/26,03:00:00,160.49,41,5980,6021
2021/03/26,03:30:00,164.91,39,6017,6056
2021/03/26,04:00:00,164.84,37,5834,5872
2021/03/26,04:30:00,164.62,37,5861,5898
2021/03/26,05:00:00,164.25,37,5916,5953
2021/03/26,05:30:00,165.59,38,6024,6062
2021/03/26,06:00:00,165.37,38,6066,6104
2021/03/26,06:30:00,165.59,37,6173,6210
2021/03/26,07:00:00,165.37,38,6185,6223
2021/03/26,07:30:00,165.37,215,6260,6476
2021/03/26,08:00:00,165.21,398,6258,6656
2021/03/26,08:30:00,165.37,627,6354,6981
2021/03/26,09:00:00,168.89,844,6432,7276
2021/03/26,09:30:00,168.89,792,6690,7482
2021/03/26,10:00:00,168.89,909,6848,7757
2021/03/26,10:30:00,168.65,895,7096,7991
2021/03/26,11:00:00,168.89,1019,7197,8217
2021/03/26,11:30:00,168.65,1119,7316,8435
2021/03/26,12:00:00,216.72,1090,7390,8480
2021/03/26,12:30:00,208.99,1069,7447,8516
2021/03/26,13:00:00,167.1,1202,7265,8467
2021/03/26,13:30:00,167.1,1127,7278,8405
2021/03/26,14:00:00,167.1,1104,7374,8478
2021/03/26,14:30:00,167.1,867,7562,8429
2021/03/26,15:00:00,167.1,748,7756,8504
2021/03/26,15:30:00,217.41,726,7832,8558
2021/03/26,16:00:00,203.5,671,8031,8702
2021/03/26,16:30:00,203.5,528,8331,8859
2021/03/26,17:00:00,207.26,401,8680,9081
2021/03/26,17:30:00,220.5,371,8897,9268
2021/03/26,18:00:00,224.14,216,9095,9311
2021/03/26,18:30:00,223.95,53,9053,9106
2021/03/26,19:00:00,204.06,46,8998,9044
2021/03/26,19:30:00,204.65,46,9006,9052
2021/03/26,20:00:00,204.06,42,8822,8864
2021/03/26,20:30:00,204.06,42,8714,8757
2021/03/26,21:00:00,219.5,40,8508,8548
2021/03/26,21:30:00,204.65,40,8305,8345
2021/03/26,22:00:00,201.51,39,8085,8125
2021/03/26,22:30:00,204.65,39,7894,7933
2021/03/26,23:00:00,204.65,39,7599,7638
2021/03/26,23:30:00,167.1,38,7287,7325
2021/03/27,00:00:00,165.21,39,6985,7024
2021/03/27,00:30:00,165.59,39,6640,6679
2021/03/27,01:00:00,165.59,40,6395,6435
2021/03/27,01:30:00,165.52,41,6122,6163
2021/03/27,02:00:00,165.14,41,5950,5991
2021/03/27,02:30:00,165.59,40,5784,5824
2021/03/27,03:00:00,165.21,40,5657,5697
2021/03/27,03:30:00,165.44,41,5609,5650
2021/03/27,04:00:00,165.44,41,5553,5594
2021/03/27,04:30:00,165.14,40,5592,5632
2021/03/27,05:00:00,170.27,40,5624,5664
2021/03/27,05:30:00,170.27,40,5745,5785
2021/03/27,06:00:00,170.27,39,5854,5893
2021/03/27,06:30:00,169.38,39,5829,5868
2021/03/27,07:00:00,164.99,42,5812,5854
2021/03/27,07:30:00,164.99,238,5739,5977
2021/03/27,08:00:00,166.05,467,5771,6238
2021/03/27,08:30:00,165.29,858,5714,6572
2021/03/27,09:00:00,164.62,1164,5634,6798
2021/03/27,09:30:00,164.99,1494,5504,6998
2021/03/27,10:00:00,164.99,1615,5514,7129
2021/03/27,10:30:00,164.84,1337,5791,7128
2021/03/27,11:00:00,165.29,1333,5883,7216
2021/03/27,11:30:00,165.37,1479,5729,7208
2021/03/27,12:00:00,165.59,1668,5582,7250
2021/03/27,12:30:00,165.37,1798,5415,7213
2021/03/27,13:00:00,166.05,1832,5480,7312
2021/03/27,13:30:00,168.57,1838,5471,7309
2021/03/27,14:00:00,168.73,1849,5425,7274
2021/03/27,14:30:00,168.65,1890,5393,7283
2021/03/27,15:00:00,168.65,1865,5464,7329
2021/03/27,15:30:00,168.73,1729,5686,7415
2021/03/27,16:00:00,168.65,1618,5934,7552
2021/03/27,16:30:00,168.01,1458,6263,7721
2021/03/27,17:00:00,167.93,1178,6388,7566
2021/03/27,17:30:00,168.01,874,6906,7780
2021/03/27,18:00:00,163.59,545,7358,7903
2021/03/27,18:30:00,180.53,188,7695,7883
2021/03/27,19:00:00,179.87,93,7886,7979
2021/03/27,19:30:00,179.21,92,7928,8020
2021/03/27,20:00:00,180.53,111,7713,7824
2021/03/27,20:30:00,183.19,114,7463,7577
2021/03/27,21:00:00,179.87,118,7415,7533
2021/03/27,21:30:00,182.72,118,7452,7570
2021/03/27,22:00:00,183.19,118,7383,7501
2021/03/27,22:30:00,183.19,118,7359,7477
2021/03/27,23:00:00,179.87,118,7239,7357
2021/03/27,23:30:00,179.87,117,6978,7095
2021/03/28,00:00:00,168.09,116,6772,6888
2021/03/28,00:30:00,168.09,107,6585,6692
2021/03/28,01:00:00,167.61,62,6404,6466
2021/03/28,01:30:00,167.77,47,6013,6060
2021/03/28,02:00:00,168.09,41,5782,5823
2021/03/28,02:30:00,168.25,40,5612,5652
2021/03/28,03:00:00,168.01,39,5502,5541
2021/03/28,03:30:00,167.85,39,5412,5451
2021/03/28,04:00:00,167.77,38,5343,5381
2021/03/28,04:30:00,167.69,38,5377,5415
2021/03/28,05:00:00,167.85,38,5457,5495
2021/03/28,05:30:00,168.17,38,5589,5627
2021/03/28,06:00:00,167.46,38,5666,5704
2021/03/28,06:30:00,168.41,38,5598,5636
2021/03/28,07:00:00,167.77,42,5575,5617
2021/03/28,07:30:00,168.01,225,5492,5717
2021/03/28,08:00:00,168.01,557,5271,5828
2021/03/28,08:30:00,167.85,834,5120,5954
2021/03/28,09:00:00,168.41,1191,4905,6096
2021/03/28,09:30:00,167.85,1349,4879,6228
2021/03/28,10:00:00,167.3,1414,4939,6353
2021/03/28,10:30:00,167.69,1399,5084,6483
2021/03/28,11:00:00,167.93,1572,5068,6640
2021/03/28,11:30:00,167.85,1502,5184,6686
2021/03/28,12:00:00,167.61,1509,5144,6653
2021/03/28,12:30:00,167.85,1688,5003,6691
2021/03/28,13:00:00,167.85,1859,4929,6788
2021/03/28,13:30:00,167.77,1773,4857,6630
2021/03/28,14:00:00,167.85,1676,4878,6554
2021/03/28,14:30:00,168.17,1542,4865,6407
2021/03/28,15:00:00,167.93,1657,4711,6368
2021/03/28,15:30:00,167.85,1640,4781,6421
2021/03/28,16:00:00,168.01,1510,4917,6427
2021/03/28,16:30:00,167.77,1318,5204,6522
2021/03/28,17:00:00,167.38,1076,5458,6534
2021/03/28,17:30:00,167.77,886,5902,6788
2021/03/28,18:00:00,167.69,566,6438,7004
2021/03/28,18:30:00,161.85,330,7004,7334
2021/03/28,19:00:00,158.09,125,7608,7733
2021/03/28,19:30:00,202.45,127,8168,8295
2021/03/28,20:00:00,202.96,127,8600,8727
2021/03/28,20:30:00,202.45,128,8737,8865
2021/03/28,21:00:00,203.5,126,8682,8808
2021/03/28,21:30:00,202.96,126,8635,8761
2021/03/28,22:00:00,202.45,124,8447,8571
2021/03/28,22:30:00,204.06,122,8214,8336
2021/03/28,23:00:00,202.96,122,7931,8053
2021/03/28,23:30:00,201.87,109,7524,7633
2021/03/29,00:00:00,200.19,73,7142,7215
2021/03/29,00:30:00,161.26,49,6753,6802
2021/03/29,01:00:00,164.62,41,6357,6398
2021/03/29,01:30:00,165.29,42,6049,6091
2021/03/29,02:00:00,165.06,40,5831,5871
2021/03/29,02:30:00,164.25,40,5631,5671
2021/03/29,03:00:00,169.86,40,5515,5555
2021/03/29,03:30:00,170.03,39,5572,5611
2021/03/29,04:00:00,170.84,38,5551,5589
2021/03/29,04:30:00,170.6,33,5632,5665
2021/03/29,05:00:00,170.44,36,5713,5749
2021/03/29,05:30:00,166.83,37,5770,5807
2021/03/29,06:00:00,165.37,37,5950,5987
2021/03/29,06:30:00,164.99,37,6105,6142
2021/03/29,07:00:00,165.06,41,6286,6327
2021/03/29,07:30:00,164.84,292,6397,6689
2021/03/29,08:00:00,165.06,592,6267,6859
2021/03/29,08:30:00,164.99,1043,6103,7146
2021/03/29,09:00:00,165.14,1340,5809,7149
2021/03/29,09:30:00,165.29,1602,5747,7349
2021/03/29,10:00:00,167.1,1782,5565,7347
2021/03/29,10:30:00,165.14,1910,5598,7508
2021/03/29,11:00:00,167.1,2007,5504,7511
2021/03/29,11:30:00,165.59,2057,5401,7458
2021/03/29,12:00:00,165.82,2097,5465,7562
2021/03/29,12:30:00,167.1,2121,5391,7512
2021/03/29,13:00:00,167.1,2112,5367,7479
2021/03/29,13:30:00,165.44,2111,5383,7494
2021/03/29,14:00:00,165.37,2084,5370,7454
2021/03/29,14:30:00,165.44,2028,5346,7374
2021/03/29,15:00:00,165.37,1978,5414,7392
2021/03/29,15:30:00,165.29,1819,5562,7381
2021/03/29,16:00:00,166.75,1664,5568,7232
2021/03/29,16:30:00,164.25,1463,5794,7257
2021/03/29,17:00:00,163.52,1121,6012,7133
2021/03/29,17:30:00,168.09,844,6506,7350
2021/03/29,18:00:00,168.49,536,7046,7582
2021/03/29,18:30:00,168.41,332,7657,7989
2021/03/29,19:00:00,168.49,106,8290,8396
2021/03/29,19:30:00,204.06,104,8939,9043
2021/03/29,20:00:00,204.65,124,9117,9241
2021/03/29,20:30:00,203.5,126,9137,9263
2021/03/29,21:00:00,205.27,124,9036,9160
2021/03/29,21:30:00,204.65,125,8865,8990
2021/03/29,22:00:00,196.05,125,8603,8728
2021/03/29,22:30:00,195.84,125,8317,8442
2021/03/29,23:00:00,196.05,126,7962,8088
2021/03/29,23:30:00,196.13,125,7581,7706
2021/03/30,00:00:00,179.87,103,7115,7218
2021/03/30,00:30:00,174.49,57,6765,6822
2021/03/30,01:00:00,173.18,44,6400,6444
2021/03/30,01:30:00,180.53,40,6129,6169
2021/03/30,02:00:00,181.17,39,5904,5943
2021/03/30,02:30:00,180.53,39,5734,5773
2021/03/30,03:00:00,181.17,38,5605,5643
2021/03/30,03:30:00,180.53,38,5564,5602
2021/03/30,04:00:00,180.53,39,5526,5565
2021/03/30,04:30:00,181.17,37,5598,5635
2021/03/30,05:00:00,181.17,37,5731,5768
2021/03/30,05:30:00,180.53,37,5931,5968
2021/03/30,06:00:00,181.81,37,6076,6113
2021/03/30,06:30:00,181.17,37,6187,6224
2021/03/30,07:00:00,179.87,42,6353,6395
2021/03/30,07:30:00,181.17,205,6498,6703
2021/03/30,08:00:00,180.53,454,6538,6992
2021/03/30,08:30:00,180.53,719,6484,7203
2021/03/30,09:00:00,179.87,922,6331,7253
2021/03/30,09:30:00,179.87,1084,6313,7397
2021/03/30,10:00:00,181.81,1297,6045,7342
2021/03/30,10:30:00,180.53,1232,6140,7372
2021/03/30,11:00:00,181.81,1331,5924,7255
2021/03/30,11:30:00,181.81,1283,6127,7410
2021/03/30,12:00:00,180.53,1213,6085,7298
2021/03/30,12:30:00,181.81,1287,6055,7342
2021/03/30,13:00:00,180.53,1264,6133,7397
2021/03/30,13:30:00,181.17,1256,6174,7430
2021/03/30,14:00:00,181.17,1161,6151,7312
2021/03/30,14:30:00,181.17,1201,6194,7395
2021/03/30,15:00:00,180.53,1091,6251,7342
2021/03/30,15:30:00,181.17,987,6415,7402
2021/03/30,16:00:00,180.53,916,6578,7494
2021/03/30,16:30:00,181.17,739,6865,7604
2021/03/30,17:00:00,180.53,662,7062,7724
2021/03/30,17:30:00,180.53,539,7142,7681
2021/03/30,18:00:00,180.53,411,7548,7959
2021/03/30,18:30:00,204.65,306,7961,8267
2021/03/30,19:00:00,204.06,56,8460,8516
2021/03/30,19:30:00,203.5,57,8971,9028
2021/03/30,20:00:00,204.65,56,9069,9125
2021/03/30,20:30:00,204.06,56,9070,9126
2021/03/30,21:00:00,204.65,56,8925,8981
2021/03/30,21:30:00,195.84,56,8752,8808
2021/03/30,22:00:00,180.53,54,8502,8556
2021/03/30,22:30:00,180.53,55,8261,8316
2021/03/30,23:00:00,180.53,54,7881,7935
2021/03/30,23:30:00,182.45,53,7483,7536
2021/03/31,00:00:00,181.17,51,7044,7095
2021/03/31,00:30:00,180.53,50,6633,6683
2021/03/31,01:00:00,181.17,48,6336,6384
2021/03/31,01:30:00,180.53,49,6048,6097
2021/03/31,02:00:00,181.81,46,5815,5861
2021/03/31,02:30:00,181.17,45,5662,5707
2021/03/31,03:00:00,180.53,45,5576,5621
2021/03/31,03:30:00,181.81,43,5480,5523
2021/03/31,04:00:00,181.81,44,5493,5537
2021/03/31,04:30:00,181.81,44,5547,5591
2021/03/31,05:00:00,181.81,44,5653,5697
2021/03/31,05:30:00,181.81,44,5889,5933
2021/03/31,06:00:00,181.17,43,6015,6058
2021/03/31,06:30:00,180.53,43,6149,6192
2021/03/31,07:00:00,181.17,46,6243,6289
2021/03/31,07:30:00,179.87,197,6437,6634
2021/03/31,08:00:00,179.87,440,6383,6823
2021/03/31,08:30:00,179.21,829,6289,7118
2021/03/31,09:00:00,180.53,1132,6137,7269
2021/03/31,09:30:00,180.53,1368,6052,7420
2021/03/31,10:00:00,179.87,1581,6101,7682
2021/03/31,10:30:00,179.87,1633,6005,7638
2021/03/31,11:00:00,179.87,1795,5908,7703
2021/03/31,11:30:00,179.21,1844,5811,7655
2021/03/31,12:00:00,179.21,1945,5669,7614
2021/03/31,12:30:00,181.17,1950,5698,7648
2021/03/31,13:00:00,180.53,1868,5748,7616
2021/03/31,13:30:00,179.87,1988,5694,7682
2021/03/31,14:00:00,179.87,1890,5726,7616
2021/03/31,14:30:00,179.87,1701,5792,7493
2021/03/31,15:00:00,179.87,1754,5819,7573
2021/03/31,15:30:00,180.53,1674,5914,7588
2021/03/31,16:00:00,179.87,1611,6102,7713
2021/03/31,16:30:00,180.53,1450,6289,7739
2021/03/31,17:00:00,205.85,1008,6375,7383
2021/03/31,17:30:00,228.73,812,6795,7607
2021/03/31,18:00:00,229.16,528,7209,7737
2021/03/31,18:30:00,228.94,334,7646,7980
2021/03/31,19:00:00,228.94,117,8214,8331
2021/03/31,19:30:00,228.94,129,8735,8864
2021/03/31,20:00:00,229.16,134,8826,8960
2021/03/31,20:30:00,229.16,131,8837,8968
2021/03/31,21:00:00,228.94,127,8788,8915
2021/03/31,21:30:00,227.84,125,8587,8712
2021/03/31,22:00:00,179.87,125,8382,8507
2021/03/31,22:30:00,182.72,125,8108,8233
2021/03/31,23:00:00,188.14,125,7779,7904
2021/03/31,23:30:00,164.84,123,7397,7520
2021/04/01,00:00:00,165.44,123,6947,7070
2021/04/01,00:30:00,178.54,121,6558,6679
2021/04/01,01:00:00,180.53,80,6283,6363
2021/04/01,01:30:00,181.17,45,6056,6101
2021/04/01,02:00:00,181.17,35,5852,5887
2021/04/01,02:30:00,180.53,33,5833,5866
2021/04/01,03:00:00,180.53,31,5866,5897
2021/04/01,03:30:00,179.87,31,5820,5851
2021/04/01,04:00:00,181.17,31,5770,5801
2021/04/01,04:30:00,168.25,33,5849,5882
2021/04/01,05:00:00,168.81,37,5968,6005
2021/04/01,05:30:00,168.41,35,6162,6197
2021/04/01,06:00:00,168.33,32,6166,6198
2021/04/01,06:30:00,168.33,32,6083,6115
2021/04/01,07:00:00,168.17,42,6245,6287
2021/04/01,07:30:00,168.09,265,6328,6593
2021/04/01,08:00:00,168.49,539,6194,6733
2021/04/01,08:30:00,168.41,882,6136,7018
2021/04/01,09:00:00,168.33,1296,5986,7282
2021/04/01,09:30:00,168.01,1546,5946,7492
2021/04/01,10:00:00,168.41,1679,5920,7599
2021/04/01,10:30:00,167.93,1867,5739,7606
2021/04/01,11:00:00,168.41,1882,5662,7544
2021/04/01,11:30:00,167.61,1834,5877,7711
2021/04/01,12:00:00,168.57,1830,5799,7629
2021/04/01,12:30:00,168.65,1722,5890,7612
2021/04/01,13:00:00,167.93,1611,5927,7538
2021/04/01,13:30:00,168.09,1528,5933,7461
2021/04/01,14:00:00,168.25,1385,5882,7267
2021/04/01,14:30:00,168.17,1211,5923,7134
2021/04/01,15:00:00,168.41,1198,5949,7147
2021/04/01,15:30:00,168.25,1163,5980,7143
2021/04/01,16:00:00,168.09,1032,6202,7234
2021/04/01,16:30:00,168.17,908,6337,7245
2021/04/01,17:00:00,168.33,729,6683,7412
2021/04/01,17:30:00,168.41,578,7055,7633
2021/04/01,18:00:00,168.41,406,7371,7777
2021/04/01,18:30:00,168.49,260,7723,7983
2021/04/01,19:00:00,184.59,135,8205,8340
2021/04/01,19:30:00,204.06,126,8651,8777
2021/04/01,20:00:00,205.27,126,8726,8852
2021/04/01,20:30:00,204.06,124,8724,8848
2021/04/01,21:00:00,199.14,120,8625,8745
2021/04/01,21:30:00,180.53,121,8439,8560
2021/04/01,22:00:00,185.3,119,8240,8359
2021/04/01,22:30:00,180.53,119,8032,8151
2021/04/01,23:00:00,180.53,89,7712,7801
2021/04/01,23:30:00,168.57,55,7432,7487
2021/04/02,00:00:00,168.57,44,7024,7068
2021/04/02,00:30:00,168.65,39,6650,6689
2021/04/02,01:00:00,173.97,38,6352,6390
2021/04/02,01:30:00,181.17,38,6068,6106
2021/04/02,02:00:00,179.87,37,6014,6051
2021/04/02,02:30:00,180.53,37,5820,5857
2021/04/02,03:00:00,180.53,38,5859,5897
2021/04/02,03:30:00,179.87,38,5793,5831
2021/04/02,04:00:00,179.87,39,5741,5780
2021/04/02,04:30:00,181.17,38,5795,5833
2021/04/02,05:00:00,168.41,38,5853,5891
2021/04/02,05:30:00,181.17,39,6006,6045
2021/04/02,06:00:00,172.51,39,6131,6170
2021/04/02,06:30:00,171.89,39,6108,6147
2021/04/02,07:00:00,171.89,49,6103,6152
2021/04/02,07:30:00,171.89,275,6125,6400
2021/04/02,08:00:00,171.26,624,6064,6688
2021/04/02,08:30:00,179.21,979,5992,6971
2021/04/02,09:00:00,180.3,1376,5968,7344
2021/04/02,09:30:00,214.32,1554,6150,7704
2021/04/02,10:00:00,229.8,1634,6204,7838
2021/04/02,10:30:00,220.31,1715,6457,8172
2021/04/02,11:00:00,202.45,1632,6707,8339
2021/04/02,11:30:00,202.45,1528,6934,8462
2021/04/02,12:00:00,200.77,1455,7085,8540
2021/04/02,12:30:00,197.6,1386,7363,8749
2021/04/02,13:00:00,204.65,1572,7297,8869
2021/04/02,13:30:00,202.96,1743,7122,8865
2021/04/02,14:00:00,202.96,1542,7099,8641
2021/04/02,14:30:00,203.5,1416,7014,8430
2021/04/02,15:00:00,201.97,1636,6871,8507
2021/04/02,15:30:00,203.5,1571,6882,8453
2021/04/02,16:00:00,204.06,1323,7086,8409
2021/04/02,16:30:00,210.65,1253,7458,8711
2021/04/02,17:00:00,224.56,939,7759,8698
2021/04/02,17:30:00,224.31,674,8045,8719
2021/04/02,18:00:00,224.31,409,8341,8750
2021/04/02,18:30:00,202.96,301,8475,8776
2021/04/02,19:00:00,203.5,50,8453,8503
2021/04/02,19:30:00,203.5,46,8556,8602
2021/04/02,20:00:00,203.5,47,8369,8416
2021/04/02,20:30:00,203.5,51,8160,8211
2021/04/02,21:00:00,203.5,55,7999,8054
2021/04/02,21:30:00,201.41,54,7852,7906
2021/04/02,22:00:00,200.72,55,7701,7756
2021/04/02,22:30:00,203.5,55,7542,7597
2021/04/02,23:00:00,203.5,51,7349,7400
2021/04/02,23:30:00,203.5,50,7077,7127
2021/04/03,00:00:00,203.5,47,6790,6837
2021/04/03,00:30:00,164.84,44,6494,6538
2021/04/03,01:00:00,165.21,40,6198,6238
2021/04/03,01:30:00,164.77,43,5972,6015
2021/04/03,02:00:00,165.37,43,5747,5790
2021/04/03,02:30:00,164.84,41,5619,5660
2021/04/03,03:00:00,165.75,43,5669,5712
2021/04/03,03:30:00,164.84,42,5611,5653
2021/04/03,04:00:00,164.84,47,5554,5601
2021/04/03,04:30:00,164.99,46,5586,5632
2021/04/03,05:00:00,164.77,43,5689,5732
2021/04/03,05:30:00,164.69,44,5787,5831
2021/04/03,06:00:00,164.62,44,5876,5920
2021/04/03,06:30:00,164.69,44,5797,5841
2021/04/03,07:00:00,164.84,53,5755,5808
2021/04/03,07:30:00,163.67,296,5817,6113
2021/04/03,08:00:00,164.84,555,5652,6207
2021/04/03,08:30:00,164.84,945,5542,6487
2021/04/03,09:00:00,167.06,1316,5302,6618
2021/04/03,09:30:00,169.7,1529,5338,6867
2021/04/03,10:00:00,170.19,1617,5370,6987
2021/04/03,10:30:00,170.19,1730,5410,7140
2021/04/03,11:00:00,164.47,1828,5342,7170
2021/04/03,11:30:00,165.44,1780,5404,7184
2021/04/03,12:00:00,164.84,1737,5379,7116
2021/04/03,12:30:00,164.84,1854,5251,7105
2021/04/03,13:00:00,164.47,1867,5142,7009
2021/04/03,13:30:00,164.91,1871,5098,6969
2021/04/03,14:00:00,164.84,1903,5027,6930
2021/04/03,14:30:00,164.99,1866,5016,6882
2021/04/03,15:00:00,164.99,1876,4958,6834
2021/04/03,15:30:00,164.84,1759,5035,6794
2021/04/03,16:00:00,202.96,1673,5146,6819
2021/04/03,16:30:00,204.65,1484,5398,6882
2021/04/03,17:00:00,202.45,1180,5530,6710
2021/04/03,17:30:00,203.5,914,5818,6732
2021/04/03,18:00:00,202.45,576,6285,6861
2021/04/03,18:30:00,202.96,347,6847,7194
2021/04/03,19:00:00,205.27,107,7401,7508
2021/04/03,19:30:00,203.5,114,7953,8067
2021/04/03,20:00:00,202.96,131,8213,8344
2021/04/03,20:30:00,203.5,131,8198,8329
2021/04/03,21:00:00,203.5,128,8124,8252
2021/04/03,21:30:00,203.5,127,8043,8170
2021/04/03,22:00:00,203.5,122,7894,8016
2021/04/03,22:30:00,204.65,120,7759,7879
2021/04/03,23:00:00,203.5,121,7568,7689
2021/04/03,23:30:00,204.06,120,7258,7378
2021/04/04,00:00:00,204.28,121,6953,7074
2021/04/04,00:30:00,180.53,120,6599,6719
2021/04/04,01:00:00,180.53,117,6315,6432
2021/04/04,01:30:00,179.87,83,6065,6148
2021/04/04,02:00:00,153.24,49,5850,5899
2021/04/04,02:30:00,152.96,41,5660,5701
2021/04/04,03:00:00,153.59,37,5504,5541
2021/04/04,03:30:00,153.03,37,5613,5650
2021/04/04,04:00:00,152.83,37,5563,5600
2021/04/04,04:30:00,202.55,37,5630,5667
2021/04/04,05:00:00,202.56,37,5778,5815
2021/04/04,05:30:00,202.47,37,5866,5903
2021/04/04,06:00:00,152.55,37,6056,6093
2021/04/04,06:30:00,152.96,37,6190,6227
2021/04/04,07:00:00,152.62,127,6417,6544
2021/04/04,07:30:00,152.96,302,6516,6818
2021/04/04,08:00:00,152.83,644,6384,7028
2021/04/04,08:30:00,152.96,1057,6151,7208
2021/04/04,09:00:00,152.48,1452,5924,7376
2021/04/04,09:30:00,153.74,1632,5811,7443
2021/04/04,10:00:00,152.41,1808,5981,7789
2021/04/04,10:30:00,152.83,1906,5903,7809
2021/04/04,11:00:00,152.9,2002,5812,7814
2021/04/04,11:30:00,153.1,2064,5739,7803
2021/04/04,12:00:00,152.83,2089,5705,7794
2021/04/04,12:30:00,153.1,2097,5639,7736
2021/04/04,13:00:00,152.83,2104,5669,7773
2021/04/04,13:30:00,153.03,2084,5695,7779
2021/04/04,14:00:00,152.83,2065,5671,7736
2021/04/04,14:30:00,153.03,2011,5684,7695
2021/04/04,15:00:00,156.67,1955,5758,7713
2021/04/04,15:30:00,170.23,1846,5877,7723
2021/04/04,16:00:00,156.99,1651,6001,7652
2021/04/04,16:30:00,169.89,1479,6172,7651
2021/04/04,17:00:00,156.67,1161,6505,7666
2021/04/04,17:30:00,156.83,856,6665,7521
2021/04/04,18:00:00,156.67,551,7143,7694
2021/04/04,18:30:00,206.12,326,7613,7939
2021/04/04,19:00:00,206.12,107,8190,8297
2021/04/04,19:30:00,230.01,120,8797,8917
2021/04/04,20:00:00,234.32,124,9013,9137
2021/04/04,20:30:00,233.2,124,9041,9165
2021/04/04,21:00:00,228.94,123,8937,9060
2021/04/04,21:30:00,205.06,123,8758,8881
2021/04/04,22:00:00,207.93,121,8495,8616
2021/04/04,22:30:00,206.12,121,8231,8352
2021/04/04,23:00:00,206.12,120,7821,7941
2021/04/04,23:30:00,206.7,120,7365,7485
2021/04/05,00:00:00,207.3,121,6926,7047
2021/04/05,00:30:00,179.21,120,6545,6665
2021/04/05,01:00:00,176.47,114,6241,6355
2021/04/05,01:30:00,178.54,57,6016,6073
2021/04/05,02:00:00,176.47,45,5832,5877
2021/04/05,02:30:00,178.54,41,5718,5759
2021/04/05,03:00:00,179.21,39,5640,5679
2021/04/05,03:30:00,178.54,38,5564,5602
2021/04/05,04:00:00,178.54,37,5566,5603
2021/04/05,04:30:00,153.59,38,5665,5703
2021/04/05,05:00:00,152.41,37,5854,5891
2021/04/05,05:30:00,237.76,38,6109,6147
2021/04/05,06:00:00,226.47,39,6231,6270
2021/04/05,06:30:00,226.66,39,6407,6446
2021/04/05,07:00:00,226.07,55,6709,6764
2021/04/05,07:30:00,168.16,300,6844,7144
2021/04/05,08:00:00,169.97,610,6533,7143
2021/04/05,08:30:00,153.29,950,6288,7238
2021/04/05,09:00:00,153.31,1318,5993,7311
2021/04/05,09:30:00,152.96,1511,6018,7529
2021/04/05,10:00:00,153.52,1685,6027,7712
2021/04/05,10:30:00,153.24,1723,5866,7589
2021/04/05,11:00:00,153.24,1849,5766,7615
2021/04/05,11:30:00,152.69,1876,5710,7586
2021/04/05,12:00:00,153.52,1941,5656,7597
2021/04/05,12:30:00,155.83,2013,5622,7635
2021/04/05,13:00:00,156.2,2020,5669,7689
2021/04/05,13:30:00,156.35,2017,5703,7720
2021/04/05,14:00:00,156.5,2007,5762,7769
2021/04/05,14:30:00,156.5,1938,5821,7759
2021/04/05,15:00:00,156.67,1865,5890,7755
2021/04/05,15:30:00,156.36,1745,6009,7754
2021/04/05,16:00:00,156.67,1588,6117,7705
2021/04/05,16:30:00,156.67,1431,6298,7729
2021/04/05,17:00:00,156.67,1113,6559,7672
2021/04/05,17:30:00,156.67,869,6922,7791
2021/04/05,18:00:00,180.3,524,7140,7664
2021/04/05,18:30:00,187.5,326,7358,7684
2021/04/05,19:00:00,205.58,82,7733,7815
2021/04/05,19:30:00,205.58,100,8216,8316
2021/04/05,20:00:00,205.58,96,8316,8412
2021/04/05,20:30:00,207.3,127,8272,8399
2021/04/05,21:00:00,204.85,127,8165,8292
2021/04/05,21:30:00,203.01,125,7984,8109
2021/04/05,22:00:00,202.43,125,7750,7875
2021/04/05,22:30:00,180.3,125,7621,7746
2021/04/05,23:00:00,181.83,124,7279,7403
2021/04/05,23:30:00,180.3,124,6931,7055
2021/04/06,00:00:00,156.35,124,6550,6674
2021/04/06,00:30:00,156.2,126,6212,6338
2021/04/06,01:00:00,156.35,97,5981,6078
2021/04/06,01:30:00,155.76,64,5798,5862
2021/04/06,02:00:00,156.28,55,5650,5705
2021/04/06,02:30:00,156.35,44,5525,5569
2021/04/06,03:00:00,156.35,41,5432,5473
2021/04/06,03:30:00,156.28,39,5461,5500
2021/04/06,04:00:00,156.06,41,5456,5497
2021/04/06,04:30:00,156.35,42,5559,5601
2021/04/06,05:00:00,156.06,42,5695,5737
2021/04/06,05:30:00,155.98,43,5956,5999
2021/04/06,06:00:00,156.13,43,5993,6036
2021/04/06,06:30:00,156.13,40,6158,6198
2021/04/06,07:00:00,156.35,120,6328,6448
2021/04/06,07:30:00,156.43,277,6479,6756
2021/04/06,08:00:00,156.35,525,6213,6738
2021/04/06,08:30:00,156.8,870,6094,6964
2021/04/06,09:00:00,156.43,1180,5865,7045
2021/04/06,09:30:00,156.28,1442,5713,7155
2021/04/06,10:00:00,156.35,1598,5809,7407
2021/04/06,10:30:00,156.06,1751,5907,7658
2021/04/06,11:00:00,156.28,1822,5891,7713
2021/04/06,11:30:00,157.02,1811,5930,7741
2021/04/06,12:00:00,156.35,1939,5892,7831
2021/04/06,12:30:00,156.28,1964,5932,7896
2021/04/06,13:00:00,156.35,1954,6046,8000
2021/04/06,13:30:00,156.2,1937,6192,8129
2021/04/06,14:00:00,154.67,1906,6306,8212
2021/04/06,14:30:00,156.2,1834,6391,8225
2021/04/06,15:00:00,158.59,1763,6460,8223
2021/04/06,15:30:00,177.3,1635,6622,8257
2021/04/06,16:00:00,173.14,1501,6696,8197
2021/04/06,16:30:00,211.18,1272,6883,8155
2021/04/06,17:00:00,211.45,1029,7108,8137
2021/04/06,17:30:00,211.18,720,7250,7970
2021/04/06,18:00:00,210.9,487,7279,7766
2021/04/06,18:30:00,211.45,303,7516,7819
2021/04/06,19:00:00,211.45,118,7700,7818
2021/04/06,19:30:00,210.9,119,8022,8141
2021/04/06,20:00:00,211.18,119,8108,8227
2021/04/06,20:30:00,211.18,119,7985,8104
2021/04/06,21:00:00,206.7,119,7870,7989
2021/04/06,21:30:00,211.18,119,7701,7820
2021/04/06,22:00:00,211.18,118,7537,7655
2021/04/06,22:30:00,199.91,119,7326,7445
2021/04/06,23:00:00,196.65,119,7022,7141
2021/04/06,23:30:00,180.3,118,6778,6896
2021/04/07,00:00:00,180.3,117,6496,6613
2021/04/07,00:30:00,156.65,98,6191,6289
2021/04/07,01:00:00,156.43,64,6018,6082
2021/04/07,01:30:00,156.35,43,5840,5883
2021/04/07,02:00:00,156.35,39,5703,5742
2021/04/07,02:30:00,155.69,39,5597,5636
2021/04/07,03:00:00,156.43,37,5496,5533
2021/04/07,03:30:00,167.96,38,5495,5533
2021/04/07,04:00:00,202.89,37,5463,5500
2021/04/07,04:30:00,208.88,36,5560,5596
2021/04/07,05:00:00,207.07,37,5660,5697
2021/04/07,05:30:00,166.71,37,5896,5933
2021/04/07,06:00:00,198.28,37,5951,5988
2021/04/07,06:30:00,181.35,37,5972,6009
2021/04/07,07:00:00,190.17,129,6176,6305
2021/04/07,07:30:00,206.76,276,6324,6600
2021/04/07,08:00:00,210.04,558,6180,6738
2021/04/07,08:30:00,204.22,809,6149,6958
2021/04/07,09:00:00,213.88,1084,5989,7073
2021/04/07,09:30:00,212.28,1415,5926,7341
2021/04/07,10:00:00,213.35,1615,5892,7507
2021/04/07,10:30:00,218.33,1683,5880,7563
2021/04/07,11:00:00,217.86,1859,5969,7828
2021/04/07,11:30:00,206.14,1889,5957,7846
2021/04/07,12:00:00,201.52,1928,5984,7912
2021/04/07,12:30:00,193.6,1990,5979,7969
2021/04/07,13:00:00,198.28,1971,6043,8014
2021/04/07,13:30:00,197.53,1982,6094,8076
2021/04/07,14:00:00,203.89,1953,6162,8115
2021/04/07,14:30:00,156.67,1929,6203,8132
2021/04/07,15:00:00,156.67,1828,6277,8105
2021/04/07,15:30:00,156.67,1722,6384,8106
2021/04/07,16:00:00,156.67,1528,6476,8004
2021/04/07,16:30:00,156.35,1354,6617,7971
2021/04/07,17:00:00,156.35,1014,6829,7843
2021/04/07,17:30:00,156.13,775,6933,7708
2021/04/07,18:00:00,155.61,436,7154,7590
2021/04/07,18:30:00,156.43,287,7216,7503
2021/04/07,19:00:00,156.2,118,7387,7505
2021/04/07,19:30:00,156.2,129,7701,7830
2021/04/07,20:00:00,156.35,123,7725,7848
2021/04/07,20:30:00,156.58,123,7692,7815
2021/04/07,21:00:00,156.58,123,7542,7665
2021/04/07,21:30:00,156.43,124,7398,7522
2021/04/07,22:00:00,156.43,122,7259,7381
2021/04/07,22:30:00,156.43,122,7083,7205
2021/04/07,23:00:00,156.65,123,6841,6964
2021/04/07,23:30:00,156.43,124,6628,6752
2021/04/08,00:00:00,190.1,127,6327,6454
2021/04/08,00:30:00,190.71,125,6022,6147
2021/04/08,01:00:00,166.47,92,5887,5979
2021/04/08,01:30:00,165.92,51,5772,5823
2021/04/08,02:00:00,165.92,41,5651,5692
2021/04/08,02:30:00,165.92,39,5478,5517
2021/04/08,03:00:00,164.58,39,5438,5477
2021/04/08,03:30:00,164.58,38,5396,5434
2021/04/08,04:00:00,166.47,38,5439,5477
2021/04/08,04:30:00,164.58,38,5505,5543
2021/04/08,05:00:00,165.92,40,5637,5677
2021/04/08,05:30:00,164.58,40,5857,5897
2021/04/08,06:00:00,170.95,43,5855,5898
2021/04/08,06:30:00,190.1,44,6019,6063
2021/04/08,07:00:00,156.43,53,6226,6279
2021/04/08,07:30:00,156.65,263,6419,6682
2021/04/08,08:00:00,156.65,465,6236,6701
2021/04/08,08:30:00,156.65,830,6154,6984
2021/04/08,09:00:00,156.43,1028,6032,7060
2021/04/08,09:30:00,156.13,1297,5915,7212
2021/04/08,10:00:00,156.65,1616,5933,7549
2021/04/08,10:30:00,156.58,1688,5964,7652
2021/04/08,11:00:00,156.58,1857,5870,7727
2021/04/08,11:30:00,156.58,1974,5759,7733
2021/04/08,12:00:00,156.35,2011,5750,7761
2021/04/08,12:30:00,156.58,2049,5700,7749
2021/04/08,13:00:00,156.35,2049,5771,7820
2021/04/08,13:30:00,156.65,2047,5829,7876
2021/04/08,14:00:00,156.65,2011,5863,7874
2021/04/08,14:30:00,156.2,1963,5892,7855
2021/04/08,15:00:00,156.65,1877,5910,7787
2021/04/08,15:30:00,156.43,1743,6053,7796
2021/04/08,16:00:00,156.58,1608,6130,7738
2021/04/08,16:30:00,156.35,1418,6275,7693
2021/04/08,17:00:00,156.58,1113,6563,7676
2021/04/08,17:30:00,155.54,868,6719,7587
2021/04/08,18:00:00,156.72,528,6913,7441
2021/04/08,18:30:00,156.65,312,7233,7545
2021/04/08,19:00:00,193.36,121,7566,7687
2021/04/08,19:30:00,203.73,113,8005,8118
2021/04/08,20:00:00,204.28,129,8051,8180
2021/04/08,20:30:00,205.45,131,7954,8085
2021/04/08,21:00:00,206.74,130,7839,7969
2021/04/08,21:30:00,201.5,129,7659,7788
2021/04/08,22:00:00,191.69,126,7467,7593
2021/04/08,22:30:00,188.62,122,7302,7424
2021/04/08,23:00:00,190.4,129,7031,7160
2021/04/08,23:30:00,190.71,133,6767,6900
2021/04/09,00:00:00,156.28,131,6465,6596
2021/04/09,00:30:00,156.65,135,6133,6268
2021/04/09,01:00:00,156.43,105,5954,6059
2021/04/09,01:30:00,163.48,62,5798,5860
2021/04/09,02:00:00,156.2,12,5699,5711
2021/04/09,02:30:00,156.43,11,5548,5559
2021/04/09,03:00:00,156.28,11,5537,5548
2021/04/09,03:30:00,156.35,12,5490,5502
2021/04/09,04:00:00,156.43,9,5498,5507
2021/04/09,04:30:00,161.2,9,5535,5544
2021/04/09,05:00:00,156.35,5,5642,5647
2021/04/09,05:30:00,156.28,7,5779,5786
2021/04/09,06:00:00,161.2,7,5771,5778
2021/04/09,06:30:00,161.97,6,5783,5789
2021/04/09,07:00:00,156.65,100,5855,5955
2021/04/09,07:30:00,156.5,288,5911,6199
2021/04/09,08:00:00,156.43,560,5728,6288
2021/04/09,08:30:00,156.72,935,5583,6518
2021/04/09,09:00:00,156.35,1231,5432,6663
2021/04/09,09:30:00,156.5,1350,5475,6825
2021/04/09,10:00:00,156.65,1574,5396,6970
2021/04/09,10:30:00,156.65,1746,5217,6963
2021/04/09,11:00:00,156.43,1824,5120,6944
2021/04/09,11:30:00,156.5,1962,5100,7062
2021/04/09,12:00:00,169.1,2011,5193,7204
2021/04/09,12:30:00,156.43,1989,5138,7127
2021/04/09,13:00:00,169.1,1971,5169,7140
2021/04/09,13:30:00,169.1,2004,5155,7159
2021/04/09,14:00:00,169.1,1931,5133,7064
2021/04/09,14:30:00,161.2,1936,5160,7096
2021/04/09,15:00:00,161.2,1819,5225,7044
2021/04/09,15:30:00,158.82,1715,5291,7006
2021/04/09,16:00:00,169.1,1477,5446,6923
2021/04/09,16:30:00,169.1,1375,5685,7060
2021/04/09,17:00:00,222.7,1065,6007,7072
2021/04/09,17:30:00,222.7,775,6489,7264
2021/04/09,18:00:00,222.7,536,6971,7507
2021/04/09,18:30:00,231.06,316,7351,7667
2021/04/09,19:00:00,231.06,114,7226,7340
2021/04/09,19:30:00,231.23,106,7427,7533
2021/04/09,20:00:00,231.58,105,7378,7483
2021/04/09,20:30:00,229.05,111,7196,7307
2021/04/09,21:00:00,180.3,112,7018,7130
2021/04/09,21:30:00,180.3,113,6913,7026
2021/04/09,22:00:00,180.3,114,6734,6848
2021/04/09,22:30:00,180.3,115,6628,6743
2021/04/09,23:00:00,180.3,117,6418,6535
2021/04/09,23:30:00,180.3,109,6223,6332
2021/04/10,00:00:00,178.54,115,6012,6127
2021/04/10,00:30:00,179.21,100,5820,5920
2021/04/10,01:00:00,156.52,4,5670,5674
2021/04/10,01:30:00,156.67,3,5553,5556
2021/04/10,02:00:00,178.54,2,5545,5547
2021/04/10,02:30:00,178.54,2,5448,5450
2021/04/10,03:00:00,178.54,1,5375,5376
2021/04/10,03:30:00,178.54,1,5342,5343
2021/04/10,04:00:00,157.92,1,5326,5327
2021/04/10,04:30:00,157.33,1,5347,5348
2021/04/10,05:00:00,156.58,2,5462,5464
2021/04/10,05:30:00,156.58,1,5560,5561
2021/04/10,06:00:00,163.69,2,5562,5564
2021/04/10,06:30:00,163.07,4,5500,5504
2021/04/10,07:00:00,161.44,153,5476,5629
2021/04/10,07:30:00,163.69,122,5498,5620
2021/04/10,08:00:00,163.07,213,5568,5781
2021/04/10,08:30:00,207.3,395,5646,6041
2021/04/10,09:00:00,208.59,510,5658,6168
2021/04/10,09:30:00,204.09,703,5800,6503
2021/04/10,10:00:00,207.73,912,5868,6780
2021/04/10,10:30:00,208.59,989,5932,6921
2021/04/10,11:00:00,207.3,962,6145,7107
2021/04/10,11:30:00,231.84,1056,6101,7157
2021/04/10,12:00:00,231.84,1023,6157,7180
2021/04/10,12:30:00,207.3,1019,6194,7213
2021/04/10,13:00:00,220.66,1110,5901,7011
2021/04/10,13:30:00,208.59,1294,5814,7108
2021/04/10,14:00:00,224.06,1226,5931,7157
2021/04/10,14:30:00,207.93,1196,5859,7055
2021/04/10,15:00:00,207.3,1185,5823,7008
2021/04/10,15:30:00,207.3,955,5894,6849
2021/04/10,16:00:00,207.93,1008,5974,6982
2021/04/10,16:30:00,206.12,907,6187,7094
2021/04/10,17:00:00,207.3,847,6355,7202
2021/04/10,17:30:00,207.3,668,6814,7482
2021/04/10,18:00:00,206.12,439,7204,7643
2021/04/10,18:30:00,206.12,206,7454,7660
2021/04/10,19:00:00,231.44,26,7777,7803
2021/04/10,19:30:00,231.84,8,8253,8261
2021/04/10,20:00:00,231.84,9,8588,8597
2021/04/10,20:30:00,232.04,9,8727,8736
2021/04/10,21:00:00,232.04,9,8653,8662
2021/04/10,21:30:00,231.84,11,8492,8503
2021/04/10,22:00:00,218.81,7,8252,8259
2021/04/10,22:30:00,207.3,6,8003,8009
2021/04/10,23:00:00,205.45,6,7640,7646
2021/04/10,23:30:00,201.5,6,7249,7255
2021/04/11,00:00:00,202.13,8,6845,6853
2021/04/11,00:30:00,179.21,12,6464,6476
2021/04/11,01:00:00,155.91,13,6153,6166
2021/04/11,01:30:00,178.54,7,5897,5904
2021/04/11,02:00:00,179.21,5,5670,5675
2021/04/11,02:30:00,179.21,6,5668,5674
2021/04/11,03:00:00,179.21,7,5736,5743
2021/04/11,03:30:00,178.54,10,5698,5708
2021/04/11,04:00:00,178.54,8,5683,5691
2021/04/11,04:30:00,179.21,6,5774,5780
2021/04/11,05:00:00,156.83,4,5991,5995
2021/04/11,05:30:00,156.52,7,6048,6055
2021/04/11,06:00:00,163.69,6,6049,6055
2021/04/11,06:30:00,216.91,4,6298,6302
2021/04/11,07:00:00,227.84,103,6608,6711
2021/04/11,07:30:00,225.53,220,6778,6998
2021/04/11,08:00:00,214.41,543,6615,7158
2021/04/11,08:30:00,163.07,814,6492,7306
2021/04/11,09:00:00,176.47,1039,6319,7358
2021/04/11,09:30:00,180.3,1169,6324,7493
2021/04/11,10:00:00,180.3,1196,6446,7642
2021/04/11,10:30:00,214.73,1137,6515,7652
2021/04/11,11:00:00,214.73,1224,6480,7704
2021/04/11,11:30:00,214.41,1215,6518,7733
2021/04/11,12:00:00,214.73,1291,6496,7787
2021/04/11,12:30:00,180.53,1382,6461,7843
2021/04/11,13:00:00,180.3,1445,6367,7812
2021/04/11,13:30:00,180.3,1455,6378,7833
2021/04/11,14:00:00,180.3,1716,6193,7909
2021/04/11,14:30:00,178.54,1790,6189,7979
2021/04/11,15:00:00,156.52,1846,6255,8101
2021/04/11,15:30:00,156.52,1684,6443,8127
2021/04/11,16:00:00,206.7,1443,6604,8047
2021/04/11,16:30:00,206.7,1345,6738,8083
2021/04/11,17:00:00,206.12,1152,6918,8070
2021/04/11,17:30:00,206.7,828,7322,8150
2021/04/11,18:00:00,206.7,586,7758,8344
2021/04/11,18:30:00,248.98,332,8216,8548
2021/04/11,19:00:00,232.04,683,8655,9338
2021/04/11,19:30:00,231.84,97,9274,9371
2021/04/11,20:00:00,232.04,94,9374,9468
2021/04/11,20:30:00,231.84,109,9320,9429
2021/04/11,21:00:00,232.04,112,9114,9226
2021/04/11,21:30:00,231.87,112,8848,8960
2021/04/11,22:00:00,231.84,110,8645,8755
2021/04/11,22:30:00,219.26,108,8342,8450
2021/04/11,23:00:00,207.3,107,7908,8015
2021/04/11,23:30:00,206.12,108,7486,7594
2021/04/12,00:00:00,203.61,108,7015,7123
2021/04/12,00:30:00,224.31,87,6603,6690
2021/04/12,01:00:00,187.72,2,6372,6374
2021/04/12,01:30:00,189.83,4,6288,6292
2021/04/12,02:00:00,188.08,6,6085,6091
2021/04/12,02:30:00,186.64,7,5917,5924
2021/04/12,03:00:00,187.72,6,5919,5925
2021/04/12,03:30:00,187.36,3,6008,6011
2021/04/12,04:00:00,193.81,2,6016,6018
2021/04/12,04:30:00,194.13,1,6110,6111
2021/04/12,05:00:00,194.45,1,6034,6035
2021/04/12,05:30:00,188.44,0,6290,6290
2021/04/12,06:00:00,161.44,0,6378,6378
2021/04/12,06:30:00,161.44,0,6659,6659
2021/04/12,07:00:00,163.69,107,6997,7104
2021/04/12,07:30:00,152.69,279,7130,7409
2021/04/12,08:00:00,152.83,566,6922,7488
2021/04/12,08:30:00,161.44,810,6862,7672
2021/04/12,09:00:00,161.44,1033,6751,7784
2021/04/12,09:30:00,161.44,1333,6544,7877
2021/04/12,10:00:00,178.54,1472,6417,7889
2021/04/12,10:30:00,180.3,1530,6607,8137
2021/04/12,11:00:00,155.9,1693,6334,8027
2021/04/12,11:30:00,157.59,1685,6441,8126
2021/04/12,12:00:00,157.76,1850,6305,8155
2021/04/12,12:30:00,157.97,1864,6282,8146
2021/04/12,13:00:00,157.58,1870,6275,8145
2021/04/12,13:30:00,158.37,1811,6258,8069
2021/04/12,14:00:00,179.21,1916,6145,8061
2021/04/12,14:30:00,179.21,1955,6104,8059
2021/04/12,15:00:00,179.21,1902,6087,7989
2021/04/12,15:30:00,179.21,1827,6215,8042
2021/04/12,16:00:00,179.21,1698,6318,8016
2021/04/12,16:30:00,179.21,1502,6571,8073
2021/04/12,17:00:00,176.47,1200,6857,8057
2021/04/12,17:30:00,179.21,919,6955,7874
2021/04/12,18:00:00,183.07,626,7439,8065
2021/04/12,18:30:00,220.51,412,7949,8361
2021/04/12,19:00:00,223.05,114,9167,9281
2021/04/12,19:30:00,240.1,114,9053,9167
2021/04/12,20:00:00,239.95,114,9230,9344
2021/04/12,20:30:00,239.1,109,9224,9333
2021/04/12,21:00:00,239.95,110,9108,9218
2021/04/12,21:30:00,223.48,112,8916,9028
2021/04/12,22:00:00,212.79,115,8701,8816
2021/04/12,22:30:00,207.3,113,8429,8542
2021/04/12,23:00:00,208.59,113,8061,8174
2021/04/12,23:30:00,205.45,98,7590,7688
2021/04/13,00:00:00,215.16,1,7260,7261
2021/04/13,00:30:00,181.17,0,6888,6888
2021/04/13,01:00:00,156.67,0,6531,6531
2021/04/13,01:30:00,156.52,0,6295,6295
2021/04/13,02:00:00,156.52,0,6115,6115
2021/04/13,02:30:00,156.52,0,5968,5968
2021/04/13,03:00:00,156.67,0,5921,5921
2021/04/13,03:30:00,179.21,0,5940,5940
2021/04/13,04:00:00,155.91,0,6039,6039
2021/04/13,04:30:00,153.17,0,6168,6168
2021/04/13,05:00:00,180.3,0,6264,6264
2021/04/13,05:30:00,180.3,0,6368,6368
2021/04/13,06:00:00,183.93,0,6363,6363
2021/04/13,06:30:00,195.35,0,6591,6591
2021/04/13,07:00:00,219.05,132,6846,6978
2021/04/13,07:30:00,208,352,6820,7172
2021/04/13,08:00:00,161.44,739,6478,7217
2021/04/13,08:30:00,179.21,1156,6282,7438
2021/04/13,09:00:00,179.21,1453,6072,7525
2021/04/13,09:30:00,179.21,1638,6151,7789
2021/04/13,10:00:00,178.54,1814,6023,7837
2021/04/13,10:30:00,171.79,1845,5967,7812
2021/04/13,11:00:00,175.11,1982,5782,7764
2021/04/13,11:30:00,175.56,2040,5749,7789
2021/04/13,12:00:00,175.56,2098,5690,7788
2021/04/13,12:30:00,178.54,2106,5696,7802
2021/04/13,13:00:00,179.21,2116,5715,7831
2021/04/13,13:30:00,178.54,2093,5696,7789
2021/04/13,14:00:00,179.21,2071,5668,7739
2021/04/13,14:30:00,178.54,2015,5681,7696
2021/04/13,15:00:00,178.54,1947,5644,7591
2021/04/13,15:30:00,175.11,1853,5830,7683
2021/04/13,16:00:00,174.67,1674,5947,7621
2021/04/13,16:30:00,179.21,1508,6161,7669
2021/04/13,17:00:00,178.54,1168,6411,7579
2021/04/13,17:30:00,176.47,832,6860,7692
2021/04/13,18:00:00,178.54,551,7209,7760
2021/04/13,18:30:00,179.62,313,7714,8027
2021/04/13,19:00:00,207.14,119,8170,8289
2021/04/13,19:30:00,210.64,113,8469,8582
2021/04/13,20:00:00,208.34,130,8678,8808
2021/04/13,20:30:00,205.45,131,8741,8872
2021/04/13,21:00:00,205.45,127,8670,8797
2021/04/13,21:30:00,207.3,126,8491,8617
2021/04/13,22:00:00,207.93,123,8327,8450
2021/04/13,22:30:00,207.3,122,8114,8236
2021/04/13,23:00:00,207.93,121,7753,7874
2021/04/13,23:30:00,204.85,121,7383,7504
2021/04/14,00:00:00,178.54,118,6960,7078
2021/04/14,00:30:00,178.54,113,6630,6743
2021/04/14,01:00:00,152.96,75,6371,6446
2021/04/14,01:30:00,155.91,0,6188,6188
2021/04/14,02:00:00,155.91,0,6041,6041
2021/04/14,02:30:00,155.91,0,5928,5928
2021/04/14,03:00:00,155.91,0,5837,5837
2021/04/14,03:30:00,155.91,0,5824,5824
2021/04/14,04:00:00,155.91,0,5933,5933
2021/04/14,04:30:00,155.91,0,6065,6065
2021/04/14,05:00:00,153.1,0,6096,6096
2021/04/14,05:30:00,203.62,0,6173,6173
2021/04/14,06:00:00,206.08,1,6285,6286
2021/04/14,06:30:00,161.44,1,6333,6334
2021/04/14,07:00:00,161.44,126,6467,6593
2021/04/14,07:30:00,161.57,360,6495,6855
2021/04/14,08:00:00,154.31,679,6273,6952
2021/04/14,08:30:00,153.38,1110,6063,7173
2021/04/14,09:00:00,154.52,1455,5933,7388
2021/04/14,09:30:00,156.06,1646,5731,7377
2021/04/14,10:00:00,155.76,1805,5604,7409
2021/04/14,10:30:00,155.61,1919,5452,7371
2021/04/14,11:00:00,155.76,2006,5320,7326
2021/04/14,11:30:00,155.69,2045,5313,7358
2021/04/14,12:00:00,155.76,2085,5180,7265
2021/04/14,12:30:00,155.76,2098,5209,7307
2021/04/14,13:00:00,156.67,2090,5207,7297
2021/04/14,13:30:00,156.52,2085,5167,7252
2021/04/14,14:00:00,156.52,2061,5050,7111
2021/04/14,14:30:00,156.52,2013,5003,7016
2021/04/14,15:00:00,156.83,1941,5026,6967
2021/04/14,15:30:00,156.36,1844,5084,6928
2021/04/14,16:00:00,156.67,1662,5261,6923
2021/04/14,16:30:00,156.67,1508,5384,6892
2021/04/14,17:00:00,170,1188,5631,6819
2021/04/14,17:30:00,170,893,6085,6978
2021/04/14,18:00:00,180.3,565,6584,7149
2021/04/14,18:30:00,180.3,358,7115,7473
2021/04/14,19:00:00,218.4,107,7574,7681
2021/04/14,19:30:00,205.58,105,7691,7796
2021/04/14,20:00:00,206.7,113,7926,8039
2021/04/14,20:30:00,206.12,122,7765,7887
2021/04/14,21:00:00,206.12,121,7520,7641
2021/04/14,21:30:00,204.28,121,7353,7474
2021/04/14,22:00:00,180.54,121,7202,7323
2021/04/14,22:30:00,180.54,120,7080,7200
2021/04/14,23:00:00,180.3,120,6887,7007
2021/04/14,23:30:00,155.54,120,6742,6862
2021/04/15,00:00:00,185.51,121,6519,6640
2021/04/15,00:30:00,179.87,121,6245,6366
2021/04/15,01:00:00,155.91,122,6026,6148
2021/04/15,01:30:00,178.54,111,5807,5917
2021/04/15,02:00:00,155.91,63,5688,5751
2021/04/15,02:30:00,176.47,2,5585,5587
2021/04/15,03:00:00,157.33,2,5511,5513
2021/04/15,03:30:00,157.33,2,5470,5473
2021/04/15,04:00:00,155.98,3,5522,5524
2021/04/15,04:30:00,157.33,2,5593,5595
2021/04/15,05:00:00,156.07,2,5576,5579
2021/04/15,05:30:00,155.91,2,5578,5580
2021/04/15,06:00:00,161.44,4,5554,5558
2021/04/15,06:30:00,178.54,3,5412,5416
2021/04/15,07:00:00,155.69,109,5375,5484
2021/04/15,07:30:00,155.83,344,5244,5588
2021/04/15,08:00:00,155.83,621,5055,5675
2021/04/15,08:30:00,155.54,1104,4788,5893
2021/04/15,09:00:00,155.83,1359,4763,6122
2021/04/15,09:30:00,155.69,1573,4858,6432
2021/04/15,10:00:00,155.61,1728,4795,6523
2021/04/15,10:30:00,155.69,1845,4713,6557
2021/04/15,11:00:00,155.69,1943,4651,6594
2021/04/15,11:30:00,155.76,2007,4593,6600
2021/04/15,12:00:00,155.61,2042,4521,6564
2021/04/15,12:30:00,155.69,2032,4501,6533
2021/04/15,13:00:00,155.61,2064,4487,6551
2021/04/15,13:30:00,155.83,2053,4434,6487
2021/04/15,14:00:00,155.76,2014,4374,6388
2021/04/15,14:30:00,155.69,1946,4400,6346
2021/04/15,15:00:00,155.17,1879,4435,6314
2021/04/15,15:30:00,155.1,1795,4592,6387
2021/04/15,16:00:00,156.36,1609,4789,6398
2021/04/15,16:30:00,156.83,1432,5070,6503
2021/04/15,17:00:00,156.83,1080,5440,6519
2021/04/15,17:30:00,156.83,802,5660,6462
2021/04/15,18:00:00,195.23,456,6095,6551
2021/04/15,18:30:00,178.54,317,6512,6829
2021/04/15,19:00:00,180.3,115,6880,6995
2021/04/15,19:30:00,187.5,116,7069,7184
2021/04/15,20:00:00,180.3,123,7342,7466
2021/04/15,20:30:00,180.3,123,7370,7493
2021/04/15,21:00:00,180.3,121,7303,7425
2021/04/15,21:30:00,180.3,121,7191,7313
2021/04/15,22:00:00,180.3,121,7042,7163
2021/04/15,22:30:00,180.3,121,6858,6980
2021/04/15,23:00:00,180.3,121,6656,6777
2021/04/15,23:30:00,180.3,121,6422,6543
2021/04/16,00:00:00,180.3,121,6242,6363
2021/04/16,00:30:00,156.52,121,6015,6136
2021/04/16,01:00:00,178.54,122,5836,5958
2021/04/16,01:30:00,155.91,111,5682,5793
2021/04/16,02:00:00,155.91,63,5580,5643
2021/04/16,02:30:00,155.91,2,5536,5538
2021/04/16,03:00:00,155.91,2,5434,5436
2021/04/16,03:30:00,155.91,2,5429,5431
2021/04/16,04:00:00,155.91,3,5476,5479
2021/04/16,04:30:00,155.91,2,5491,5493
2021/04/16,05:00:00,155.91,2,5549,5551
2021/04/16,05:30:00,155.91,2,5591,5593
2021/04/16,06:00:00,178.54,4,5606,5610
2021/04/16,06:30:00,152.83,3,5588,5591
2021/04/16,07:00:00,155.39,109,5641,5750
2021/04/16,07:30:00,156.35,344,5571,5915
2021/04/16,08:00:00,156.43,621,5356,5977
2021/04/16,08:30:00,155.69,1104,5150,6254
2021/04/16,09:00:00,156.65,1359,4983,6342
2021/04/16,09:30:00,156.72,1573,5007,6580
2021/04/16,10:00:00,156.28,1728,4983,6711
2021/04/16,10:30:00,155.69,1845,4977,6822
2021/04/16,11:00:00,156.13,1943,4933,6876
2021/04/16,11:30:00,157.02,2007,4816,6823
2021/04/16,12:00:00,156.13,2042,4819,6861
2021/04/16,12:30:00,157.02,2032,4884,6916
2021/04/16,13:00:00,156.8,2064,4868,6932
2021/04/16,13:30:00,156.72,2053,4841,6894
2021/04/16,14:00:00,156.65,2014,4875,6889
2021/04/16,14:30:00,156.65,1946,4984,6930
2021/04/16,15:00:00,155.83,1879,4916,6795
2021/04/16,15:30:00,156.43,1795,4990,6785
2021/04/16,16:00:00,156.36,1609,5160,6769
2021/04/16,16:30:00,156.43,1432,5472,6904
2021/04/16,17:00:00,155.39,1080,5869,6949
2021/04/16,17:30:00,193.73,802,6348,7150
2021/04/16,18:00:00,178.54,456,6842,7298
2021/04/16,18:30:00,207.93,317,7103,7420
2021/04/16,19:00:00,207.93,115,7092,7207
2021/04/16,19:30:00,208.59,116,7037,7153
2021/04/16,20:00:00,206.7,123,7255,7378
2021/04/16,20:30:00,207.3,123,7100,7223
2021/04/16,21:00:00,206.7,121,6965,7086
2021/04/16,21:30:00,207.3,121,6799,6920
2021/04/16,22:00:00,205.58,121,6713,6834
2021/04/16,22:30:00,204.28,121,6616,6737
2021/04/16,23:00:00,206.74,121,6402,6523
2021/04/16,23:30:00,178.54,121,6262,6383
2021/04/17,00:00:00,179.21,123,6111,6234
2021/04/17,00:30:00,179.21,122,5950,6072
2021/04/17,01:00:00,155.93,74,5854,5928
2021/04/17,01:30:00,179.21,39,5740,5779
2021/04/17,02:00:00,179.21,2,5650,5652
2021/04/17,02:30:00,179.21,3,5558,5561
2021/04/17,03:00:00,179.21,2,5523,5525
2021/04/17,03:30:00,179.21,2,5521,5523
2021/04/17,04:00:00,179.21,0,5477,5477
2021/04/17,04:30:00,179.21,0,5556,5556
2021/04/17,05:00:00,178.54,0,5523,5523
2021/04/17,05:30:00,179.21,0,5520,5520
2021/04/17,06:00:00,176.47,0,5539,5539
2021/04/17,06:30:00,176.47,0,5379,5379
2021/04/17,07:00:00,152.83,116,5291,5407
2021/04/17,07:30:00,154.23,317,5083,5400
2021/04/17,08:00:00,151.87,559,5157,5716
2021/04/17,08:30:00,153.1,901,4980,5881
2021/04/17,09:00:00,155.76,1304,4706,6010
2021/04/17,09:30:00,156.13,1559,4625,6184
2021/04/17,10:00:00,156.2,1698,4549,6247
2021/04/17,10:30:00,156.13,1836,4514,6350
2021/04/17,11:00:00,156.35,1907,4492,6399
2021/04/17,11:30:00,156.72,1966,4468,6434
2021/04/17,12:00:00,156.43,1997,4483,6480
2021/04/17,12:30:00,156.2,2001,4506,6507
2021/04/17,13:00:00,156.2,2015,4540,6555
2021/04/17,13:30:00,156.2,2000,4550,6550
2021/04/17,14:00:00,156.58,1968,4592,6560
2021/04/17,14:30:00,156.06,1891,4649,6540
2021/04/17,15:00:00,156.65,1829,4796,6625
2021/04/17,15:30:00,156.13,1705,5013,6718
2021/04/17,16:00:00,156.87,1516,5264,6780
2021/04/17,16:30:00,155.69,1275,5352,6627
2021/04/17,17:00:00,155.83,939,5676,6615
2021/04/17,17:30:00,155.76,730,6085,6815
2021/04/17,18:00:00,180.3,506,6335,6841
2021/04/17,18:30:00,207.78,331,6677,7008
2021/04/17,19:00:00,178.54,108,6895,7003
2021/04/17,19:30:00,180.3,112,7014,7126
2021/04/17,20:00:00,180.3,121,7316,7437
2021/04/17,20:30:00,206.12,117,7362,7479
2021/04/17,21:00:00,205.58,118,7409,7527
2021/04/17,21:30:00,206.12,119,7324,7443
2021/04/17,22:00:00,205.58,118,7242,7360
2021/04/17,22:30:00,205.58,116,7122,7238
2021/04/17,23:00:00,206.12,116,6904,7020
2021/04/17,23:30:00,206.12,116,6756,6872
2021/04/18,00:00:00,179.21,105,6492,6597
2021/04/18,00:30:00,178.54,1,6407,6408
2021/04/18,01:00:00,157.34,1,6110,6111
2021/04/18,01:30:00,155.91,1,5969,5970
2021/04/18,02:00:00,156.58,2,5822,5824
2021/04/18,02:30:00,157.35,3,5704,5707
2021/04/18,03:00:00,156.13,3,5681,5684
2021/04/18,03:30:00,157.34,4,5650,5654
2021/04/18,04:00:00,156.13,5,5648,5653
2021/04/18,04:30:00,156.28,5,5763,5768
2021/04/18,05:00:00,187.73,4,5753,5757
2021/04/18,05:30:00,202.29,3,5926,5929
2021/04/18,06:00:00,214.94,2,6005,6007
2021/04/18,06:30:00,180.31,4,6117,6121
2021/04/18,07:00:00,180.3,120,6265,6385
2021/04/18,07:30:00,180.3,289,6422,6711
2021/04/18,08:00:00,180.3,526,6474,7000
2021/04/18,08:30:00,180.3,836,6514,7350
2021/04/18,09:00:00,201.36,1074,6422,7496
2021/04/18,09:30:00,201.26,1341,6347,7688
2021/04/18,10:00:00,201.3,1530,6291,7821
2021/04/18,10:30:00,201.23,1698,6291,7989
2021/04/18,11:00:00,201.23,1791,6332,8123
2021/04/18,11:30:00,201.23,1876,6371,8247
2021/04/18,12:00:00,178.54,1901,6439,8340
2021/04/18,12:30:00,179.21,1919,6545,8464
2021/04/18,13:00:00,207.78,1915,6711,8626
2021/04/18,13:30:00,214.41,1902,6916,8818
2021/04/18,14:00:00,227.84,1736,7016,8752
2021/04/18,14:30:00,190.67,1793,7098,8891
2021/04/18,15:00:00,222.7,1786,7107,8893
2021/04/18,15:30:00,222.7,1566,7166,8732
2021/04/18,16:00:00,190.34,1413,7284,8697
2021/04/18,16:30:00,227.84,1185,7570,8755
2021/04/18,17:00:00,227.62,959,7764,8723
2021/04/18,17:30:00,232.04,688,8027,8715
2021/04/18,18:00:00,2556.17,431,8292,8723
2021/04/18,18:30:00,234.5,290,8381,8671
2021/04/18,19:00:00,258.12,67,8532,8599
2021/04/18,19:30:00,255.04,1,8550,8551
2021/04/18,20:00:00,256.56,1,8692,8693
2021/04/18,20:30:00,253.56,1,8707,8708
2021/04/18,21:00:00,258.24,1,8614,8615
2021/04/18,21:30:00,255.7,1,8459,8460
2021/04/18,22:00:00,256.9,0,8192,8192
2021/04/18,22:30:00,254.18,0,8035,8035
2021/04/18,23:00:00,206.12,0,7848,7848
2021/04/18,23:30:00,227.84,1,7568,7569
2021/04/19,00:00:00,222.7,1,7351,7352
2021/04/19,00:30:00,207.3,1,7413,7414
2021/04/19,01:00:00,206.7,2,7235,7237
2021/04/19,01:30:00,207.3,2,7058,7060
2021/04/19,02:00:00,189.89,2,6899,6901
2021/04/19,02:30:00,222.7,2,6790,6792
2021/04/19,03:00:00,222.7,3,6720,6723
2021/04/19,03:30:00,222.7,5,6724,6729
2021/04/19,04:00:00,222.7,2,6718,6720
2021/04/19,04:30:00,222.7,2,6717,6719
2021/04/19,05:00:00,222.7,3,6804,6807
2021/04/19,05:30:00,222.7,3,6928,6931
2021/04/19,06:00:00,170.12,2,6849,6851
2021/04/19,06:30:00,170.57,2,7002,7004
2021/04/19,07:00:00,170.94,93,7181,7274
2021/04/19,07:30:00,162.44,266,7360,7626
2021/04/19,08:00:00,178.54,481,7344,7825
2021/04/19,08:30:00,162.72,765,7457,8222
2021/04/19,09:00:00,164.27,996,7423,8419
2021/04/19,09:30:00,163.01,1300,7463,8763
2021/04/19,10:00:00,169.1,1288,7462,8750
2021/04/19,10:30:00,187.5,1272,7787,9059
2021/04/19,11:00:00,207.3,1342,7808,9150
2021/04/19,11:30:00,2068.42,1327,7854,9181
2021/04/19,12:00:00,2068.42,1276,8096,9372
2021/04/19,12:30:00,202.09,1731,8243,9974
2021/04/19,13:00:00,197.74,1636,8462,10098
2021/04/19,13:30:00,229.83,1649,8632,10281
2021/04/19,14:00:00,225.95,1559,8911,10470
2021/04/19,14:30:00,229.83,1330,9226,10556
2021/04/19,15:00:00,231.61,1184,9380,10564
2021/04/19,15:30:00,230.89,1183,9370,10553
2021/04/19,16:00:00,230.89,1067,9447,10514
2021/04/19,16:30:00,230.89,864,9492,10356
2021/04/19,17:00:00,231.61,634,9714,10348
2021/04/19,17:30:00,228.8,409,9845,10254
2021/04/19,18:00:00,233.39,287,9925,10212
2021/04/19,18:30:00,233.58,133,9905,10038
2021/04/19,19:00:00,233.95,4,9880,9884
2021/04/19,19:30:00,233.95,2,9781,9783
2021/04/19,20:00:00,233.58,0,9800,9800
2021/04/19,20:30:00,229.83,0,9737,9737
2021/04/19,21:00:00,233.95,0,9598,9598
2021/04/19,21:30:00,233.95,0,9458,9458
2021/04/19,22:00:00,228.8,1,9261,9262
2021/04/19,22:30:00,222.75,1,9008,9009
2021/04/19,23:00:00,234.5,1,8738,8739
2021/04/19,23:30:00,222.7,1,8431,8432
2021/04/20,00:00:00,197.03,0,8221,8221
2021/04/20,00:30:00,155.77,0,8020,8020
2021/04/20,01:00:00,155.77,0,7709,7709
2021/04/20,01:30:00,222.7,0,7563,7563
2021/04/20,02:00:00,222.7,0,7714,7714
2021/04/20,02:30:00,222.7,0,7562,7562
2021/04/20,03:00:00,155.63,1,7452,7453
2021/04/20,03:30:00,155.77,0,7399,7399
2021/04/20,04:00:00,155.63,0,7404,7404
2021/04/20,04:30:00,155.77,0,7424,7424
2021/04/20,05:00:00,155.77,0,7456,7456
2021/04/20,05:30:00,156.44,0,7556,7556
2021/04/20,06:00:00,164.48,1,7460,7461
2021/04/20,06:30:00,163.37,1,7469,7470
2021/04/20,07:00:00,163.52,109,7716,7825
2021/04/20,07:30:00,163.65,222,7750,7972
2021/04/20,08:00:00,197.44,360,7747,8107
2021/04/20,08:30:00,203.33,548,7694,8242
2021/04/20,09:00:00,203.59,663,7848,8511
2021/04/20,09:30:00,203.82,863,7809,8672
2021/04/20,10:00:00,203.76,1042,7753,8795
2021/04/20,10:30:00,195.39,1308,7755,9063
2021/04/20,11:00:00,195.64,1565,7690,9255
2021/04/20,11:30:00,196.49,1715,7666,9381
2021/04/20,12:00:00,196.49,1799,7630,9429
2021/04/20,12:30:00,196.2,1929,7675,9604
2021/04/20,13:00:00,196.49,1935,7757,9692
2021/04/20,13:30:00,196.49,1879,7928,9807
2021/04/20,14:00:00,195.64,1925,7968,9893
2021/04/20,14:30:00,195.64,1908,7850,9758
2021/04/20,15:00:00,195.39,1817,7814,9631
2021/04/20,15:30:00,195.14,1673,7877,9550
2021/04/20,16:00:00,194.9,1517,7865,9382
2021/04/20,16:30:00,194.9,1304,7922,9226
2021/04/20,17:00:00,194.45,1069,7959,9028
2021/04/20,17:30:00,194.67,797,8128,8925
2021/04/20,18:00:00,194.45,563,8264,8827
2021/04/20,18:30:00,194.23,321,8350,8671
2021/04/20,19:00:00,194.23,114,8340,8454
2021/04/20,19:30:00,194.01,113,8314,8427
2021/04/20,20:00:00,193.79,110,8425,8535
2021/04/20,20:30:00,193.79,13,8553,8566
2021/04/20,21:00:00,193.58,12,8430,8442
2021/04/20,21:30:00,193.58,12,8247,8259
2021/04/20,22:00:00,180.3,12,8074,8086
2021/04/20,22:30:00,180.3,14,7921,7935
2021/04/20,23:00:00,180.54,12,7671,7683
2021/04/20,23:30:00,180.3,15,7429,7444
2021/04/21,00:00:00,156.52,15,7188,7203
2021/04/21,00:30:00,156.13,15,6964,6979
2021/04/21,01:00:00,155.91,15,6734,6749
2021/04/21,01:30:00,157.33,13,6553,6566
2021/04/21,02:00:00,156.52,8,6420,6428
2021/04/21,02:30:00,156.67,5,6482,6487
2021/04/21,03:00:00,156.52,6,6541,6547
2021/04/21,03:30:00,156.67,4,6535,6539
2021/04/21,04:00:00,157.33,4,6483,6487
2021/04/21,04:30:00,156.67,5,6501,6506
2021/04/21,05:00:00,157.33,3,6603,6606
2021/04/21,05:30:00,169.1,4,6754,6758
2021/04/21,06:00:00,161.44,4,6605,6609
2021/04/21,06:30:00,155.61,3,6719,6722
2021/04/21,07:00:00,161.44,129,6904,7033
2021/04/21,07:30:00,161.44,279,7028,7307
2021/04/21,08:00:00,161.56,561,6930,7491
2021/04/21,08:30:00,163.21,665,6895,7560
2021/04/21,09:00:00,163.6,997,6701,7698
2021/04/21,09:30:00,163.41,1343,6518,7861
2021/04/21,10:00:00,163.76,1666,6294,7960
2021/04/21,10:30:00,158.12,1782,6156,7938
2021/04/21,11:00:00,156.96,1844,6141,7985
2021/04/21,11:30:00,157.08,1910,5799,7709
2021/04/21,12:00:00,157.13,2007,5786,7793
2021/04/21,12:30:00,158.61,2047,5833,7880
2021/04/21,13:00:00,158.58,2048,5876,7924
2021/04/21,13:30:00,157.18,2033,5925,7958
2021/04/21,14:00:00,158.46,2024,5947,7971
2021/04/21,14:30:00,158.33,1902,6047,7949
2021/04/21,15:00:00,158.69,1708,6213,7921
2021/04/21,15:30:00,156.93,1620,6216,7836
2021/04/21,16:00:00,158.12,1426,6366,7792
2021/04/21,16:30:00,156.67,1203,6563,7766
2021/04/21,17:00:00,179.21,974,6713,7687
2021/04/21,17:30:00,178.54,720,7026,7746
2021/04/21,18:00:00,178.54,523,7229,7752
2021/04/21,18:30:00,178.54,334,7475,7809
2021/04/21,19:00:00,193.58,114,7663,7777
2021/04/21,19:30:00,206.12,113,7757,7870
2021/04/21,20:00:00,205.58,85,7973,8058
2021/04/21,20:30:00,206.74,11,8109,8120
2021/04/21,21:00:00,206.12,11,8038,8049
2021/04/21,21:30:00,206.12,11,7872,7883
2021/04/21,22:00:00,205.06,9,7687,7696
2021/04/21,22:30:00,206.12,9,7490,7499
2021/04/21,23:00:00,206.12,12,7281,7293
2021/04/21,23:30:00,203.73,9,7040,7049
2021/04/22,00:00:00,204.28,8,6807,6815
2021/04/22,00:30:00,178.54,6,6546,6552
2021/04/22,01:00:00,155.91,7,6347,6354
2021/04/22,01:30:00,155.6,6,6172,6178
2021/04/22,02:00:00,155.6,6,6058,6064
2021/04/22,02:30:00,155.91,6,6069,6075
2021/04/22,03:00:00,155.6,5,5998,6003
2021/04/22,03:30:00,155.91,2,5997,5999
2021/04/22,04:00:00,155.6,2,6051,6053
2021/04/22,04:30:00,155.6,3,6084,6087
2021/04/22,05:00:00,155.91,4,6114,6118
2021/04/22,05:30:00,157.33,3,6249,6252
2021/04/22,06:00:00,178.54,4,6208,6212
2021/04/22,06:30:00,161.44,4,6296,6300
2021/04/22,07:00:00,161.44,149,6503,6652
2021/04/22,07:30:00,162.49,357,6583,6940
2021/04/22,08:00:00,163.07,644,6401,7045
2021/04/22,08:30:00,178.54,898,6279,7177
2021/04/22,09:00:00,179.21,1163,6171,7334
2021/04/22,09:30:00,179.21,1487,5931,7418
2021/04/22,10:00:00,170.14,1782,5734,7516
2021/04/22,10:30:00,178.54,1914,5664,7578
2021/04/22,11:00:00,179.21,2024,5612,7636
2021/04/22,11:30:00,178.54,2075,5590,7665
2021/04/22,12:00:00,174.67,2105,5561,7666
2021/04/22,12:30:00,175.56,2121,5584,7705
2021/04/22,13:00:00,175.11,2122,5672,7794
2021/04/22,13:30:00,174.23,2114,5735,7849
2021/04/22,14:00:00,174.67,2080,5718,7798
2021/04/22,14:30:00,179.21,2039,5747,7786
2021/04/22,15:00:00,179.21,1954,5766,7720
2021/04/22,15:30:00,157.07,1840,5863,7703
2021/04/22,16:00:00,178.54,1681,5958,7639
2021/04/22,16:30:00,158.36,1467,6057,7524
2021/04/22,17:00:00,178.54,1153,6303,7456
2021/04/22,17:30:00,178.54,912,6660,7572
2021/04/22,18:00:00,180.88,653,6971,7624
2021/04/22,18:30:00,179.21,379,7330,7709
2021/04/22,19:00:00,180.3,100,7570,7670
2021/04/22,19:30:00,180.3,99,7695,7794
2021/04/22,20:00:00,180.3,124,7837,7961
2021/04/22,20:30:00,187.5,125,7914,8039
2021/04/22,21:00:00,206.7,124,7801,7925
2021/04/22,21:30:00,206.12,123,7638,7761
2021/04/22,22:00:00,206.12,128,7390,7518
2021/04/22,22:30:00,203.73,137,7222,7359
2021/04/22,23:00:00,179.21,137,7007,7144
2021/04/22,23:30:00,179.21,143,6776,6919
2021/04/23,00:00:00,156.13,131,6528,6659
2021/04/23,00:30:00,156.28,87,6401,6488
2021/04/23,01:00:00,156.28,2,6277,6279
2021/04/23,01:30:00,156.13,2,6083,6085
2021/04/23,02:00:00,157.35,4,5920,5924
2021/04/23,02:30:00,172.96,7,5798,5805
2021/04/23,03:00:00,174.67,8,5721,5729
2021/04/23,03:30:00,174.67,3,5696,5699
2021/04/23,04:00:00,175.56,2,5706,5708
2021/04/23,04:30:00,174.67,1,5737,5738
2021/04/23,05:00:00,174.67,4,5717,5721
2021/04/23,05:30:00,175.11,1,5785,5786
2021/04/23,06:00:00,156.35,1,5713,5714
2021/04/23,06:30:00,155.98,3,5755,5758
2021/04/23,07:00:00,156.43,138,5934,6072
2021/04/23,07:30:00,156.65,364,5942,6306
2021/04/23,08:00:00,156.58,643,5775,6418
2021/04/23,08:30:00,156.8,937,5800,6737
2021/04/23,09:00:00,156.13,1201,5670,6871
2021/04/23,09:30:00,154.52,1522,5467,6989
2021/04/23,10:00:00,155.91,1790,5311,7101
2021/04/23,10:30:00,156.35,1931,5264,7195
2021/04/23,11:00:00,156.06,2026,5305,7331
2021/04/23,11:30:00,156.43,2072,5291,7363
2021/04/23,12:00:00,156.43,2101,5284,7385
2021/04/23,12:30:00,155.91,2109,5328,7437
2021/04/23,13:00:00,156.35,2105,5276,7381
2021/04/23,13:30:00,156.2,2082,5350,7432
2021/04/23,14:00:00,156.28,2058,5384,7442
2021/04/23,14:30:00,156.06,1991,5437,7428
2021/04/23,15:00:00,155.91,1858,5531,7389
2021/04/23,15:30:00,155.83,1584,5721,7305
2021/04/23,16:00:00,155.76,1304,5948,7252
2021/04/23,16:30:00,156.35,1129,6223,7352
2021/04/23,17:00:00,153.17,802,6471,7273
2021/04/23,17:30:00,151.94,641,6948,7589
2021/04/23,18:00:00,207.3,370,7277,7647
2021/04/23,18:30:00,207.93,436,7452,7888
2021/04/23,19:00:00,201.13,110,7419,7529
2021/04/23,19:30:00,207.3,125,7329,7454
2021/04/23,20:00:00,206.7,137,7336,7473
2021/04/23,20:30:00,207.3,139,7208,7347
2021/04/23,21:00:00,204.85,141,7052,7193
2021/04/23,21:30:00,202.13,139,6916,7055
2021/04/23,22:00:00,201.5,73,6853,6926
2021/04/23,22:30:00,152.96,43,6744,6787
2021/04/23,23:00:00,153.38,1,6643,6644
2021/04/23,23:30:00,153.1,1,6539,6540
2021/04/24,00:00:00,153.38,1,6381,6382
2021/04/24,00:30:00,153.59,3,6234,6237
2021/04/24,01:00:00,153.24,1,6101,6102
2021/04/24,01:30:00,153.52,3,5980,5983
2021/04/24,02:00:00,153.52,2,5873,5875
2021/04/24,02:30:00,153.31,1,5803,5804
2021/04/24,03:00:00,153.24,5,5748,5753
2021/04/24,03:30:00,153.52,1,5715,5716
2021/04/24,04:00:00,153.52,1,5711,5712
2021/04/24,04:30:00,153.03,0,5710,5710
2021/04/24,05:00:00,153.1,0,5726,5726
2021/04/24,05:30:00,153.38,0,5731,5731
2021/04/24,06:00:00,153.1,2,5637,5639
2021/04/24,06:30:00,153.24,0,5533,5533
2021/04/24,07:00:00,153.88,93,5449,5542
2021/04/24,07:30:00,156.2,208,5439,5647
2021/04/24,08:00:00,156.58,338,5336,5674
2021/04/24,08:30:00,156.58,525,5281,5806
2021/04/24,09:00:00,156.65,856,5114,5970
2021/04/24,09:30:00,155.83,1103,5129,6232
2021/04/24,10:00:00,156.72,1460,4982,6442
2021/04/24,10:30:00,156.43,1744,4953,6697
2021/04/24,11:00:00,156.58,1924,4907,6831
2021/04/24,11:30:00,156.8,1991,4878,6869
2021/04/24,12:00:00,156.58,1987,4919,6906
2021/04/24,12:30:00,156.5,2008,4981,6989
2021/04/24,13:00:00,156.13,1891,5117,7008
2021/04/24,13:30:00,156.43,1924,5079,7003
2021/04/24,14:00:00,156.28,1951,5017,6968
2021/04/24,14:30:00,155.69,1772,5230,7002
2021/04/24,15:00:00,155.69,1798,5170,6968
2021/04/24,15:30:00,156.06,1597,5505,7102
2021/04/24,16:00:00,156.06,1445,5658,7103
2021/04/24,16:30:00,156.13,1314,5766,7080
2021/04/24,17:00:00,155.76,1047,5872,6919
2021/04/24,17:30:00,155.91,753,6199,6952
2021/04/24,18:00:00,156.13,404,6587,6991
2021/04/24,18:30:00,153.74,296,6846,7142
2021/04/24,19:00:00,180.3,111,6961,7072
2021/04/24,19:30:00,180.3,123,7093,7216
2021/04/24,20:00:00,211.4,126,7329,7455
2021/04/24,20:30:00,181.1,57,7523,7580
2021/04/24,21:00:00,180.3,40,7528,7568
2021/04/24,21:30:00,180.3,6,7520,7526
2021/04/24,22:00:00,180.3,7,7392,7399
2021/04/24,22:30:00,180.3,7,7282,7289
2021/04/24,23:00:00,180.3,5,7067,7072
2021/04/24,23:30:00,180.3,6,6899,6905
2021/04/25,00:00:00,180.3,6,6667,6673
2021/04/25,00:30:00,179.21,7,6430,6437
2021/04/25,01:00:00,152.69,6,6227,6233
2021/04/25,01:30:00,157.5,7,6060,6067
2021/04/25,02:00:00,157.38,8,5905,5913
2021/04/25,02:30:00,156.07,8,5810,5818
2021/04/25,03:00:00,156.03,6,5765,5771
2021/04/25,03:30:00,156,6,5754,5760
2021/04/25,04:00:00,155.96,4,5754,5758
2021/04/25,04:30:00,155.92,4,5800,5804
2021/04/25,05:00:00,155.91,2,5831,5833
2021/04/25,05:30:00,155.91,2,6025,6027
2021/04/25,06:00:00,161.44,1,5971,5972
2021/04/25,06:30:00,161.44,0,6192,6192
2021/04/25,07:00:00,161.5,135,6319,6454
2021/04/25,07:30:00,162.97,417,6438,6855
2021/04/25,08:00:00,164.55,652,6429,7081
2021/04/25,08:30:00,161.85,1057,6323,7380
2021/04/25,09:00:00,176.47,1390,6146,7536
2021/04/25,09:30:00,176.47,1623,6106,7729
2021/04/25,10:00:00,178.54,1759,6189,7948
2021/04/25,10:30:00,179.21,1886,6194,8080
2021/04/25,11:00:00,179.21,1961,6203,8164
2021/04/25,11:30:00,179.21,1994,6194,8188
2021/04/25,12:00:00,178.54,2044,6252,8296
2021/04/25,12:30:00,176.47,2055,6349,8404
2021/04/25,13:00:00,176.47,2066,6415,8481
2021/04/25,13:30:00,178.54,2050,6506,8556
2021/04/25,14:00:00,158.08,2030,6579,8609
2021/04/25,14:30:00,160,1958,6672,8630
2021/04/25,15:00:00,160,1874,6793,8667
2021/04/25,15:30:00,160,1754,6887,8641
2021/04/25,16:00:00,160,1583,6901,8484
2021/04/25,16:30:00,160,1388,7047,8435
2021/04/25,17:00:00,178.54,1054,7209,8263
2021/04/25,17:30:00,178.54,831,7411,8242
2021/04/25,18:00:00,206.7,523,7692,8215
2021/04/25,18:30:00,206.12,334,7883,8217
2021/04/25,19:00:00,206.12,124,7947,8071
2021/04/25,19:30:00,206.7,130,7953,8083
2021/04/25,20:00:00,219.82,128,8083,8211
2021/04/25,20:30:00,206.7,128,8110,8238
2021/04/25,21:00:00,206.7,125,8009,8134
2021/04/25,21:30:00,204.28,126,7900,8026
2021/04/25,22:00:00,201.89,124,7712,7836
2021/04/25,22:30:00,203.01,141,7523,7664
2021/04/25,23:00:00,201.89,146,7310,7456
2021/04/25,23:30:00,203.01,138,7045,7183
2021/04/26,00:00:00,205.59,127,6793,6920
2021/04/26,00:30:00,158.86,120,6596,6716
2021/04/26,01:00:00,158.52,115,6418,6533
2021/04/26,01:30:00,157.75,3,6346,6349
2021/04/26,02:00:00,158.27,1,6226,6227
2021/04/26,02:30:00,157.6,1,6122,6123
2021/04/26,03:00:00,156.43,1,6040,6041
2021/04/26,03:30:00,156.43,1,6022,6023
2021/04/26,04:00:00,157.78,2,6041,6043
2021/04/26,04:30:00,157.63,4,6080,6084
2021/04/26,05:00:00,156.43,11,6106,6117
2021/04/26,05:30:00,156.43,4,6272,6276
2021/04/26,06:00:00,161.76,13,6192,6205
2021/04/26,06:30:00,163.51,18,6357,6375
2021/04/26,07:00:00,163.77,44,6627,6671
2021/04/26,07:30:00,178.54,237,6754,6991
2021/04/26,08:00:00,178.54,359,6722,7081
2021/04/26,08:30:00,162.04,456,6681,7137
2021/04/26,09:00:00,163.84,620,6596,7216
2021/04/26,09:30:00,164.01,885,6459,7344
2021/04/26,10:00:00,179.21,1514,6396,7910
2021/04/26,10:30:00,179.21,1802,6201,8003
2021/04/26,11:00:00,179.21,1769,6168,7937
2021/04/26,11:30:00,178.54,1877,6093,7970
2021/04/26,12:00:00,179.21,1946,6051,7997
2021/04/26,12:30:00,179.21,2007,6064,8071
2021/04/26,13:00:00,174.67,2057,6071,8128
2021/04/26,13:30:00,175.11,1987,6137,8124
2021/04/26,14:00:00,174.67,1925,6230,8155
2021/04/26,14:30:00,156.73,1766,6336,8102
2021/04/26,15:00:00,156.65,1659,6404,8063
2021/04/26,15:30:00,156.56,1484,6611,8095
2021/04/26,16:00:00,157.93,1228,6695,7923
2021/04/26,16:30:00,158.06,1150,6817,7967
2021/04/26,17:00:00,178.54,981,6711,7692
2021/04/26,17:30:00,178.54,793,7067,7860
2021/04/26,18:00:00,176.47,474,7334,7808
2021/04/26,18:30:00,179.21,354,7569,7923
2021/04/26,19:00:00,176.47,156,7761,7917
2021/04/26,19:30:00,207.93,156,7859,8015
2021/04/26,20:00:00,214.73,153,8036,8189
2021/04/26,20:30:00,214.41,154,8077,8231
2021/04/26,21:00:00,215.05,152,7972,8124
2021/04/26,21:30:00,206.74,151,7779,7930
2021/04/26,22:00:00,180.3,89,7597,7686
2021/04/26,22:30:00,180.3,8,7475,7483
2021/04/26,23:00:00,180.3,1,7235,7236
2021/04/26,23:30:00,179.21,1,7001,7002
2021/04/27,00:00:00,178.54,4,6681,6685
2021/04/27,00:30:00,179.21,2,6494,6496
2021/04/27,01:00:00,156.2,4,6281,6285
2021/04/27,01:30:00,156.35,7,6109,6116
2021/04/27,02:00:00,156.2,5,5975,5980
2021/04/27,02:30:00,156.43,2,5864,5866
2021/04/27,03:00:00,156.28,2,5811,5813
2021/04/27,03:30:00,156.28,2,5809,5811
2021/04/27,04:00:00,156.13,2,5819,5821
2021/04/27,04:30:00,156.35,3,5896,5899
2021/04/27,05:00:00,156.35,1,5940,5941
2021/04/27,05:30:00,156.35,2,6074,6076
2021/04/27,06:00:00,179.21,4,6013,6017
2021/04/27,06:30:00,156.28,3,6355,6358
2021/04/27,07:00:00,156.35,154,6537,6691
2021/04/27,07:30:00,156.28,312,6724,7036
2021/04/27,08:00:00,156.35,634,6516,7150
2021/04/27,08:30:00,156.72,933,6339,7272
2021/04/27,09:00:00,156.58,1282,6202,7484
2021/04/27,09:30:00,156.43,1533,6175,7708
2021/04/27,10:00:00,155.98,1755,6063,7818
2021/04/27,10:30:00,156.43,1892,5954,7846
2021/04/27,11:00:00,156.43,1980,5894,7874
2021/04/27,11:30:00,156.43,2042,5820,7862
2021/04/27,12:00:00,156.58,2078,5760,7838
2021/04/27,12:30:00,156.43,2098,5797,7895
2021/04/27,13:00:00,156.58,2093,5801,7894
2021/04/27,13:30:00,156.43,2103,5827,7930
2021/04/27,14:00:00,156.43,2088,5920,8008
2021/04/27,14:30:00,156.43,2049,5882,7931
2021/04/27,15:00:00,156.35,1961,5832,7793
2021/04/27,15:30:00,156.28,1851,5922,7773
2021/04/27,16:00:00,156.43,1694,5989,7683
2021/04/27,16:30:00,156.35,1541,6041,7582
2021/04/27,17:00:00,156.72,1222,6286,7508
2021/04/27,17:30:00,156.2,947,6648,7595
2021/04/27,18:00:00,156.43,673,6998,7671
2021/04/27,18:30:00,187.5,422,7354,7776
2021/04/27,19:00:00,200.32,147,7578,7725
2021/04/27,19:30:00,200.32,148,7713,7861
2021/04/27,20:00:00,201.5,154,7916,8070
2021/04/27,20:30:00,202.13,160,7982,8142
2021/04/27,21:00:00,180.54,155,7885,8040
2021/04/27,21:30:00,180.3,154,7759,7913
2021/04/27,22:00:00,180.3,155,7555,7710
2021/04/27,22:30:00,180.3,129,7404,7533
2021/04/27,23:00:00,180.3,129,7150,7279
2021/04/27,23:30:00,180.3,128,6874,7002
2021/04/28,00:00:00,156.58,127,6618,6745
2021/04/28,00:30:00,156.43,127,6349,6476
2021/04/28,01:00:00,156.06,127,6143,6270
2021/04/28,01:30:00,156.06,81,6016,6097
2021/04/28,02:00:00,156.06,7,5961,5968
2021/04/28,02:30:00,156.06,5,5853,5858
2021/04/28,03:00:00,157.33,5,5759,5764
2021/04/28,03:30:00,156.07,4,5799,5803
2021/04/28,04:00:00,156.13,4,5802,5806
2021/04/28,04:30:00,156.43,3,5863,5866
2021/04/28,05:00:00,156.28,3,5897,5900
2021/04/28,05:30:00,156.06,4,6026,6030
2021/04/28,06:00:00,176.47,4,5963,5967
2021/04/28,06:30:00,161.44,6,6255,6261
2021/04/28,07:00:00,161.44,206,6435,6641
2021/04/28,07:30:00,163.07,473,6433,6906
2021/04/28,08:00:00,179.21,891,6198,7089
2021/04/28,08:30:00,163.35,1213,6001,7214
2021/04/28,09:00:00,178.54,1453,6018,7471
2021/04/28,09:30:00,178.54,1644,5893,7537
2021/04/28,10:00:00,178.54,1772,5806,7578
2021/04/28,10:30:00,178.54,1775,5843,7618
2021/04/28,11:00:00,178.54,1851,5845,7696
2021/04/28,11:30:00,179.21,1948,5851,7799
2021/04/28,12:00:00,178.54,2039,5805,7844
2021/04/28,12:30:00,179.21,2094,5839,7933
2021/04/28,13:00:00,178.54,2096,5913,8009
2021/04/28,13:30:00,178.54,2086,5873,7959
2021/04/28,14:00:00,179.21,2061,5949,8010
2021/04/28,14:30:00,178.54,2013,5962,7975
2021/04/28,15:00:00,178.54,1930,5887,7817
2021/04/28,15:30:00,157.07,1809,6033,7842
2021/04/28,16:00:00,179.21,1674,6153,7827
2021/04/28,16:30:00,178.54,1471,6359,7830
2021/04/28,17:00:00,176.47,1154,6587,7741
2021/04/28,17:30:00,178.54,929,6888,7817
2021/04/28,18:00:00,178.54,616,7191,7807
2021/04/28,18:30:00,178.54,384,7470,7854
2021/04/28,19:00:00,186.1,140,7701,7841
2021/04/28,19:30:00,227.62,153,7799,7952
2021/04/28,20:00:00,228.07,153,7968,8121
2021/04/28,20:30:00,228.07,155,8083,8238
2021/04/28,21:00:00,227.84,153,7989,8142
2021/04/28,21:30:00,211.4,152,7799,7951
2021/04/28,22:00:00,180.3,152,7626,7778
2021/04/28,22:30:00,237.44,125,7464,7589
2021/04/28,23:00:00,237.93,123,7236,7359
2021/04/28,23:30:00,214.41,122,6957,7079
2021/04/29,00:00:00,176.47,121,6720,6841
2021/04/29,00:30:00,176.47,121,6481,6602
2021/04/29,01:00:00,155.91,121,6255,6376
2021/04/29,01:30:00,157.33,86,6161,6247
2021/04/29,02:00:00,157.33,1,6224,6225
2021/04/29,02:30:00,155.91,0,6111,6111
2021/04/29,03:00:00,155.91,1,6170,6171
2021/04/29,03:30:00,155.91,0,6197,6197
2021/04/29,04:00:00,155.91,0,6188,6188
2021/04/29,04:30:00,155.91,0,6226,6226
2021/04/29,05:00:00,157.33,0,6271,6271
2021/04/29,05:30:00,155.91,0,6440,6440
2021/04/29,06:00:00,163.07,0,6308,6308
2021/04/29,06:30:00,163.07,1,6376,6377
2021/04/29,07:00:00,163.07,146,6537,6683
2021/04/29,07:30:00,161.51,315,6652,6967
2021/04/29,08:00:00,163.91,580,6403,6983
2021/04/29,08:30:00,164.51,1068,6173,7241
2021/04/29,09:00:00,164.51,1375,6134,7509
2021/04/29,09:30:00,164.53,1604,6088,7692
2021/04/29,10:00:00,164.47,1761,6052,7813
2021/04/29,10:30:00,159.05,1872,6051,7923
2021/04/29,11:00:00,160.32,1967,6072,8039
2021/04/29,11:30:00,157.92,2020,6105,8125
2021/04/29,12:00:00,159.73,2055,6188,8243
2021/04/29,12:30:00,159.57,2071,6253,8324
2021/04/29,13:00:00,159.84,2069,6373,8442
2021/04/29,13:30:00,160.1,2056,6467,8523
2021/04/29,14:00:00,159.86,2019,6563,8582
2021/04/29,14:30:00,159.65,1983,6494,8477
2021/04/29,15:00:00,159.47,1888,6598,8486
2021/04/29,15:30:00,158.12,1786,6699,8485
2021/04/29,16:00:00,179.21,1462,6983,8445
2021/04/29,16:30:00,179.21,1407,7071,8478
2021/04/29,17:00:00,179.21,1105,7281,8386
2021/04/29,17:30:00,178.54,872,7560,8432
2021/04/29,18:00:00,178.54,613,7765,8378
2021/04/29,18:30:00,179.87,395,7892,8287
2021/04/29,19:00:00,178.54,147,7975,8122
2021/04/29,19:30:00,195.91,152,7968,8120
2021/04/29,20:00:00,194.45,163,8024,8187
2021/04/29,20:30:00,194.23,162,8075,8237
2021/04/29,21:00:00,194.23,158,7918,8076
2021/04/29,21:30:00,194.01,157,7740,7897
2021/04/29,22:00:00,194.23,153,7518,7671
2021/04/29,22:30:00,193.79,122,7460,7582
2021/04/29,23:00:00,194.01,122,7282,7404
2021/04/29,23:30:00,194.01,117,7098,7215
2021/04/30,00:00:00,194.23,114,6915,7029
2021/04/30,00:30:00,203.16,120,6709,6829
2021/04/30,01:00:00,204.64,119,6540,6659
2021/04/30,01:30:00,152.83,72,6399,6471
2021/04/30,02:00:00,153.1,1,6309,6310
2021/04/30,02:30:00,152.83,0,6206,6206
2021/04/30,03:00:00,153.88,1,6151,6152
2021/04/30,03:30:00,153.95,1,6099,6100
2021/04/30,04:00:00,153.1,2,6070,6072
2021/04/30,04:30:00,153.24,2,6078,6080
2021/04/30,05:00:00,153.1,1,6034,6035
2021/04/30,05:30:00,153.52,1,6110,6111
2021/04/30,06:00:00,153.52,0,5970,5970
2021/04/30,06:30:00,153.88,3,6044,6047
2021/04/30,07:00:00,180.3,157,6166,6323
2021/04/30,07:30:00,155,307,6197,6504
2021/04/30,08:00:00,152.41,660,6060,6720
2021/04/30,08:30:00,195.23,987,5950,6937
2021/04/30,09:00:00,156.13,1400,5853,7253
2021/04/30,09:30:00,155.76,1581,5925,7506
2021/04/30,10:00:00,156.13,1723,5993,7716
2021/04/30,10:30:00,156.13,1835,6014,7849
2021/04/30,11:00:00,156.35,1916,6082,7998
2021/04/30,11:30:00,156.65,1990,6186,8176
2021/04/30,12:00:00,156.13,2003,6262,8265
2021/04/30,12:30:00,156.13,2033,6312,8345
2021/04/30,13:00:00,155.98,2031,6326,8357
2021/04/30,13:30:00,156.13,2013,6382,8395
2021/04/30,14:00:00,156.13,1989,6411,8400
2021/04/30,14:30:00,155.91,1938,6281,8219
2021/04/30,15:00:00,180.3,1888,6171,8059
2021/04/30,15:30:00,180.3,1753,6259,8012
2021/04/30,16:00:00,180.3,1616,6390,8006
2021/04/30,16:30:00,180.3,1388,6610,7998
2021/04/30,17:00:00,180.3,1112,6857,7969
2021/04/30,17:30:00,195.14,861,7209,8070
2021/04/30,18:00:00,222.7,602,7494,8096
2021/04/30,18:30:00,222.7,399,7784,8183
2021/04/30,19:00:00,203.61,85,7812,7897
2021/04/30,19:30:00,202.43,102,7672,7774
2021/04/30,20:00:00,202.43,102,7715,7817
2021/04/30,20:30:00,202.43,130,7609,7739
2021/04/30,21:00:00,202.43,131,7374,7505
2021/04/30,21:30:00,202.43,131,7265,7396
2021/04/30,22:00:00,202.43,127,7100,7227
2021/04/30,22:30:00,200.32,126,6990,7116
2021/04/30,23:00:00,200.32,126,6916,7042
2021/04/30,23:30:00,199.78,126,6760,6886
2021/05/01,00:00:00,198.97,126,6634,6760
2021/05/01,00:30:00,183.99,126,6450,6576
2021/05/01,01:00:00,184.16,124,6394,6518
2021/05/01,01:30:00,184.24,100,6280,6380
2021/05/01,02:00:00,184.42,2,6260,6262
2021/05/01,02:30:00,184.24,2,6130,6132
2021/05/01,03:00:00,184.16,2,6094,6096
2021/05/01,03:30:00,184.24,3,6032,6035
2021/05/01,04:00:00,184.33,2,6030,6032
2021/05/01,04:30:00,183.9,3,6018,6021
2021/05/01,05:00:00,184.33,4,5986,5990
2021/05/01,05:30:00,184.42,4,5982,5986
2021/05/01,06:00:00,183.81,3,5821,5824
2021/05/01,06:30:00,183.64,9,5693,5702
2021/05/01,07:00:00,183.99,197,5762,5959
2021/05/01,07:30:00,184.16,542,5531,6073
2021/05/01,08:00:00,184.24,927,5336,6263
2021/05/01,08:30:00,183.73,1260,5198,6458
2021/05/01,09:00:00,183.99,1459,5140,6599
2021/05/01,09:30:00,184.42,1644,5123,6767
2021/05/01,10:00:00,183.99,1794,5142,6936
2021/05/01,10:30:00,183.99,1880,5136,7016
2021/05/01,11:00:00,183.9,1990,5157,7147
2021/05/01,11:30:00,183.9,2060,5186,7246
2021/05/01,12:00:00,183.9,2087,5242,7329
2021/05/01,12:30:00,184.16,2091,5328,7419
2021/05/01,13:00:00,183.81,2095,5365,7460
2021/05/01,13:30:00,183.9,2081,5440,7521
2021/05/01,14:00:00,183.9,2032,5471,7503
2021/05/01,14:30:00,183.9,2001,5526,7527
2021/05/01,15:00:00,183.81,1908,5606,7514
2021/05/01,15:30:00,183.73,1827,5636,7463
2021/05/01,16:00:00,183.9,1667,5793,7460
2021/05/01,16:30:00,184.42,1511,5891,7402
2021/05/01,17:00:00,184.24,1146,6280,7426
2021/05/01,17:30:00,184.33,870,6621,7491
2021/05/01,18:00:00,184.16,588,6859,7447
2021/05/01,18:30:00,186.98,289,7144,7433
2021/05/01,19:00:00,186.42,120,7270,7390
2021/05/01,19:30:00,186.87,130,7351,7481
2021/05/01,20:00:00,186.43,131,7574,7705
2021/05/01,20:30:00,186.34,131,7630,7761
2021/05/01,21:00:00,186.45,128,7673,7801
2021/05/01,21:30:00,185.82,126,7655,7781
2021/05/01,22:00:00,185.82,126,7531,7657
2021/05/01,22:30:00,185.82,128,7411,7539
2021/05/01,23:00:00,185.82,125,7248,7373
2021/05/01,23:30:00,185.82,125,7030,7155
2021/05/02,00:00:00,197.86,124,6785,6909
2021/05/02,00:30:00,184.16,125,6642,6767
2021/05/02,01:00:00,183.99,125,6452,6577
2021/05/02,01:30:00,183.9,123,6274,6397
2021/05/02,02:00:00,182.21,100,6165,6265
2021/05/02,02:30:00,180.4,69,6087,6156
2021/05/02,03:00:00,179.68,2,6012,6014
2021/05/02,03:30:00,179.36,2,5997,5999
2021/05/02,04:00:00,180.08,1,5979,5980
2021/05/02,04:30:00,179.44,1,5993,5994
2021/05/02,05:00:00,178.74,2,6077,6079
2021/05/02,05:30:00,179.21,2,6250,6252
2021/05/02,06:00:00,180.16,1,6095,6096
2021/05/02,06:30:00,179.13,11,6267,6278
2021/05/02,07:00:00,180.24,230,6423,6653
2021/05/02,07:30:00,180.3,428,6588,7016
2021/05/02,08:00:00,180.3,857,6370,7227
2021/05/02,08:30:00,178.13,1156,6416,7572
2021/05/02,09:00:00,176.47,1449,6424,7873
2021/05/02,09:30:00,175.15,1603,6328,7931
2021/05/02,10:00:00,179.68,1757,6486,8243
2021/05/02,10:30:00,180.16,1859,6510,8369
2021/05/02,11:00:00,180.16,1941,6563,8504
2021/05/02,11:30:00,180.24,2012,6589,8601
2021/05/02,12:00:00,179.68,2052,6629,8681
2021/05/02,12:30:00,180.8,2066,6825,8891
2021/05/02,13:00:00,180.88,2067,6941,9008
2021/05/02,13:30:00,179.68,2053,7067,9120
2021/05/02,14:00:00,187.09,2034,7127,9161
2021/05/02,14:30:00,180.64,1980,7232,9212
2021/05/02,15:00:00,190.66,1905,7339,9244
2021/05/02,15:30:00,190.8,1763,7296,9059
2021/05/02,16:00:00,189.9,1639,7219,8858
2021/05/02,16:30:00,190.04,1427,7407,8834
2021/05/02,17:00:00,202.46,1180,7579,8759
2021/05/02,17:30:00,202.55,906,7805,8711
2021/05/02,18:00:00,202.63,625,7986,8611
2021/05/02,18:30:00,202.98,397,8163,8560
2021/05/02,19:00:00,200.99,116,8269,8385
2021/05/02,19:30:00,201.52,122,8307,8429
2021/05/02,20:00:00,201.52,134,8381,8515
2021/05/02,20:30:00,201.52,134,8450,8584
2021/05/02,21:00:00,201.52,130,8308,8438
2021/05/02,21:30:00,202.07,127,8196,8323
2021/05/02,22:00:00,200.99,126,7959,8085
2021/05/02,22:30:00,202.65,128,7745,7873
2021/05/02,23:00:00,200.99,125,7516,7641
2021/05/02,23:30:00,203.26,127,7276,7403
2021/05/03,00:00:00,180.56,129,7042,7171
2021/05/03,00:30:00,180.4,126,6847,6973
2021/05/03,01:00:00,180.24,126,6633,6759
2021/05/03,01:30:00,180.72,126,6453,6579
2021/05/03,02:00:00,180.4,92,6389,6481
2021/05/03,02:30:00,181.13,55,6339,6394
2021/05/03,03:00:00,180.64,2,6283,6285
2021/05/03,03:30:00,181.29,2,6239,6241
2021/05/03,04:00:00,180.8,2,6252,6254
2021/05/03,04:30:00,180.72,1,6264,6265
2021/05/03,05:00:00,180.97,3,6323,6326
2021/05/03,05:30:00,180.64,3,6411,6414
2021/05/03,06:00:00,179.92,3,6354,6357
2021/05/03,06:30:00,180.56,11,6621,6632
2021/05/03,07:00:00,180.88,176,6925,7101
2021/05/03,07:30:00,180.56,420,7020,7440
2021/05/03,08:00:00,180.56,679,6908,7587
2021/05/03,08:30:00,180.97,1053,6915,7968
2021/05/03,09:00:00,180.24,1317,6828,8145
2021/05/03,09:30:00,220.2,1518,6870,8388
2021/05/03,10:00:00,220.2,1675,6856,8531
2021/05/03,10:30:00,176.88,1788,6926,8714
2021/05/03,11:00:00,177.02,1876,6932,8808
2021/05/03,11:30:00,176.81,1935,7017,8952
2021/05/03,12:00:00,176.81,1986,7062,9048
2021/05/03,12:30:00,180.16,2003,7129,9132
2021/05/03,13:00:00,180.08,2004,7214,9218
2021/05/03,13:30:00,179.76,1993,7250,9243
2021/05/03,14:00:00,180.48,1959,7354,9313
2021/05/03,14:30:00,180.24,1915,7433,9348
2021/05/03,15:00:00,191.54,1805,7572,9377
2021/05/03,15:30:00,179.13,1728,7461,9189
2021/05/03,16:00:00,191.09,1553,7487,9040
2021/05/03,16:30:00,190.82,1392,7646,9038
2021/05/03,17:00:00,190.51,1136,7819,8955
2021/05/03,17:30:00,189.48,872,8027,8899
2021/05/03,18:00:00,189.8,575,8175,8750
2021/05/03,18:30:00,189.07,359,8300,8659
2021/05/03,19:00:00,189.1,130,8329,8459
2021/05/03,19:30:00,188.77,131,8357,8488
2021/05/03,20:00:00,197.83,137,8476,8613
2021/05/03,20:30:00,197.83,137,8514,8651
2021/05/03,21:00:00,199.57,135,8424,8559
2021/05/03,21:30:00,197.83,131,8291,8422
2021/05/03,22:00:00,197.83,132,8095,8227
2021/05/03,22:30:00,220.2,128,7875,8003
2021/05/03,23:00:00,185.82,123,7703,7826
2021/05/03,23:30:00,195.54,122,7476,7598
2021/05/04,00:00:00,180.4,98,7245,7343
2021/05/04,00:30:00,180.32,2,7068,7070
2021/05/04,01:00:00,180.16,3,6912,6915
2021/05/04,01:30:00,180.64,3,6722,6725
2021/05/04,02:00:00,180.32,2,6608,6610
2021/05/04,02:30:00,181.21,3,6394,6397
2021/05/04,03:00:00,180.88,2,6341,6343
2021/05/04,03:30:00,180.97,3,6351,6354
2021/05/04,04:00:00,180.97,3,6289,6292
2021/05/04,04:30:00,180.32,3,6341,6344
2021/05/04,05:00:00,180.88,3,6332,6335
2021/05/04,05:30:00,180.56,2,6485,6487
2021/05/04,06:00:00,181.62,1,6495,6496
2021/05/04,06:30:00,180.24,5,6681,6686
2021/05/04,07:00:00,180.24,202,6934,7136
2021/05/04,07:30:00,180.16,389,7090,7479
2021/05/04,08:00:00,181.05,687,7022,7709
2021/05/04,08:30:00,179.76,1037,6922,7959
2021/05/04,09:00:00,183.64,1323,6929,8252
2021/05/04,09:30:00,183.81,1535,6939,8474
2021/05/04,10:00:00,184.07,1694,6951,8645
2021/05/04,10:30:00,183.99,1806,6990,8796
2021/05/04,11:00:00,184.16,1882,7039,8921
2021/05/04,11:30:00,192.44,1945,7128,9073
2021/05/04,12:00:00,203.01,1973,7200,9173
2021/05/04,12:30:00,203.44,1999,7210,9209
2021/05/04,13:00:00,186.1,1988,7252,9240
2021/05/04,13:30:00,186.1,2007,7442,9449
2021/05/04,14:00:00,202.27,1968,7663,9631
2021/05/04,14:30:00,202.4,1888,7814,9702
2021/05/04,15:00:00,201.04,1813,7895,9708
2021/05/04,15:30:00,201.67,1691,8022,9713
2021/05/04,16:00:00,236.18,1560,8029,9589
2021/05/04,16:30:00,236.7,1384,8174,9558
2021/05/04,17:00:00,236.7,1082,8344,9426
2021/05/04,17:30:00,237.04,850,8588,9438
2021/05/04,18:00:00,237.04,557,8730,9287
2021/05/04,18:30:00,237.55,334,8874,9208
2021/05/04,19:00:00,237.89,106,8853,8959
2021/05/04,19:30:00,229.51,113,8842,8955
2021/05/04,20:00:00,220.2,126,8870,8996
2021/05/04,20:30:00,229.29,126,8882,9008
2021/05/04,21:00:00,220.2,126,8854,8980
2021/05/04,21:30:00,220.2,126,8661,8787
2021/05/04,22:00:00,220.2,125,8402,8527
2021/05/04,22:30:00,202.65,125,8268,8393
2021/05/04,23:00:00,213.6,124,8014,8138
2021/05/04,23:30:00,202.65,123,7803,7926
2021/05/05,00:00:00,180.72,92,7562,7654
2021/05/05,00:30:00,180.24,50,7396,7446
2021/05/05,01:00:00,179.76,2,7235,7237
2021/05/05,01:30:00,180.56,2,7058,7060
2021/05/05,02:00:00,180.64,3,6906,6909
2021/05/05,02:30:00,180.48,2,6719,6721
2021/05/05,03:00:00,181.13,1,6637,6638
2021/05/05,03:30:00,180.08,1,6620,6621
2021/05/05,04:00:00,180.8,2,6578,6580
2021/05/05,04:30:00,180.56,2,6601,6603
2021/05/05,05:00:00,180.24,1,6602,6603
2021/05/05,05:30:00,180.56,1,6742,6743
2021/05/05,06:00:00,180.72,1,6721,6722
2021/05/05,06:30:00,180.64,81,7013,7094
2021/05/05,07:00:00,180.88,207,7143,7350
2021/05/05,07:30:00,181.38,415,7263,7678
2021/05/05,08:00:00,180.48,737,7279,8016
2021/05/05,08:30:00,181.05,1033,7259,8292
2021/05/05,09:00:00,180.72,1363,7218,8581
2021/05/05,09:30:00,220.2,1505,7320,8825
2021/05/05,10:00:00,220.2,1683,7376,9059
2021/05/05,10:30:00,220.2,1789,7378,9167
2021/05/05,11:00:00,180.88,1888,7416,9304
2021/05/05,11:30:00,180.24,1965,7436,9401
2021/05/05,12:00:00,180.32,2017,7477,9494
2021/05/05,12:30:00,172.22,1857,7616,9473
2021/05/05,13:00:00,169.09,1884,7710,9594
2021/05/05,13:30:00,168.97,1762,7757,9519
2021/05/05,14:00:00,168.97,1743,7907,9650
2021/05/05,14:30:00,202.07,1722,8010,9732
2021/05/05,15:00:00,202.07,1660,8078,9738
2021/05/05,15:30:00,202.65,1557,8212,9769
2021/05/05,16:00:00,203.89,1522,8132,9654
2021/05/05,16:30:00,201.52,1336,8297,9633
2021/05/05,17:00:00,198.72,1062,8421,9483
2021/05/05,17:30:00,193.85,866,8585,9451
2021/05/05,18:00:00,235.28,600,8731,9331
2021/05/05,18:30:00,237.89,376,8811,9187
2021/05/05,19:00:00,226.78,133,8828,8961
2021/05/05,19:30:00,224.83,130,8775,8905
2021/05/05,20:00:00,224.83,129,8817,8946
2021/05/05,20:30:00,224.83,123,8870,8993
2021/05/05,21:00:00,201.52,122,8762,8884
2021/05/05,21:30:00,201.52,122,8610,8732
2021/05/05,22:00:00,203.26,123,8424,8547
2021/05/05,22:30:00,202.07,126,8192,8318
2021/05/05,23:00:00,200.29,124,8000,8124
2021/05/05,23:30:00,197.83,126,7652,7778
2021/05/06,00:00:00,198.39,109,7469,7578
2021/05/06,00:30:00,197.31,6,7333,7339
2021/05/06,01:00:00,197.83,3,7127,7130
2021/05/06,01:30:00,184.42,2,6933,6935
2021/05/06,02:00:00,184.24,4,6769,6773
2021/05/06,02:30:00,184.24,5,6634,6639
2021/05/06,03:00:00,184.5,7,6550,6557
2021/05/06,03:30:00,184.33,8,6503,6511
2021/05/06,04:00:00,184.24,5,6478,6483
2021/05/06,04:30:00,184.33,5,6462,6467
2021/05/06,05:00:00,184.24,4,6534,6538
2021/05/06,05:30:00,184.24,3,6612,6615
2021/05/06,06:00:00,184.24,3,6662,6665
2021/05/06,06:30:00,184.24,83,6876,6959
2021/05/06,07:00:00,184.5,200,7023,7223
2021/05/06,07:30:00,184.24,517,7115,7632
2021/05/06,08:00:00,184.24,877,7054,7931
2021/05/06,08:30:00,184.33,1181,7078,8259
2021/05/06,09:00:00,184.42,1426,7075,8501
2021/05/06,09:30:00,184.16,1586,7134,8720
2021/05/06,10:00:00,184.5,1743,7138,8881
2021/05/06,10:30:00,184.16,1848,7193,9041
2021/05/06,11:00:00,184.42,1951,7155,9106
2021/05/06,11:30:00,184.33,2002,7167,9169
2021/05/06,12:00:00,184.16,2035,7248,9283
2021/05/06,12:30:00,184.07,2047,7309,9356
2021/05/06,13:00:00,183.64,2047,7434,9481
2021/05/06,13:30:00,183.99,2026,7553,9579
2021/05/06,14:00:00,184.16,1981,7636,9617
2021/05/06,14:30:00,183.81,1939,7600,9539
2021/05/06,15:00:00,184.16,1836,7693,9529
2021/05/06,15:30:00,184.07,1721,7803,9524
2021/05/06,16:00:00,184.07,1576,7874,9450
2021/05/06,16:30:00,183.64,1355,7884,9239
2021/05/06,17:00:00,183.99,1094,7993,9087
2021/05/06,17:30:00,186.1,816,8194,9010
2021/05/06,18:00:00,186.24,576,8301,8877
2021/05/06,18:30:00,190.54,325,8440,8765
2021/05/06,19:00:00,193.58,116,8433,8549
2021/05/06,19:30:00,192.44,132,8421,8553
2021/05/06,20:00:00,201.52,131,8486,8617
2021/05/06,20:30:00,220.2,125,8586,8711
2021/05/06,21:00:00,202.07,119,8497,8616
2021/05/06,21:30:00,201.52,121,8293,8414
2021/05/06,22:00:00,201.52,124,8095,8219
2021/05/06,22:30:00,184.24,123,7897,8020
2021/05/06,23:00:00,184.07,123,7685,7808
2021/05/06,23:30:00,184.24,122,7496,7618
2021/05/07,00:00:00,220.2,120,7258,7378
2021/05/07,00:30:00,183.9,121,7047,7168
2021/05/07,01:00:00,184.42,118,6873,6991
2021/05/07,01:30:00,184.16,12,6807,6819
2021/05/07,02:00:00,184.42,1,6674,6675
2021/05/07,02:30:00,184.5,1,6568,6569
2021/05/07,03:00:00,184.33,0,6468,6468
2021/05/07,03:30:00,184.16,1,6401,6402
2021/05/07,04:00:00,184.16,1,6343,6344
2021/05/07,04:30:00,184.24,1,6324,6325
2021/05/07,05:00:00,184.16,1,6339,6340
2021/05/07,05:30:00,184.16,0,6346,6346
2021/05/07,06:00:00,184.42,4,6244,6248
2021/05/07,06:30:00,184.42,10,6375,6385
2021/05/07,07:00:00,184.24,153,6559,6712
2021/05/07,07:30:00,184.16,297,6702,6999
2021/05/07,08:00:00,183.9,416,6722,7138
2021/05/07,08:30:00,184.16,615,6764,7379
2021/05/07,09:00:00,183.99,844,6766,7610
2021/05/07,09:30:00,183.81,1075,6742,7817
2021/05/07,10:00:00,184.24,1262,6638,7900
2021/05/07,10:30:00,183.47,1451,6607,8058
2021/05/07,11:00:00,184.42,1542,6628,8170
2021/05/07,11:30:00,184.24,1548,6732,8280
2021/05/07,12:00:00,184.33,1702,6637,8339
2021/05/07,12:30:00,184.16,1695,6663,8358
2021/05/07,13:00:00,183.9,1788,6673,8461
2021/05/07,13:30:00,184.24,1919,6603,8522
2021/05/07,14:00:00,183.9,1955,6599,8554
2021/05/07,14:30:00,184.16,1935,6576,8511
2021/05/07,15:00:00,183.9,1902,6644,8546
2021/05/07,15:30:00,184.16,1814,6738,8552
2021/05/07,16:00:00,184.33,1648,6911,8559
2021/05/07,16:30:00,184.42,1470,7087,8557
2021/05/07,17:00:00,183.81,1223,7397,8620
2021/05/07,17:30:00,184.59,929,7442,8371
2021/05/07,18:00:00,220.2,683,7785,8468
2021/05/07,18:30:00,220.2,414,8096,8510
2021/05/07,19:00:00,228.97,111,8184,8295
2021/05/07,19:30:00,186.03,106,8062,8168
2021/05/07,20:00:00,229.17,132,8009,8141
2021/05/07,20:30:00,229.73,134,7925,8059
2021/05/07,21:00:00,229.92,129,7787,7916
2021/05/07,21:30:00,229.92,131,7614,7745
2021/05/07,22:00:00,195.23,126,7458,7584
2021/05/07,22:30:00,184.07,126,7340,7466
2021/05/07,23:00:00,184.24,74,7258,7332
2021/05/07,23:30:00,184.24,4,7185,7189
2021/05/08,00:00:00,184.16,3,7000,7003
2021/05/08,00:30:00,184.24,2,6839,6841
2021/05/08,01:00:00,184.24,2,6702,6704
2021/05/08,01:30:00,184.07,2,6562,6564
2021/05/08,02:00:00,183.9,2,6440,6442
2021/05/08,02:30:00,183.9,2,6339,6341
2021/05/08,03:00:00,183.73,2,6405,6407
2021/05/08,03:30:00,183.81,3,6361,6364
2021/05/08,04:00:00,184.42,2,6151,6153
2021/05/08,04:30:00,184.16,1,6152,6153
2021/05/08,05:00:00,184.16,1,6105,6106
2021/05/08,05:30:00,183.99,1,6085,6086
2021/05/08,06:00:00,184.16,1,5900,5901
2021/05/08,06:30:00,184.16,153,5877,6030
2021/05/08,07:00:00,184.07,225,5725,5950
2021/05/08,07:30:00,184.76,451,5781,6232
2021/05/08,08:00:00,184.07,774,5716,6490
2021/05/08,08:30:00,184.16,1091,5566,6657
2021/05/08,09:00:00,184.16,1374,5487,6861
2021/05/08,09:30:00,184.33,1588,5449,7037
2021/05/08,10:00:00,184.42,1734,5510,7244
2021/05/08,10:30:00,184.24,1864,5534,7398
2021/05/08,11:00:00,184.42,1934,5594,7528
2021/05/08,11:30:00,184.59,2012,5661,7673
2021/05/08,12:00:00,184.5,2032,5546,7578
2021/05/08,12:30:00,184.24,2047,5683,7730
2021/05/08,13:00:00,184.16,2053,5699,7752
2021/05/08,13:30:00,184.33,2039,5817,7856
2021/05/08,14:00:00,184.5,2000,5870,7870
2021/05/08,14:30:00,184.16,1943,5956,7899
2021/05/08,15:00:00,184.16,1856,6135,7991
2021/05/08,15:30:00,183.99,1763,6252,8015
2021/05/08,16:00:00,183.81,1593,6425,8018
2021/05/08,16:30:00,184.16,1436,6708,8144
2021/05/08,17:00:00,184.33,1124,7025,8149
2021/05/08,17:30:00,183.9,909,7343,8252
2021/05/08,18:00:00,184.07,587,7645,8232
2021/05/08,18:30:00,184.07,397,7841,8238
2021/05/08,19:00:00,186.67,107,8016,8123
2021/05/08,19:30:00,186.67,114,8044,8158
2021/05/08,20:00:00,186.45,122,8158,8280
2021/05/08,20:30:00,198.07,123,8311,8434
2021/05/08,21:00:00,200.92,123,8332,8455
2021/05/08,21:30:00,200.24,121,8278,8399
2021/05/08,22:00:00,200.48,120,8184,8304
2021/05/08,22:30:00,184.24,120,8022,8142
2021/05/08,23:00:00,184.16,120,7835,7955
2021/05/08,23:30:00,184.16,121,7573,7694
2021/05/09,00:00:00,184.16,120,7329,7449
2021/05/09,00:30:00,184.16,121,7114,7235
2021/05/09,01:00:00,184.07,120,7047,7167
2021/05/09,01:30:00,183.9,120,7029,7149
2021/05/09,02:00:00,184.24,61,6935,6996
2021/05/09,02:30:00,184.42,0,6857,6857
2021/05/09,03:00:00,184.07,1,6761,6762
2021/05/09,03:30:00,183.99,1,6714,6715
2021/05/09,04:00:00,183.9,1,6646,6647
2021/05/09,04:30:00,183.9,0,6676,6676
2021/05/09,05:00:00,183.99,1,6693,6694
2021/05/09,05:30:00,184.07,1,6839,6840
2021/05/09,06:00:00,183.99,2,6714,6716
2021/05/09,06:30:00,183.99,102,6885,6987
2021/05/09,07:00:00,183.64,239,6925,7164
2021/05/09,07:30:00,183.64,415,7087,7502
2021/05/09,08:00:00,183.99,703,7173,7876
2021/05/09,08:30:00,183.99,847,7358,8205
2021/05/09,09:00:00,184.42,1262,7506,8768
2021/05/09,09:30:00,183.81,1434,7713,9147
2021/05/09,10:00:00,184.16,1568,7888,9456
2021/05/09,10:30:00,212,1682,8111,9793
2021/05/09,11:00:00,212.66,1774,8294,10068
2021/05/09,11:30:00,212.69,1879,8428,10307
2021/05/09,12:00:00,212.09,1903,8553,10456
2021/05/09,12:30:00,213.38,1843,8682,10525
2021/05/09,13:00:00,231.61,1734,8913,10647
2021/05/09,13:30:00,213.4,1757,9061,10818
2021/05/09,14:00:00,213.38,1688,9339,11027
2021/05/09,14:30:00,207.53,1534,9314,10848
2021/05/09,15:00:00,206.81,1416,9501,10917
2021/05/09,15:30:00,206.98,1335,9570,10905
2021/05/09,16:00:00,220.73,1131,9636,10767
2021/05/09,16:30:00,220.7,989,9839,10828
2021/05/09,17:00:00,220.7,837,9941,10778
2021/05/09,17:30:00,220.7,567,10013,10580
2021/05/09,18:00:00,220.7,427,10086,10513
2021/05/09,18:30:00,220.7,286,10029,10315
2021/05/09,19:00:00,220.7,125,9960,10085
2021/05/09,19:30:00,220.7,100,9854,9954
2021/05/09,20:00:00,222.04,69,9799,9868
2021/05/09,20:30:00,220.7,14,9850,9864
2021/05/09,21:00:00,220.7,15,9682,9697
2021/05/09,21:30:00,205.6,12,9517,9529
2021/05/09,22:00:00,203.93,10,9239,9249
2021/05/09,22:30:00,203.88,2,9010,9012
2021/05/09,23:00:00,203.88,3,8716,8719
2021/05/09,23:30:00,197.91,5,8441,8446
2021/05/10,00:00:00,231.61,9,8167,8176
2021/05/10,00:30:00,200.42,12,7911,7923
2021/05/10,01:00:00,200.29,12,7742,7754
2021/05/10,01:30:00,204.97,10,7819,7829
2021/05/10,02:00:00,204.92,14,7686,7700
2021/05/10,02:30:00,204.86,8,7557,7565
2021/05/10,03:00:00,184.16,7,7443,7450
2021/05/10,03:30:00,206.42,8,7412,7420
2021/05/10,04:00:00,207.1,6,7387,7393
2021/05/10,04:30:00,207.05,2,7351,7353
2021/05/10,05:00:00,206.75,4,7374,7378
2021/05/10,05:30:00,206.95,4,7455,7459
2021/05/10,06:00:00,207.02,4,7326,7330
2021/05/10,06:30:00,207.35,5,7551,7556
2021/05/10,07:00:00,207.31,150,7681,7831
2021/05/10,07:30:00,207.06,333,7772,8105
2021/05/10,08:00:00,204.8,542,7733,8275
2021/05/10,08:30:00,184.07,768,7867,8635
2021/05/10,09:00:00,184.76,1073,8030,9103
2021/05/10,09:30:00,177.98,1293,8006,9299
2021/05/10,10:00:00,173.59,1555,7918,9473
2021/05/10,10:30:00,173.65,1699,7974,9673
2021/05/10,11:00:00,173.71,1804,8030,9834
2021/05/10,11:30:00,173.77,1889,7974,9863
2021/05/10,12:00:00,173.77,1942,8042,9984
2021/05/10,12:30:00,174.32,1953,7929,9882
2021/05/10,13:00:00,173.13,1923,8024,9947
2021/05/10,13:30:00,173.65,1970,8146,10116
2021/05/10,14:00:00,173.36,1860,8327,10187
2021/05/10,14:30:00,173.24,1789,8417,10206
2021/05/10,15:00:00,192.22,1716,8543,10259
2021/05/10,15:30:00,201.52,1553,8655,10208
2021/05/10,16:00:00,229.65,1421,8653,10074
2021/05/10,16:30:00,204.68,1215,8893,10108
2021/05/10,17:00:00,237.5,981,9026,10007
2021/05/10,17:30:00,221.26,774,9153,9927
2021/05/10,18:00:00,237.5,556,9195,9751
2021/05/10,18:30:00,237.5,309,9292,9601
2021/05/10,19:00:00,220.39,116,9216,9332
2021/05/10,19:30:00,237.33,43,9285,9328
2021/05/10,20:00:00,231.61,4,9388,9392
2021/05/10,20:30:00,231.61,3,9346,9349
2021/05/10,21:00:00,231.61,3,9220,9223
2021/05/10,21:30:00,231.61,3,9024,9027
2021/05/10,22:00:00,231.61,2,8783,8785
2021/05/10,22:30:00,202.65,2,8613,8615
2021/05/10,23:00:00,202.65,2,8310,8312
2021/05/10,23:30:00,203.89,3,8079,8082
2021/05/11,00:00:00,202.12,3,7837,7840
2021/05/11,00:30:00,200.29,4,7582,7586
2021/05/11,01:00:00,200.87,5,7397,7402
2021/05/11,01:30:00,180.88,6,7350,7356
2021/05/11,02:00:00,180.32,6,7183,7189
2021/05/11,02:30:00,180.32,4,7089,7093
2021/05/11,03:00:00,180.4,4,6998,7002
2021/05/11,03:30:00,180.48,5,6959,6964
2021/05/11,04:00:00,180.24,3,6879,6882
2021/05/11,04:30:00,180.4,2,6855,6857
2021/05/11,05:00:00,180.24,1,6893,6894
2021/05/11,05:30:00,180.72,1,6952,6953
2021/05/11,06:00:00,180.72,1,6853,6854
2021/05/11,06:30:00,180.4,8,6990,6998
2021/05/11,07:00:00,180.48,149,7141,7290
2021/05/11,07:30:00,179.76,319,7407,7726
2021/05/11,08:00:00,179.76,504,7376,7880
2021/05/11,08:30:00,180.08,822,7392,8214
2021/05/11,09:00:00,181.38,1151,7359,8510
2021/05/11,09:30:00,182.71,1503,7358,8861
2021/05/11,10:00:00,183.3,1673,7298,8971
2021/05/11,10:30:00,182.88,1801,7330,9131
2021/05/11,11:00:00,183.39,1890,7400,9290
2021/05/11,11:30:00,182.88,1953,7425,9378
2021/05/11,12:00:00,183.39,2014,7490,9504
2021/05/11,12:30:00,183.39,2029,7561,9590
2021/05/11,13:00:00,182.79,2034,7683,9717
2021/05/11,13:30:00,182.63,2015,7759,9774
2021/05/11,14:00:00,183.47,1989,7762,9751
2021/05/11,14:30:00,182.71,1940,7890,9830
2021/05/11,15:00:00,183.13,1839,7824,9663
2021/05/11,15:30:00,183.47,1744,7856,9600
2021/05/11,16:00:00,183.47,1555,7970,9525
2021/05/11,16:30:00,183.64,1394,8058,9452
2021/05/11,17:00:00,183.39,1134,8216,9350
2021/05/11,17:30:00,183.56,863,8358,9221
2021/05/11,18:00:00,183.39,609,8417,9026
2021/05/11,18:30:00,182.09,388,8582,8970
2021/05/11,19:00:00,181.43,116,8603,8719
2021/05/11,19:30:00,181.43,125,8608,8733
2021/05/11,20:00:00,181.43,129,8603,8732
2021/05/11,20:30:00,182.09,128,8615,8743
2021/05/11,21:00:00,174.96,126,8330,8456
2021/05/11,21:30:00,182.09,129,8223,8352
2021/05/11,22:00:00,179.41,128,8097,8225
2021/05/11,22:30:00,179.41,128,7948,8076
2021/05/11,23:00:00,179.41,125,7748,7873
2021/05/11,23:30:00,171.97,123,7530,7653
2021/05/12,00:00:00,175.02,93,7328,7421
2021/05/12,00:30:00,175.35,5,7167,7172
2021/05/12,01:00:00,175.35,3,6960,6963
2021/05/12,01:30:00,175.22,5,6789,6794
2021/05/12,02:00:00,174.96,4,6643,6647
2021/05/12,02:30:00,175.22,4,6511,6515
2021/05/12,03:00:00,175.22,4,6468,6472
2021/05/12,03:30:00,175.42,3,6476,6479
2021/05/12,04:00:00,175.29,3,6382,6385
2021/05/12,04:30:00,175.35,3,6359,6362
2021/05/12,05:00:00,175.22,3,6347,6350
2021/05/12,05:30:00,175.15,3,6372,6375
2021/05/12,06:00:00,174.89,2,6371,6373
2021/05/12,06:30:00,177.24,133,6499,6632
2021/05/12,07:00:00,179.36,222,6610,6832
2021/05/12,07:30:00,180.08,428,6717,7145
2021/05/12,08:00:00,180.24,786,6552,7338
2021/05/12,08:30:00,179.6,1086,6528,7614
2021/05/12,09:00:00,177.98,1331,6484,7815
2021/05/12,09:30:00,174.38,1566,6520,8086
2021/05/12,10:00:00,174.32,1718,6488,8206
2021/05/12,10:30:00,176.31,1851,6568,8419
2021/05/12,11:00:00,176.31,1910,6624,8534
2021/05/12,11:30:00,176.38,1973,6695,8668
2021/05/12,12:00:00,176.81,2026,6561,8587
2021/05/12,12:30:00,176.31,2046,6689,8735
2021/05/12,13:00:00,173.53,2048,6820,8868
2021/05/12,13:30:00,172.17,2030,6778,8808
2021/05/12,14:00:00,170.39,1999,6820,8819
2021/05/12,14:30:00,170.69,1947,6951,8898
2021/05/12,15:00:00,170.69,1856,7015,8871
2021/05/12,15:30:00,170.69,1744,7136,8880
2021/05/12,16:00:00,178.54,1610,7185,8795
2021/05/12,16:30:00,176.47,1441,7344,8785
2021/05/12,17:00:00,176.47,1147,7520,8667
2021/05/12,17:30:00,178.54,941,7708,8649
2021/05/12,18:00:00,216.3,642,7851,8493
2021/05/12,18:30:00,227.84,438,8079,8517
2021/05/12,19:00:00,227.84,134,8181,8315
2021/05/12,19:30:00,228.07,116,8183,8299
2021/05/12,20:00:00,227.84,110,8275,8385
2021/05/12,20:30:00,228.07,129,8258,8387
2021/05/12,21:00:00,227.39,132,8127,8259
2021/05/12,21:30:00,178.54,126,7978,8104
2021/05/12,22:00:00,178.54,128,7791,7919
2021/05/12,22:30:00,176.47,130,7641,7771
2021/05/12,23:00:00,179.87,125,7431,7556
2021/05/12,23:30:00,170.69,122,7216,7338
2021/05/13,00:00:00,170.81,126,7015,7141
2021/05/13,00:30:00,170.97,125,6801,6926
2021/05/13,01:00:00,171.22,124,6644,6768
2021/05/13,01:30:00,170.73,123,6520,6643
2021/05/13,02:00:00,171.18,100,6423,6523
2021/05/13,02:30:00,170.97,4,6415,6419
2021/05/13,03:00:00,171.05,4,6305,6309
2021/05/13,03:30:00,170.93,1,6242,6243
2021/05/13,04:00:00,176.66,2,6218,6220
2021/05/13,04:30:00,176.88,3,6262,6265
2021/05/13,05:00:00,176.81,3,6296,6299
2021/05/13,05:30:00,176.52,3,6343,6346
2021/05/13,06:00:00,176.59,3,6240,6243
2021/05/13,06:30:00,178.28,97,6418,6515
2021/05/13,07:00:00,183.56,217,6511,6728
2021/05/13,07:30:00,184.16,462,6521,6983
2021/05/13,08:00:00,184.16,912,6358,7270
2021/05/13,08:30:00,184.16,1165,6293,7458
2021/05/13,09:00:00,184.5,1465,6339,7804
2021/05/13,09:30:00,184.42,1553,6288,7841
2021/05/13,10:00:00,184.24,1758,6264,8022
2021/05/13,10:30:00,184.16,1843,6277,8120
2021/05/13,11:00:00,184.16,1950,6254,8204
2021/05/13,11:30:00,184.16,2013,6261,8274
2021/05/13,12:00:00,183.9,2049,6335,8384
2021/05/13,12:30:00,183.9,2066,6369,8435
2021/05/13,13:00:00,183.81,2070,6434,8504
2021/05/13,13:30:00,184.24,2062,6502,8564
2021/05/13,14:00:00,184.16,2031,6557,8588
2021/05/13,14:30:00,183.64,1987,6562,8549
2021/05/13,15:00:00,184.16,1928,6548,8476
2021/05/13,15:30:00,183.81,1803,6621,8424
2021/05/13,16:00:00,184.07,1687,6603,8290
2021/05/13,16:30:00,184.24,1491,6690,8181
2021/05/13,17:00:00,183.73,1205,6814,8019
2021/05/13,17:30:00,183.81,974,7012,7986
2021/05/13,18:00:00,184.16,755,7223,7978
2021/05/13,18:30:00,208.96,518,7410,7928
2021/05/13,19:00:00,227.84,150,7491,7641
2021/05/13,19:30:00,227.84,117,7643,7760
2021/05/13,20:00:00,227.62,133,7826,7959
2021/05/13,20:30:00,208.53,135,7812,7947
2021/05/13,21:00:00,183.81,134,7701,7835
2021/05/13,21:30:00,183.9,132,7520,7652
2021/05/13,22:00:00,183.99,131,7374,7505
2021/05/13,22:30:00,184.16,129,7266,7395
2021/05/13,23:00:00,184.16,127,7072,7199
2021/05/13,23:30:00,184.5,126,6880,7006
2021/05/14,00:00:00,184.07,126,6670,6796
2021/05/14,00:30:00,184.59,125,6489,6614
2021/05/14,01:00:00,184.5,127,6301,6428
2021/05/14,01:30:00,184.33,125,6134,6259
2021/05/14,02:00:00,184.16,119,6009,6128
2021/05/14,02:30:00,184.5,70,5952,6022
2021/05/14,03:00:00,184.5,5,5896,5901
2021/05/14,03:30:00,184.42,4,5822,5826
2021/05/14,04:00:00,184.16,4,5805,5809
2021/05/14,04:30:00,184.16,5,5837,5842
2021/05/14,05:00:00,184.42,5,5882,5887
2021/05/14,05:30:00,184.42,5,5892,5897
2021/05/14,06:00:00,184.42,3,5775,5778
2021/05/14,06:30:00,183.9,83,5812,5895
2021/05/14,07:00:00,184.59,206,5809,6015
2021/05/14,07:30:00,183.9,403,5798,6201
2021/05/14,08:00:00,184.5,614,5738,6352
2021/05/14,08:30:00,183.9,814,5834,6648
2021/05/14,09:00:00,183.99,1164,5709,6873
2021/05/14,09:30:00,184.16,1437,5623,7060
2021/05/14,10:00:00,184.16,1646,5740,7386
2021/05/14,10:30:00,183.99,1773,5690,7463
2021/05/14,11:00:00,184.16,1904,5697,7601
2021/05/14,11:30:00,184.07,2025,5691,7716
2021/05/14,12:00:00,183.99,2062,5761,7823
2021/05/14,12:30:00,184.42,2077,5791,7868
2021/05/14,13:00:00,184.16,2090,5808,7898
2021/05/14,13:30:00,184.16,2084,5857,7941
2021/05/14,14:00:00,184.07,2032,5850,7882
2021/05/14,14:30:00,184.33,2006,5912,7918
2021/05/14,15:00:00,184.16,1912,5970,7882
2021/05/14,15:30:00,184.59,1820,6050,7870
2021/05/14,16:00:00,183.47,1678,6032,7710
2021/05/14,16:30:00,184.76,1483,6077,7560
2021/05/14,17:00:00,183.9,1223,6306,7529
2021/05/14,17:30:00,183.15,949,6645,7594
2021/05/14,18:00:00,179,731,6991,7722
2021/05/14,18:30:00,179,459,7327,7786
2021/05/14,19:00:00,204.56,128,7461,7589
2021/05/14,19:30:00,201.52,120,7458,7578
2021/05/14,20:00:00,210.52,131,7589,7720
2021/05/14,20:30:00,209.75,132,7519,7651
2021/05/14,21:00:00,200.99,132,7359,7491
2021/05/14,21:30:00,200.99,130,7224,7354
2021/05/14,22:00:00,201.52,131,7099,7230
2021/05/14,22:30:00,201.52,130,6996,7126
2021/05/14,23:00:00,174.32,130,6818,6948
2021/05/14,23:30:00,175.83,131,6657,6788
2021/05/15,00:00:00,176.1,130,6506,6636
2021/05/15,00:30:00,177.02,129,6345,6474
2021/05/15,01:00:00,184.42,130,6202,6332
2021/05/15,01:30:00,183.47,125,6080,6205
2021/05/15,02:00:00,184.16,73,6053,6126
2021/05/15,02:30:00,184.42,9,6012,6021
2021/05/15,03:00:00,184.07,8,5930,5938
2021/05/15,03:30:00,184.33,7,5882,5889
2021/05/15,04:00:00,184.24,6,5858,5864
2021/05/15,04:30:00,183.81,5,5869,5874
2021/05/15,05:00:00,184.07,3,5873,5876
2021/05/15,05:30:00,183.9,5,5816,5821
2021/05/15,06:00:00,184.42,4,5625,5629
2021/05/15,06:30:00,184.42,126,5708,5834
2021/05/15,07:00:00,184.16,223,5549,5772
2021/05/15,07:30:00,184.16,533,5483,6016
2021/05/15,08:00:00,184.33,841,5219,6060
2021/05/15,08:30:00,184.42,1247,5039,6286
2021/05/15,09:00:00,184.24,1473,4944,6417
2021/05/15,09:30:00,184.24,1661,4938,6599
2021/05/15,10:00:00,183.9,1788,4943,6731
2021/05/15,10:30:00,183.64,1902,4949,6851
2021/05/15,11:00:00,184.16,1978,4970,6948
2021/05/15,11:30:00,183.99,2039,5019,7058
2021/05/15,12:00:00,183.9,2074,5047,7121
2021/05/15,12:30:00,184.16,2071,5159,7230
2021/05/15,13:00:00,184.16,2075,5207,7282
2021/05/15,13:30:00,184.16,2065,5252,7317
2021/05/15,14:00:00,184.24,2035,5269,7304
2021/05/15,14:30:00,184.24,1997,5381,7378
2021/05/15,15:00:00,183.9,1910,5441,7351
2021/05/15,15:30:00,183.9,1822,5592,7414
2021/05/15,16:00:00,183.9,1648,5723,7371
2021/05/15,16:30:00,190.73,1498,5928,7426
2021/05/15,17:00:00,190.26,1229,6164,7393
2021/05/15,17:30:00,191.2,980,6334,7314
2021/05/15,18:00:00,190.26,730,6655,7385
2021/05/15,18:30:00,190.73,466,6787,7253
2021/05/15,19:00:00,217.84,160,6834,6994
2021/05/15,19:30:00,217.84,123,7032,7155
2021/05/15,20:00:00,217.33,121,7299,7420
2021/05/15,20:30:00,217.84,129,7325,7454
2021/05/15,21:00:00,185.53,131,7359,7490
2021/05/15,21:30:00,186.08,128,7337,7465
2021/05/15,22:00:00,198.1,127,7212,7339
2021/05/15,22:30:00,217.59,130,7163,7293
2021/05/15,23:00:00,217.84,131,7025,7156
2021/05/15,23:30:00,183.9,126,6844,6970
2021/05/16,00:00:00,184.16,127,6626,6753
2021/05/16,00:30:00,183.9,130,6404,6534
2021/05/16,01:00:00,183.99,130,6252,6382
2021/05/16,01:30:00,183.9,123,6095,6218
2021/05/16,02:00:00,184.07,117,5917,6034
2021/05/16,02:30:00,183.73,56,5873,5929
2021/05/16,03:00:00,184.16,1,5821,5822
2021/05/16,03:30:00,184.07,1,5768,5769
2021/05/16,04:00:00,183.9,2,5730,5732
2021/05/16,04:30:00,184.16,2,5724,5726
2021/05/16,05:00:00,192.99,2,5749,5751
2021/05/16,05:30:00,184.16,6,5775,5781
2021/05/16,06:00:00,184.16,3,5642,5645
2021/05/16,06:30:00,183.9,124,5882,6006
2021/05/16,07:00:00,184.42,293,5800,6093
2021/05/16,07:30:00,184.24,632,5741,6373
2021/05/16,08:00:00,183.81,993,5648,6641
2021/05/16,08:30:00,184.5,1265,5700,6965
2021/05/16,09:00:00,183.99,1453,5728,7181
2021/05/16,09:30:00,184.5,1651,5683,7334
2021/05/16,10:00:00,184.24,1759,5735,7494
2021/05/16,10:30:00,184.16,1877,5779,7656
2021/05/16,11:00:00,183.9,1930,5897,7827
2021/05/16,11:30:00,183.99,2003,5978,7981
2021/05/16,12:00:00,184.24,2028,6036,8064
2021/05/16,12:30:00,184.16,2038,6103,8141
2021/05/16,13:00:00,184.16,2035,6203,8238
2021/05/16,13:30:00,184.42,2006,6286,8292
2021/05/16,14:00:00,184.59,1975,6253,8228
2021/05/16,14:30:00,183.99,1920,6335,8255
2021/05/16,15:00:00,184.16,1831,6360,8191
2021/05/16,15:30:00,179.84,1724,6471,8195
2021/05/16,16:00:00,177.17,1517,6589,8106
2021/05/16,16:30:00,177.02,1323,6706,8029
2021/05/16,17:00:00,180.08,1016,7054,8070
2021/05/16,17:30:00,179.84,822,7260,8082
2021/05/16,18:00:00,207.22,620,7515,8135
2021/05/16,18:30:00,186.67,444,7737,8181
2021/05/16,19:00:00,186.67,118,7802,7920
2021/05/16,19:30:00,186.45,105,7728,7833
2021/05/16,20:00:00,187.36,123,7752,7875
2021/05/16,20:30:00,193,121,7613,7734
2021/05/16,21:00:00,193.58,121,7431,7552
2021/05/16,21:30:00,179.92,120,7333,7453
2021/05/16,22:00:00,198.39,120,7157,7277
2021/05/16,22:30:00,197.31,120,7059,7179
2021/05/16,23:00:00,196.8,120,6926,7046
2021/05/16,23:30:00,183.64,120,6773,6893
2021/05/17,00:00:00,183.99,120,6601,6721
2021/05/17,00:30:00,184.16,120,6449,6569
2021/05/17,01:00:00,183.99,120,6320,6440
2021/05/17,01:30:00,184.24,89,6205,6294
2021/05/17,02:00:00,184.16,40,6114,6154
2021/05/17,02:30:00,184.16,0,6098,6098
2021/05/17,03:00:00,183.99,0,6035,6035
2021/05/17,03:30:00,184.24,0,5964,5964
2021/05/17,04:00:00,184.16,1,5954,5955
2021/05/17,04:30:00,184.24,2,5949,5951
2021/05/17,05:00:00,183.99,2,5953,5955
2021/05/17,05:30:00,184.33,2,5941,5943
2021/05/17,06:00:00,184.07,3,5775,5778
2021/05/17,06:30:00,183.73,15,5743,5758
2021/05/17,07:00:00,184.42,219,5759,5978
2021/05/17,07:30:00,185.11,370,5728,6098
2021/05/17,08:00:00,184.42,642,5606,6248
2021/05/17,08:30:00,184.42,828,5590,6418
2021/05/17,09:00:00,183.64,1130,5495,6625
2021/05/17,09:30:00,183.9,1346,5573,6919
2021/05/17,10:00:00,184.16,1569,5563,7132
2021/05/17,10:30:00,183.9,1793,5488,7281
2021/05/17,11:00:00,184.07,1890,5475,7365
2021/05/17,11:30:00,184.42,1973,5517,7490
2021/05/17,12:00:00,184.42,2022,5530,7552
2021/05/17,12:30:00,184.16,2041,5596,7637
2021/05/17,13:00:00,183.99,2038,5668,7706
2021/05/17,13:30:00,183.99,2020,5597,7617
2021/05/17,14:00:00,184.24,1999,5627,7626
2021/05/17,14:30:00,184.59,1939,5528,7467
2021/05/17,15:00:00,184.42,1888,5599,7487
2021/05/17,15:30:00,184.33,1758,5744,7502
2021/05/17,16:00:00,184.07,1619,5848,7467
2021/05/17,16:30:00,184.24,1431,6050,7481
2021/05/17,17:00:00,184.59,1183,6166,7349
2021/05/17,17:30:00,184.24,932,6413,7345
2021/05/17,18:00:00,184.33,707,6625,7332
2021/05/17,18:30:00,184.24,500,6884,7384
2021/05/17,19:00:00,184.33,150,7078,7228
2021/05/17,19:30:00,184.24,116,7274,7390
2021/05/17,20:00:00,184.42,133,7512,7645
2021/05/17,20:30:00,177.31,132,7540,7672
2021/05/17,21:00:00,179,130,7540,7670
2021/05/17,21:30:00,190.43,125,7537,7662
2021/05/17,22:00:00,1670.69,127,7436,7563
2021/05/17,22:30:00,1471.3,126,7271,7397
2021/05/17,23:00:00,1889.99,124,7064,7188
2021/05/17,23:30:00,1826.88,126,6898,7024
2021/05/18,00:00:00,169.73,125,6697,6822
2021/05/18,00:30:00,176.45,126,6471,6597
2021/05/18,01:00:00,180.97,123,6270,6393
2021/05/18,01:30:00,179.21,125,6125,6250
2021/05/18,02:00:00,180.97,126,5963,6089
2021/05/18,02:30:00,180.48,95,6220,6315
2021/05/18,03:00:00,180.24,57,6178,6235
2021/05/18,03:30:00,184.16,2,6152,6154
2021/05/18,04:00:00,183.9,0,6167,6167
2021/05/18,04:30:00,183.9,0,6171,6171
2021/05/18,05:00:00,184.16,1,6216,6217
2021/05/18,05:30:00,184.5,2,6260,6262
2021/05/18,06:00:00,184.24,2,6130,6132
2021/05/18,06:30:00,184.16,134,6242,6376
2021/05/18,07:00:00,184.33,240,6341,6581
2021/05/18,07:30:00,184.16,465,6452,6917
2021/05/18,08:00:00,184.07,828,6388,7216
2021/05/18,08:30:00,183.99,1124,6369,7493
2021/05/18,09:00:00,184.07,1427,6328,7755
2021/05/18,09:30:00,184.16,1559,6339,7898
2021/05/18,10:00:00,184.5,1738,6324,8062
2021/05/18,10:30:00,184.16,1824,6344,8168
2021/05/18,11:00:00,184.24,1925,6370,8295
2021/05/18,11:30:00,184.42,1985,6273,8258
2021/05/18,12:00:00,183.9,2025,6328,8353
2021/05/18,12:30:00,184.16,2036,6273,8309
2021/05/18,13:00:00,184.24,2042,6375,8417
2021/05/18,13:30:00,184.24,2029,6474,8503
2021/05/18,14:00:00,184.33,2001,6535,8536
2021/05/18,14:30:00,184.16,1956,6604,8560
2021/05/18,15:00:00,184.16,1872,6670,8542
2021/05/18,15:30:00,184.16,1748,6801,8549
2021/05/18,16:00:00,184.42,1631,6873,8504
2021/05/18,16:30:00,184.07,1450,7010,8460
2021/05/18,17:00:00,184.16,1206,7169,8375
2021/05/18,17:30:00,184.33,945,7366,8311
2021/05/18,18:00:00,184.24,733,7522,8255
2021/05/18,18:30:00,178.54,467,7707,8174
2021/05/18,19:00:00,178.54,149,7801,7950
2021/05/18,19:30:00,176.47,117,7926,8043
2021/05/18,20:00:00,178.54,123,8188,8311
2021/05/18,20:30:00,176.47,131,8145,8276
2021/05/18,21:00:00,176.47,128,8012,8140
2021/05/18,21:30:00,176.47,128,7844,7972
2021/05/18,22:00:00,179.21,127,7734,7861
2021/05/18,22:30:00,176.47,126,7519,7645
2021/05/18,23:00:00,178.54,125,7345,7470
2021/05/18,23:30:00,175.36,126,7117,7243
2021/05/19,00:00:00,174.26,125,6874,6999
2021/05/19,00:30:00,182.21,127,6698,6825
2021/05/19,01:00:00,184.16,127,6452,6579
2021/05/19,01:30:00,184.07,105,6289,6394
2021/05/19,02:00:00,183.9,63,6266,6329
2021/05/19,02:30:00,183.73,7,6368,6375
2021/05/19,03:00:00,184.07,5,6440,6445
2021/05/19,03:30:00,184.24,4,6320,6324
2021/05/19,04:00:00,184.24,4,6292,6296
2021/05/19,04:30:00,184.07,4,6360,6364
2021/05/19,05:00:00,184.42,3,6350,6353
2021/05/19,05:30:00,184.24,2,6467,6469
2021/05/19,06:00:00,184.33,2,6324,6326
2021/05/19,06:30:00,183.81,117,6534,6651
2021/05/19,07:00:00,184.16,233,6625,6858
2021/05/19,07:30:00,184.16,487,6820,7307
2021/05/19,08:00:00,184.07,715,6926,7641
2021/05/19,08:30:00,184.16,975,6975,7950
2021/05/19,09:00:00,184.42,1207,6911,8118
2021/05/19,09:30:00,183.99,1591,6764,8355
2021/05/19,10:00:00,184.16,1729,6516,8245
2021/05/19,10:30:00,183.9,1842,6530,8372
2021/05/19,11:00:00,183.99,1922,6542,8464
2021/05/19,11:30:00,183.73,1993,6609,8602
2021/05/19,12:00:00,184.24,2010,6668,8678
2021/05/19,12:30:00,183.99,2050,6776,8826
2021/05/19,13:00:00,184.07,2046,6898,8944
2021/05/19,13:30:00,184.24,2035,7052,9087
2021/05/19,14:00:00,184.42,1982,7152,9134
2021/05/19,14:30:00,184.16,133,9102,9235
2021/05/19,15:00:00,180.97,1804,7378,9182
2021/05/19,15:30:00,173.59,1762,7483,9245
2021/05/19,16:00:00,178.54,1600,7550,9150
2021/05/19,16:30:00,179.21,1453,7671,9124
2021/05/19,17:00:00,178.54,1145,7741,8886
2021/05/19,17:30:00,179.21,939,7931,8870
2021/05/19,18:00:00,179.21,679,8065,8744
2021/05/19,18:30:00,179.87,447,8183,8630
2021/05/19,19:00:00,179.21,128,8257,8385
2021/05/19,19:30:00,179.21,119,8296,8415
2021/05/19,20:00:00,179.21,129,8565,8694
2021/05/19,20:30:00,179.21,125,8496,8621
2021/05/19,21:00:00,178.54,126,8324,8450
2021/05/19,21:30:00,179.87,125,8214,8339
2021/05/19,22:00:00,179,124,8041,8165
2021/05/19,22:30:00,179,125,7830,7955
2021/05/19,23:00:00,178.54,124,7629,7753
2021/05/19,23:30:00,169.53,125,7378,7503
2021/05/20,00:00:00,170.36,126,7110,7236
2021/05/20,00:30:00,172.02,125,6909,7034
2021/05/20,01:00:00,171.58,107,6732,6839
2021/05/20,01:30:00,172.07,8,6660,6668
2021/05/20,02:00:00,172.02,7,6556,6563
2021/05/20,02:30:00,171.45,8,6451,6459
2021/05/20,03:00:00,175.15,7,6345,6352
2021/05/20,03:30:00,177.39,5,6295,6300
2021/05/20,04:00:00,176.73,5,6266,6271
2021/05/20,04:30:00,176.81,7,6311,6318
2021/05/20,05:00:00,176.59,4,6376,6380
2021/05/20,05:30:00,176.38,3,6412,6415
2021/05/20,06:00:00,176.95,2,6347,6349
2021/05/20,06:30:00,176.73,16,6604,6620
2021/05/20,07:00:00,180,204,6764,6968
2021/05/20,07:30:00,180.16,410,6990,7400
2021/05/20,08:00:00,179.92,695,6992,7687
2021/05/20,08:30:00,180.56,1078,6979,8057
2021/05/20,09:00:00,184.42,1325,6991,8316
2021/05/20,09:30:00,180.32,1537,7076,8613
2021/05/20,10:00:00,180.97,1667,7246,8913
2021/05/20,10:30:00,179,1794,7287,9081
2021/05/20,11:00:00,179,1855,7330,9185
2021/05/20,11:30:00,179,1923,7403,9326
2021/05/20,12:00:00,179,1967,7487,9454
2021/05/20,12:30:00,171.49,1978,7604,9582
2021/05/20,13:00:00,170.46,1982,7756,9738
2021/05/20,13:30:00,170.69,1967,7874,9841
2021/05/20,14:00:00,169.12,1944,7998,9942
2021/05/20,14:30:00,168.98,1887,8173,10060
2021/05/20,15:00:00,168.98,1800,8230,10030
2021/05/20,15:30:00,168.98,1688,8348,10036
2021/05/20,16:00:00,179.21,1503,8282,9785
2021/05/20,16:30:00,179.87,1101,8445,9546
2021/05/20,17:00:00,179.21,1040,8532,9572
2021/05/20,17:30:00,179.87,812,8543,9355
2021/05/20,18:00:00,179.87,521,8613,9134
2021/05/20,18:30:00,180.53,349,8578,8927
2021/05/20,19:00:00,232.37,131,8507,8638
2021/05/20,19:30:00,230.62,129,8552,8681
2021/05/20,20:00:00,232.68,130,8746,8876
2021/05/20,20:30:00,232.69,129,8701,8830
2021/05/20,21:00:00,229.25,129,8608,8737
2021/05/20,21:30:00,229.25,129,8470,8599
2021/05/20,22:00:00,232.38,131,8275,8406
2021/05/20,22:30:00,228.58,131,8077,8208
2021/05/20,23:00:00,228.58,127,7851,7978
2021/05/20,23:30:00,227.92,130,7610,7740
2021/05/21,00:00:00,171.4,131,7400,7531
2021/05/21,00:30:00,168.97,128,7187,7315
2021/05/21,01:00:00,169,44,7125,7169
2021/05/21,01:30:00,169.1,7,6920,6927
2021/05/21,02:00:00,171.77,8,6790,6798
2021/05/21,02:30:00,171.97,7,6694,6701
2021/05/21,03:00:00,172.17,6,6606,6612
2021/05/21,03:30:00,172.12,8,6514,6522
2021/05/21,04:00:00,172.58,6,6458,6464
2021/05/21,04:30:00,176.95,8,6462,6470
2021/05/21,05:00:00,176.45,9,6493,6502
2021/05/21,05:30:00,176.81,5,6474,6479
2021/05/21,06:00:00,177.31,5,6252,6257
2021/05/21,06:30:00,177.17,17,6416,6433
2021/05/21,07:00:00,179.13,198,6585,6783
2021/05/21,07:30:00,180.32,320,6744,7064
2021/05/21,08:00:00,180.24,523,6794,7317
2021/05/21,08:30:00,180.08,645,6891,7536
2021/05/21,09:00:00,179.84,855,6895,7750
2021/05/21,09:30:00,180.24,1190,6831,8021
2021/05/21,10:00:00,179.52,1405,6715,8120
2021/05/21,10:30:00,180,1588,6692,8280
2021/05/21,11:00:00,179.68,1746,6652,8398
2021/05/21,11:30:00,183.64,1847,6623,8470
2021/05/21,12:00:00,183.99,1900,6620,8520
2021/05/21,12:30:00,184.16,1951,6668,8619
2021/05/21,13:00:00,184.33,1949,6674,8623
2021/05/21,13:30:00,184.16,1942,6690,8632
2021/05/21,14:00:00,184.24,1924,6711,8635
2021/05/21,14:30:00,183.9,1875,6762,8637
2021/05/21,15:00:00,184.16,1799,6829,8628
2021/05/21,15:30:00,183.9,1685,6887,8572
2021/05/21,16:00:00,184.24,1560,6949,8509
2021/05/21,16:30:00,184.24,1384,6828,8212
2021/05/21,17:00:00,183.99,1140,6991,8131
2021/05/21,17:30:00,183.64,932,7225,8157
2021/05/21,18:00:00,206.76,694,7526,8220
2021/05/21,18:30:00,206.41,473,7773,8246
2021/05/21,19:00:00,206.41,136,7914,8050
2021/05/21,19:30:00,202.07,135,7944,8079
2021/05/21,20:00:00,203.89,139,8068,8207
2021/05/21,20:30:00,202.07,138,7970,8108
2021/05/21,21:00:00,202.65,137,7770,7907
2021/05/21,21:30:00,184.24,133,7672,7805
2021/05/21,22:00:00,220.2,88,7512,7600
2021/05/21,22:30:00,184.5,9,7431,7440
2021/05/21,23:00:00,184.24,11,7256,7267
2021/05/21,23:30:00,184.16,10,7196,7206
2021/05/22,00:00:00,184.24,8,6984,6992
2021/05/22,00:30:00,183.9,4,6831,6835
2021/05/22,01:00:00,184.59,5,6649,6654
2021/05/22,01:30:00,184.24,4,6526,6530
2021/05/22,02:00:00,184.59,1,6415,6416
2021/05/22,02:30:00,184.24,1,6336,6337
2021/05/22,03:00:00,184.42,2,6251,6253
2021/05/22,03:30:00,184.5,5,6218,6223
2021/05/22,04:00:00,184.33,8,6188,6196
2021/05/22,04:30:00,184.42,10,6138,6148
2021/05/22,05:00:00,184.5,9,6152,6161
2021/05/22,05:30:00,184.33,8,6085,6093
2021/05/22,06:00:00,184.33,6,5929,5935
2021/05/22,06:30:00,184.68,96,5991,6087
2021/05/22,07:00:00,184.42,215,6089,6304
2021/05/22,07:30:00,184.42,379,6003,6382
2021/05/22,08:00:00,184.5,602,5909,6511
2021/05/22,08:30:00,184.42,756,5913,6669
2021/05/22,09:00:00,184.59,1050,5764,6814
2021/05/22,09:30:00,184.33,27,6905,6932
2021/05/22,10:00:00,183.99,1431,5722,7153
2021/05/22,10:30:00,184.07,1469,5597,7066
2021/05/22,11:00:00,197.36,1699,5463,7162
2021/05/22,11:30:00,197.36,1812,5494,7306
2021/05/22,12:00:00,196.72,1851,5372,7223
2021/05/22,12:30:00,197.36,1987,5299,7286
2021/05/22,13:00:00,198.01,2046,5312,7358
2021/05/22,13:30:00,198.01,2060,5316,7376
2021/05/22,14:00:00,198.01,2051,5325,7376
2021/05/22,14:30:00,197.36,1985,5361,7346
2021/05/22,15:00:00,197.36,1914,5422,7336
2021/05/22,15:30:00,198.01,1773,5591,7364
2021/05/22,16:00:00,202.2,1654,5712,7366
2021/05/22,16:30:00,201.66,1464,5640,7104
2021/05/22,17:00:00,201.66,1230,5825,7055
2021/05/22,17:30:00,201.66,936,6067,7003
2021/05/22,18:00:00,201.66,718,6339,7057
2021/05/22,18:30:00,224.18,464,6632,7096
2021/05/22,19:00:00,231.4,153,6889,7042
2021/05/22,19:30:00,231.81,132,7088,7220
2021/05/22,20:00:00,231.8,139,7413,7552
2021/05/22,20:30:00,231.39,136,7515,7651
2021/05/22,21:00:00,235.23,131,7596,7727
2021/05/22,21:30:00,235.31,129,7522,7651
2021/05/22,22:00:00,231.9,134,7431,7565
2021/05/22,22:30:00,236.12,128,7290,7418
2021/05/22,23:00:00,236.91,123,7062,7185
2021/05/22,23:30:00,183.9,111,6846,6957
2021/05/23,00:00:00,183.39,11,6748,6759
2021/05/23,00:30:00,184.07,8,6582,6590
2021/05/23,01:00:00,184.07,8,6340,6348
2021/05/23,01:30:00,183.9,4,6226,6230
2021/05/23,02:00:00,183.99,4,6091,6095
2021/05/23,02:30:00,183.99,6,5977,5983
2021/05/23,03:00:00,183.99,6,5918,5924
2021/05/23,03:30:00,184.16,8,5866,5874
2021/05/23,04:00:00,183.99,8,5854,5862
2021/05/23,04:30:00,184.24,7,5854,5861
2021/05/23,05:00:00,184.16,7,5973,5980
2021/05/23,05:30:00,184.24,6,6057,6063
2021/05/23,06:00:00,184.16,5,5981,5986
2021/05/23,06:30:00,184.16,130,6339,6469
2021/05/23,07:00:00,183.9,217,6579,6796
2021/05/23,07:30:00,226.88,439,6816,7255
2021/05/23,08:00:00,227.55,683,6940,7623
2021/05/23,08:30:00,228.25,915,7075,7990
2021/05/23,09:00:00,229.64,1077,7047,8124
2021/05/23,09:30:00,245.08,1437,6885,8322
2021/05/23,10:00:00,245.09,1639,6783,8422
2021/05/23,10:30:00,243.87,1727,6690,8417
2021/05/23,11:00:00,245.09,1850,6705,8555
2021/05/23,11:30:00,249,1979,6621,8600
2021/05/23,12:00:00,245.1,2051,6608,8659
2021/05/23,12:30:00,247.64,2084,6654,8738
2021/05/23,13:00:00,245.11,2087,6702,8789
2021/05/23,13:30:00,245.11,2076,6773,8849
2021/05/23,14:00:00,249,2054,6835,8889
2021/05/23,14:30:00,247.65,2010,6933,8943
2021/05/23,15:00:00,243.89,1915,6998,8913
2021/05/23,15:30:00,247.65,1826,6908,8734
2021/05/23,16:00:00,246.36,1658,6879,8537
2021/05/23,16:30:00,245.11,1516,6986,8502
2021/05/23,17:00:00,246.35,1253,7090,8343
2021/05/23,17:30:00,245.11,989,7318,8307
2021/05/23,18:00:00,246.35,757,7475,8232
2021/05/23,18:30:00,229.04,512,7696,8208
2021/05/23,19:00:00,229.08,168,7846,8014
2021/05/23,19:30:00,229.08,51,8066,8117
2021/05/23,20:00:00,227.73,89,8291,8380
2021/05/23,20:30:00,228.42,122,8278,8400
2021/05/23,21:00:00,227.75,134,8215,8349
2021/05/23,21:30:00,227.75,137,8038,8175
2021/05/23,22:00:00,225.96,137,7857,7994
2021/05/23,22:30:00,225.97,133,7633,7766
2021/05/23,23:00:00,225.96,131,7388,7519
2021/05/23,23:30:00,225.96,129,7126,7255
2021/05/24,00:00:00,184.24,123,6876,6999
2021/05/24,00:30:00,184.16,81,6647,6728
2021/05/24,01:00:00,184.42,8,6540,6548
2021/05/24,01:30:00,183.9,6,6362,6368
2021/05/24,02:00:00,184.42,6,6211,6217
2021/05/24,02:30:00,184.42,7,6142,6149
2021/05/24,03:00:00,183.73,6,6048,6054
2021/05/24,03:30:00,184.24,6,6048,6054
2021/05/24,04:00:00,184.33,5,6016,6021
2021/05/24,04:30:00,184.16,6,6059,6065
2021/05/24,05:00:00,184.42,8,6122,6130
2021/05/24,05:30:00,184.42,9,6180,6189
2021/05/24,06:00:00,184.42,4,6147,6151
2021/05/24,06:30:00,184.24,152,6461,6613
2021/05/24,07:00:00,184.24,294,6657,6951
2021/05/24,07:30:00,184.16,634,6729,7363
2021/05/24,08:00:00,184.42,1006,6779,7785
2021/05/24,08:30:00,184.33,1226,6908,8134
2021/05/24,09:00:00,184.24,1408,6835,8243
2021/05/24,09:30:00,184.16,1624,6864,8488
2021/05/24,10:00:00,184.16,1738,6835,8573
2021/05/24,10:30:00,184.24,1880,6833,8713
2021/05/24,11:00:00,184.42,1939,6856,8795
2021/05/24,11:30:00,184.16,2013,6876,8889
2021/05/24,12:00:00,184.33,2020,6915,8935
2021/05/24,12:30:00,184.24,2060,6900,8960
2021/05/24,13:00:00,184.16,2056,6972,9028
2021/05/24,13:30:00,184.42,2053,7042,9095
2021/05/24,14:00:00,184.16,2038,6999,9037
2021/05/24,14:30:00,184.42,1984,7134,9118
2021/05/24,15:00:00,184.24,1910,7040,8950
2021/05/24,15:30:00,184.24,1810,7152,8962
2021/05/24,16:00:00,184.42,1651,7202,8853
2021/05/24,16:30:00,236.05,1502,7322,8824
2021/05/24,17:00:00,236.2,1194,7483,8677
2021/05/24,17:30:00,224.37,1022,7613,8635
2021/05/24,18:00:00,224.16,736,7827,8563
2021/05/24,18:30:00,246.93,525,8020,8545
2021/05/24,19:00:00,246.93,138,8177,8315
2021/05/24,19:30:00,240.92,130,8240,8370
2021/05/24,20:00:00,245.12,137,8507,8644
2021/05/24,20:30:00,257.17,134,8610,8744
2021/05/24,21:00:00,259.78,132,8486,8618
2021/05/24,21:30:00,256.35,131,8321,8452
2021/05/24,22:00:00,255.42,127,8094,8221
2021/05/24,22:30:00,256.22,127,7873,8000
2021/05/24,23:00:00,258.79,125,7641,7766
2021/05/24,23:30:00,246.93,123,7322,7445
2021/05/25,00:00:00,198.39,121,7087,7208
2021/05/25,00:30:00,183.64,43,6900,6943
2021/05/25,01:00:00,187.71,3,6714,6717
2021/05/25,01:30:00,187.33,2,6525,6527
2021/05/25,02:00:00,187.65,1,6373,6374
2021/05/25,02:30:00,184.07,1,6310,6311
2021/05/25,03:00:00,184.24,0,6227,6227
2021/05/25,03:30:00,184.07,0,6176,6176
2021/05/25,04:00:00,183.9,0,6168,6168
2021/05/25,04:30:00,183.9,0,6180,6180
2021/05/25,05:00:00,183.9,0,6266,6266
2021/05/25,05:30:00,183.9,1,6323,6324
2021/05/25,06:00:00,184.16,1,6247,6248
2021/05/25,06:30:00,183.9,153,6434,6587
2021/05/25,07:00:00,183.9,269,6591,6860
2021/05/25,07:30:00,184.24,469,6826,7295
2021/05/25,08:00:00,184.59,831,6733,7564
2021/05/25,08:30:00,184.07,1065,6841,7906
2021/05/25,09:00:00,184.42,1333,6934,8267
2021/05/25,09:30:00,183.99,1572,6881,8453
2021/05/25,10:00:00,184.07,1719,6890,8609
2021/05/25,10:30:00,184.16,1830,6919,8749
2021/05/25,11:00:00,183.81,1908,6969,8877
2021/05/25,11:30:00,183.99,1966,7012,8978
2021/05/25,12:00:00,184.07,2013,7085,9098
2021/05/25,12:30:00,183.99,2030,7180,9210
2021/05/25,13:00:00,183.9,2041,7300,9341
2021/05/25,13:30:00,184.33,2021,7426,9447
2021/05/25,14:00:00,184.59,1999,7539,9538
2021/05/25,14:30:00,183.99,1948,7694,9642
2021/05/25,15:00:00,184.07,1878,7838,9716
2021/05/25,15:30:00,186.1,1751,7935,9686
2021/05/25,16:00:00,233.95,1613,7976,9589
2021/05/25,16:30:00,234.13,1454,8087,9541
2021/05/25,17:00:00,234.13,1144,8181,9325
2021/05/25,17:30:00,227.25,977,8248,9225
2021/05/25,18:00:00,242.75,686,8406,9092
2021/05/25,18:30:00,236.75,482,8482,8964
2021/05/25,19:00:00,252.76,141,8528,8669
2021/05/25,19:30:00,252.16,130,8563,8693
2021/05/25,20:00:00,235.06,134,8807,8941
2021/05/25,20:30:00,258.06,132,8846,8978
2021/05/25,21:00:00,257.36,134,8713,8847
2021/05/25,21:30:00,259.51,135,8510,8645
2021/05/25,22:00:00,235.09,131,8290,8421
2021/05/25,22:30:00,241.42,129,8088,8217
2021/05/25,23:00:00,257.96,124,7843,7967
2021/05/25,23:30:00,257.96,123,7561,7684
2021/05/26,00:00:00,257.86,123,7292,7415
2021/05/26,00:30:00,257.09,123,7021,7144
2021/05/26,01:00:00,257.86,122,6775,6897
2021/05/26,01:30:00,256.35,123,6627,6750
2021/05/26,02:00:00,257.09,123,6588,6711
2021/05/26,02:30:00,262.11,114,6515,6629
2021/05/26,03:00:00,257.09,66,6470,6536
2021/05/26,03:30:00,261.14,2,6482,6484
2021/05/26,04:00:00,260.27,2,6429,6431
2021/05/26,04:30:00,260.26,1,6441,6442
2021/05/26,05:00:00,257.08,1,6496,6497
2021/05/26,05:30:00,246.93,1,6527,6528
2021/05/26,06:00:00,246.93,1,6435,6436
2021/05/26,06:30:00,246.93,141,6825,6966
2021/05/26,07:00:00,244.85,250,7020,7270
2021/05/26,07:30:00,246.93,509,7182,7691
2021/05/26,08:00:00,246.93,958,7093,8051
2021/05/26,08:30:00,245.55,1228,7182,8410
2021/05/26,09:00:00,246.93,1410,7316,8726
2021/05/26,09:30:00,246.93,1584,7351,8935
2021/05/26,10:00:00,246.93,1729,7396,9125
2021/05/26,10:30:00,245.55,1833,7468,9301
2021/05/26,11:00:00,246.93,1904,7566,9470
2021/05/26,11:30:00,246.93,1973,7638,9611
2021/05/26,12:00:00,246.93,2001,7687,9688
2021/05/26,12:30:00,245.55,2031,7820,9851
2021/05/26,13:00:00,246.93,2044,7890,9934
2021/05/26,13:30:00,245.55,2034,7927,9961
2021/05/26,14:00:00,246.93,2008,8160,10168
2021/05/26,14:30:00,262.11,1955,8119,10074
2021/05/26,15:00:00,260.33,1883,8241,10124
2021/05/26,15:30:00,261.17,1787,8319,10106
2021/05/26,16:00:00,262.11,1641,8347,9988
2021/05/26,16:30:00,264.19,1488,8501,9989
2021/05/26,17:00:00,264.19,1152,8592,9744
2021/05/26,17:30:00,246.89,977,8698,9675
2021/05/26,18:00:00,245.5,710,8812,9522
2021/05/26,18:30:00,246.58,514,8819,9333
2021/05/26,19:00:00,252.76,335,8821,9156
2021/05/26,19:30:00,245.44,107,8840,8947
2021/05/26,20:00:00,235.26,126,9015,9141
2021/05/26,20:30:00,235.96,129,9041,9170
2021/05/26,21:00:00,235.24,127,8907,9034
2021/05/26,21:30:00,251.87,126,8726,8852
2021/05/26,22:00:00,235.52,124,8465,8589
2021/05/26,22:30:00,240.82,124,8250,8374
2021/05/26,23:00:00,246.84,125,7961,8086
2021/05/26,23:30:00,258.69,124,7731,7855
2021/05/27,00:00:00,187.86,123,7412,7535
2021/05/27,00:30:00,184.5,123,7154,7277
2021/05/27,01:00:00,184.16,123,6969,7092
2021/05/27,01:30:00,184.5,122,7038,7160
2021/05/27,02:00:00,184.42,128,6877,7005
2021/05/27,02:30:00,183.9,121,6753,6874
2021/05/27,03:00:00,184.24,72,6688,6760
2021/05/27,03:30:00,184.16,1,6726,6727
2021/05/27,04:00:00,184.16,2,6670,6672
2021/05/27,04:30:00,184.33,2,6687,6689
2021/05/27,05:00:00,184.24,2,6741,6743
2021/05/27,05:30:00,184.07,2,6762,6764
2021/05/27,06:00:00,184.5,2,6698,6700
2021/05/27,06:30:00,184.24,118,6858,6976
2021/05/27,07:00:00,184.42,296,7049,7345
2021/05/27,07:30:00,184.59,595,7179,7774
2021/05/27,08:00:00,183.9,988,7044,8032
2021/05/27,08:30:00,184.33,1229,7211,8440
2021/05/27,09:00:00,184.16,1412,7322,8734
2021/05/27,09:30:00,184.24,1590,7215,8805
2021/05/27,10:00:00,184.42,1716,7343,9059
2021/05/27,10:30:00,184.16,1844,7376,9220
2021/05/27,11:00:00,184.16,1908,7387,9295
2021/05/27,11:30:00,183.81,1982,7457,9439
2021/05/27,12:00:00,184.07,2012,7528,9540
2021/05/27,12:30:00,184.33,2015,7606,9621
2021/05/27,13:00:00,184.16,2028,7760,9788
2021/05/27,13:30:00,184.24,2026,7906,9932
2021/05/27,14:00:00,184.42,1999,8045,10044
2021/05/27,14:30:00,202.65,1950,8152,10102
2021/05/27,15:00:00,219.83,1872,8278,10150
2021/05/27,15:30:00,241.21,1779,8396,10175
2021/05/27,16:00:00,240.25,1627,8438,10065
2021/05/27,16:30:00,240.25,1494,8572,10066
2021/05/27,17:00:00,240.25,1171,8652,9823
2021/05/27,17:30:00,240.25,1012,8757,9769
2021/05/27,18:00:00,243.64,745,8904,9649
2021/05/27,18:30:00,243.71,527,8986,9513
2021/05/27,19:00:00,243.91,415,9016,9431
2021/05/27,19:30:00,244.05,133,8965,9098
2021/05/27,20:00:00,244.33,131,9152,9283
2021/05/27,20:30:00,244.46,128,9136,9264
2021/05/27,21:00:00,252.94,124,9010,9134
2021/05/27,21:30:00,244.6,124,8847,8971
2021/05/27,22:00:00,251.32,126,8588,8714
2021/05/27,22:30:00,252.74,125,8413,8538
2021/05/27,23:00:00,251.3,124,8159,8283
2021/05/27,23:30:00,251.29,123,7889,8012
2021/05/28,00:00:00,210.33,82,7659,7741
2021/05/28,00:30:00,241.21,7,7508,7515
2021/05/28,01:00:00,200.42,4,7292,7296
2021/05/28,01:30:00,184.33,2,7102,7104
2021/05/28,02:00:00,184.42,2,6934,6936
2021/05/28,02:30:00,184.33,1,6798,6799
2021/05/28,03:00:00,184.42,5,6715,6720
2021/05/28,03:30:00,184.42,2,6610,6612
2021/05/28,04:00:00,184.24,2,6560,6562
2021/05/28,04:30:00,183.47,2,6565,6567
2021/05/28,05:00:00,179.92,2,6560,6562
2021/05/28,05:30:00,180.08,2,6521,6523
2021/05/28,06:00:00,182.29,2,6408,6410
2021/05/28,06:30:00,183.99,152,6536,6688
2021/05/28,07:00:00,183.9,297,6609,6906
2021/05/28,07:30:00,184.16,649,6560,7209
2021/05/28,08:00:00,183.99,993,6630,7623
2021/05/28,08:30:00,184.24,1276,6727,8003
2021/05/28,09:00:00,184.42,1431,6772,8203
2021/05/28,09:30:00,184.16,1616,6822,8438
2021/05/28,10:00:00,184.16,1718,6829,8547
2021/05/28,10:30:00,183.9,1846,6935,8781
2021/05/28,11:00:00,184.07,1927,7008,8935
2021/05/28,11:30:00,183.99,1981,7066,9047
2021/05/28,12:00:00,183.99,2019,7052,9071
2021/05/28,12:30:00,184.07,2033,7165,9198
2021/05/28,13:00:00,183.56,2039,7262,9301
2021/05/28,13:30:00,183.56,2029,7336,9365
2021/05/28,14:00:00,184.07,1994,7193,9187
2021/05/28,14:30:00,184.16,1934,7283,9217
2021/05/28,15:00:00,184.16,1842,7198,9040
2021/05/28,15:30:00,184.16,1742,7277,9019
2021/05/28,16:00:00,184.16,1607,7406,9013
2021/05/28,16:30:00,187.36,1445,7515,8960
2021/05/28,17:00:00,187.36,1182,7660,8842
2021/05/28,17:30:00,187.36,922,7889,8811
2021/05/28,18:00:00,187.12,699,8099,8798
2021/05/28,18:30:00,215.85,439,8355,8794
2021/05/28,19:00:00,214.85,353,8443,8796
2021/05/28,19:30:00,215.62,130,8338,8468
2021/05/28,20:00:00,226.82,126,8502,8628
2021/05/28,20:30:00,228.01,131,8396,8527
2021/05/28,21:00:00,224.87,127,8223,8350
2021/05/28,21:30:00,226.03,124,8051,8175
2021/05/28,22:00:00,211.91,122,7898,8020
2021/05/28,22:30:00,225.59,124,7728,7852
2021/05/28,23:00:00,226.37,122,7573,7695
2021/05/28,23:30:00,225.98,122,7449,7571
2021/05/29,00:00:00,220.2,121,7265,7386
2021/05/29,00:30:00,184.07,118,7057,7175
2021/05/29,01:00:00,184.5,124,6882,7006
2021/05/29,01:30:00,184.42,125,6688,6813
2021/05/29,02:00:00,184.42,128,6568,6696
2021/05/29,02:30:00,184.16,11,6564,6575
2021/05/29,03:00:00,184.24,11,6491,6502
2021/05/29,03:30:00,184.5,9,6432,6441
2021/05/29,04:00:00,184.5,3,6423,6426
2021/05/29,04:30:00,184.16,4,6383,6387
2021/05/29,05:00:00,184.42,1,6373,6374
2021/05/29,05:30:00,184.16,1,6272,6273
2021/05/29,06:00:00,184.59,1,6253,6254
2021/05/29,06:30:00,183.39,126,6360,6486
2021/05/29,07:00:00,184.42,259,6252,6511
2021/05/29,07:30:00,184.16,471,6128,6599
2021/05/29,08:00:00,184.24,809,6071,6880
2021/05/29,08:30:00,184.24,1113,5944,7057
2021/05/29,09:00:00,184.16,1399,5872,7271
2021/05/29,09:30:00,184.33,1548,5816,7364
2021/05/29,10:00:00,184.33,1712,5874,7586
2021/05/29,10:30:00,184.59,1792,5873,7665
2021/05/29,11:00:00,184.24,1913,5885,7798
2021/05/29,11:30:00,184.42,1958,5931,7889
2021/05/29,12:00:00,184.42,2002,5922,7924
2021/05/29,12:30:00,184.16,2035,6036,8071
2021/05/29,13:00:00,184.33,2042,6117,8159
2021/05/29,13:30:00,183.99,2027,6214,8241
2021/05/29,14:00:00,184.42,2003,6281,8284
2021/05/29,14:30:00,184.42,1939,6325,8264
2021/05/29,15:00:00,184.42,1877,6432,8309
2021/05/29,15:30:00,184.16,1758,6566,8324
2021/05/29,16:00:00,184.07,1622,6648,8270
2021/05/29,16:30:00,184.24,1452,6781,8233
2021/05/29,17:00:00,184.16,1194,6822,8016
2021/05/29,17:30:00,184.5,955,7056,8011
2021/05/29,18:00:00,184.42,725,7304,8029
2021/05/29,18:30:00,184.42,499,7527,8026
2021/05/29,19:00:00,184.07,341,7683,8024
2021/05/29,19:30:00,198.97,126,7762,7888
2021/05/29,20:00:00,202.65,128,8087,8215
2021/05/29,20:30:00,202.65,126,8149,8275
2021/05/29,21:00:00,228.32,129,8120,8249
2021/05/29,21:30:00,225.71,128,8100,8228
2021/05/29,22:00:00,224.45,129,7986,8115
2021/05/29,22:30:00,202.65,126,7858,7984
2021/05/29,23:00:00,203.26,125,7658,7783
2021/05/29,23:30:00,202.65,123,7452,7575
2021/05/30,00:00:00,184.16,123,7180,7303
2021/05/30,00:30:00,184.42,122,6923,7045
2021/05/30,01:00:00,184.42,120,6732,6852
2021/05/30,01:30:00,184.42,88,6582,6670
2021/05/30,02:00:00,184.24,1,6481,6482
2021/05/30,02:30:00,184.5,1,6358,6359
2021/05/30,03:00:00,184.24,1,6427,6428
2021/05/30,03:30:00,184.42,1,6368,6369
2021/05/30,04:00:00,184.42,0,6367,6367
2021/05/30,04:30:00,184.42,0,6374,6374
2021/05/30,05:00:00,184.24,0,6444,6444
2021/05/30,05:30:00,184.24,0,6495,6495
2021/05/30,06:00:00,184.07,0,6552,6552
2021/05/30,06:30:00,184.24,168,6769,6937
2021/05/30,07:00:00,184.42,281,6998,7279
2021/05/30,07:30:00,184.24,534,7224,7758
2021/05/30,08:00:00,184.42,978,7121,8099
2021/05/30,08:30:00,203.23,1246,7225,8471
2021/05/30,09:00:00,184.16,1420,7314,8734
2021/05/30,09:30:00,184.16,1585,7176,8761
2021/05/30,10:00:00,183.99,1729,7169,8898
2021/05/30,10:30:00,184.24,1838,7087,8925
2021/05/30,11:00:00,183.81,1780,7210,8990
2021/05/30,11:30:00,184.33,1920,7200,9120
2021/05/30,12:00:00,183.81,1877,7332,9209
2021/05/30,12:30:00,183.9,1907,7369,9276
2021/05/30,13:00:00,183.9,1914,7488,9402
2021/05/30,13:30:00,184.16,1942,7664,9606
2021/05/30,14:00:00,184.07,1882,7874,9756
2021/05/30,14:30:00,186.1,1900,7901,9801
2021/05/30,15:00:00,184.16,1842,8002,9844
2021/05/30,15:30:00,184.42,1631,8220,9851
2021/05/30,16:00:00,184.07,1590,8150,9740
2021/05/30,16:30:00,184.33,1411,8319,9730
2021/05/30,17:00:00,184.24,1106,8479,9585
2021/05/30,17:30:00,187.12,895,8628,9523
2021/05/30,18:00:00,199.86,644,8710,9354
2021/05/30,18:30:00,199.34,453,8785,9238
2021/05/30,19:00:00,199.86,304,8755,9059
2021/05/30,19:30:00,199.86,115,8791,8906
2021/05/30,20:00:00,213.13,122,9020,9142
2021/05/30,20:30:00,223.19,118,9043,9161
2021/05/30,21:00:00,210.18,117,8938,9055
2021/05/30,21:30:00,204.56,122,8769,8891
2021/05/30,22:00:00,202.65,121,8567,8688
2021/05/30,22:30:00,202.65,121,8339,8460
2021/05/30,23:00:00,202.65,121,8070,8191
2021/05/30,23:30:00,202.07,122,7804,7926
2021/05/31,00:00:00,203.26,121,7510,7631
2021/05/31,00:30:00,193.54,122,7240,7362
2021/05/31,01:00:00,184.16,100,7031,7131
2021/05/31,01:30:00,193.54,0,6966,6966
2021/05/31,02:00:00,193.57,0,6788,6788
2021/05/31,02:30:00,193.09,0,6825,6825
2021/05/31,03:00:00,192.67,0,6713,6713
2021/05/31,03:30:00,193.54,0,6664,6664
2021/05/31,04:00:00,193.54,0,6840,6840
2021/05/31,04:30:00,194,1,6856,6857
2021/05/31,05:00:00,193.57,1,6909,6910
2021/05/31,05:30:00,193.62,1,6915,6916
2021/05/31,06:00:00,200.72,1,6879,6880
2021/05/31,06:30:00,219.77,96,7017,7113
2021/05/31,07:00:00,202.3,203,7301,7504
2021/05/31,07:30:00,193.81,432,7610,8042
2021/05/31,08:00:00,184.16,587,7730,8317
2021/05/31,08:30:00,184.24,964,8048,9012
2021/05/31,09:00:00,183.9,1181,8240,9421
2021/05/31,09:30:00,197.83,1423,8423,9846
2021/05/31,10:00:00,197.83,1584,8579,10163
2021/05/31,10:30:00,198.39,1717,8678,10395
2021/05/31,11:00:00,228.17,1800,8566,10366
2021/05/31,11:30:00,221.21,1871,8765,10636
2021/05/31,12:00:00,234.89,1919,8962,10881
2021/05/31,12:30:00,235.29,1944,8963,10907
2021/05/31,13:00:00,236.46,1950,9075,11025
2021/05/31,13:30:00,234.9,1952,9181,11133
2021/05/31,14:00:00,234.07,1830,9437,11267
2021/05/31,14:30:00,232.11,1779,9619,11398
2021/05/31,15:00:00,234.58,1659,9679,11338
2021/05/31,15:30:00,234.47,1593,9794,11387
2021/05/31,16:00:00,230.25,1461,9772,11233
2021/05/31,16:30:00,234.32,1297,9911,11208
2021/05/31,17:00:00,234.47,1063,9966,11029
2021/05/31,17:30:00,229.42,836,10043,10879
2021/05/31,18:00:00,233.4,622,10105,10727
2021/05/31,18:30:00,244.73,396,10062,10458
2021/05/31,19:00:00,228.66,294,9962,10256
2021/05/31,19:30:00,227.9,128,9824,9952
2021/05/31,20:00:00,227.18,78,9951,10029
2021/05/31,20:30:00,227.84,14,10050,10064
2021/05/31,21:00:00,227.59,13,9868,9881
2021/05/31,21:30:00,224.67,4,9521,9525
2021/05/31,22:00:00,225.19,2,9325,9327
2021/05/31,22:30:00,224.03,3,9044,9047
2021/05/31,23:00:00,212.25,4,8764,8768
2021/05/31,23:30:00,212.94,6,8459,8465
2021/06/01,00:00:00,229.75,7,8154,8161
2021/06/01,00:30:00,245.55,7,7865,7872
2021/06/01,01:00:00,245.55,7,7639,7646
2021/06/01,01:30:00,231.05,7,7459,7466
2021/06/01,02:00:00,244.23,7,7268,7275
2021/06/01,02:30:00,244.85,6,7115,7121
2021/06/01,03:00:00,244.85,6,7020,7026
2021/06/01,03:30:00,244.85,5,7077,7082
2021/06/01,04:00:00,245.55,3,7068,7071
2021/06/01,04:30:00,244.85,2,7099,7101
2021/06/01,05:00:00,244.85,3,7132,7135
2021/06/01,05:30:00,244.85,4,7107,7111
2021/06/01,06:00:00,244.23,2,6995,6997
2021/06/01,06:30:00,243.68,112,7372,7484
2021/06/01,07:00:00,244.86,234,7573,7807
2021/06/01,07:30:00,231.08,453,7856,8309
2021/06/01,08:00:00,244.28,683,7934,8617
2021/06/01,08:30:00,245.55,1000,8013,9013
2021/06/01,09:00:00,243.7,1260,8012,9272
2021/06/01,09:30:00,244.87,1458,7980,9438
2021/06/01,10:00:00,244.28,1663,7961,9624
2021/06/01,10:30:00,245.55,1755,7985,9740
2021/06/01,11:00:00,244.87,1868,7975,9843
2021/06/01,11:30:00,246.93,1921,8041,9962
2021/06/01,12:00:00,244.87,1981,8112,10093
2021/06/01,12:30:00,245.55,2002,8194,10196
2021/06/01,13:00:00,241.1,2010,8148,10158
2021/06/01,13:30:00,240.76,2007,8264,10271
2021/06/01,14:00:00,198.1,1971,8435,10406
2021/06/01,14:30:00,198.76,1912,8593,10505
2021/06/01,15:00:00,198.76,1852,8698,10550
2021/06/01,15:30:00,199.46,1718,8635,10353
2021/06/01,16:00:00,220.2,1603,8650,10253
2021/06/01,16:30:00,186.21,1413,8745,10158
2021/06/01,17:00:00,186.21,1131,8826,9957
2021/06/01,17:30:00,199.83,901,8882,9783
2021/06/01,18:00:00,200.36,691,9022,9713
2021/06/01,18:30:00,199.83,466,9059,9525
2021/06/01,19:00:00,200.36,313,9059,9372
2021/06/01,19:30:00,199.44,122,8992,9114
2021/06/01,20:00:00,215.04,123,9246,9369
2021/06/01,20:30:00,213.89,128,9338,9466
2021/06/01,21:00:00,203.98,128,9202,9330
2021/06/01,21:30:00,199.83,132,9061,9193
2021/06/01,22:00:00,200.36,131,8794,8925
2021/06/01,22:30:00,200.36,126,8575,8701
2021/06/01,23:00:00,201.51,124,8275,8399
2021/06/01,23:30:00,200.36,84,8061,8145
2021/06/02,00:00:00,200.36,2,7842,7844
2021/06/02,00:30:00,199.98,2,7632,7634
2021/06/02,01:00:00,190.05,1,7402,7403
2021/06/02,01:30:00,179.1,1,7225,7226
2021/06/02,02:00:00,179.52,0,7037,7037
2021/06/02,02:30:00,179.43,1,6904,6905
2021/06/02,03:00:00,179.52,1,6812,6813
2021/06/02,03:30:00,179.52,1,6736,6737
2021/06/02,04:00:00,179.43,1,6759,6760
2021/06/02,04:30:00,179.6,0,6724,6724
2021/06/02,05:00:00,179.52,0,6801,6801
2021/06/02,05:30:00,179.27,0,6819,6819
2021/06/02,06:00:00,179.77,0,6757,6757
2021/06/02,06:30:00,179.77,117,7105,7222
2021/06/02,07:00:00,179.77,296,7282,7578
2021/06/02,07:30:00,179.94,478,7478,7956
2021/06/02,08:00:00,180.02,858,7454,8312
2021/06/02,08:30:00,179.94,972,7690,8662
2021/06/02,09:00:00,179.68,1314,7557,8871
2021/06/02,09:30:00,179.68,1435,7652,9087
2021/06/02,10:00:00,180.1,1675,7559,9234
2021/06/02,10:30:00,179.6,1734,7553,9287
2021/06/02,11:00:00,179.43,1752,7692,9444
2021/06/02,11:30:00,179.43,1846,7799,9645
2021/06/02,12:00:00,179.68,1969,7688,9657
2021/06/02,12:30:00,180.02,2057,7711,9768
2021/06/02,13:00:00,180.19,2055,7799,9854
2021/06/02,13:30:00,179.6,2042,7910,9952
2021/06/02,14:00:00,179.52,2024,8004,10028
2021/06/02,14:30:00,179.27,1974,7990,9964
2021/06/02,15:00:00,179.94,1902,7908,9810
2021/06/02,15:30:00,179.68,1800,8007,9807
2021/06/02,16:00:00,179.77,1654,8020,9674
2021/06/02,16:30:00,181.17,1511,8093,9604
2021/06/02,17:00:00,179.87,1197,8156,9353
2021/06/02,17:30:00,179.52,998,8254,9252
2021/06/02,18:00:00,179.43,759,8407,9166
2021/06/02,18:30:00,180.53,539,8519,9058
2021/06/02,19:00:00,180.53,463,8543,9006
2021/06/02,19:30:00,179.87,119,8593,8712
2021/06/02,20:00:00,189.63,114,8842,8956
2021/06/02,20:30:00,200.92,126,8873,8999
2021/06/02,21:00:00,200.36,131,8766,8897
2021/06/02,21:30:00,200.92,131,8537,8668
2021/06/02,22:00:00,200.36,129,8370,8499
2021/06/02,22:30:00,200.36,126,8108,8234
2021/06/02,23:00:00,200.92,126,7886,8012
2021/06/02,23:30:00,200.92,128,7616,7744
2021/06/03,00:00:00,201.51,129,7342,7471
2021/06/03,00:30:00,200.36,127,7101,7228
2021/06/03,01:00:00,179.6,128,6855,6983
2021/06/03,01:30:00,179.43,123,6740,6863
2021/06/03,02:00:00,179.52,78,6586,6664
2021/06/03,02:30:00,179.68,1,6526,6527
2021/06/03,03:00:00,179.43,1,6494,6495
2021/06/03,03:30:00,179.68,1,6454,6455
2021/06/03,04:00:00,179.68,1,6382,6383
2021/06/03,04:30:00,179.52,0,6424,6424
2021/06/03,05:00:00,179.85,0,6423,6423
2021/06/03,05:30:00,179.35,0,6476,6476
2021/06/03,06:00:00,179.68,0,6441,6441
2021/06/03,06:30:00,179.68,111,6549,6660
2021/06/03,07:00:00,179.68,263,6788,7051
2021/06/03,07:30:00,179.52,616,7034,7650
2021/06/03,08:00:00,179.77,988,7065,8053
2021/06/03,08:30:00,179.77,1239,7187,8426
2021/06/03,09:00:00,179.77,1463,7192,8655
2021/06/03,09:30:00,179.77,1627,7277,8904
2021/06/03,10:00:00,179.77,1788,7151,8939
2021/06/03,10:30:00,179.6,1885,7171,9056
2021/06/03,11:00:00,179.6,1985,7144,9129
2021/06/03,11:30:00,179.94,2039,7170,9209
2021/06/03,12:00:00,179.94,2073,7179,9252
2021/06/03,12:30:00,179.85,2086,7215,9301
2021/06/03,13:00:00,179.77,2090,7266,9356
2021/06/03,13:30:00,179.6,2067,7362,9429
2021/06/03,14:00:00,179.85,2023,7413,9436
2021/06/03,14:30:00,180.02,1974,7372,9346
2021/06/03,15:00:00,179.77,1920,7444,9364
2021/06/03,15:30:00,179.94,1789,7503,9292
2021/06/03,16:00:00,180.1,1665,7396,9061
2021/06/03,16:30:00,180.53,1501,7485,8986
2021/06/03,17:00:00,181.17,1189,7568,8757
2021/06/03,17:30:00,180.53,969,7745,8714
2021/06/03,18:00:00,180.53,741,7934,8675
2021/06/03,18:30:00,180.53,518,8102,8620
2021/06/03,19:00:00,179.77,373,8179,8552
2021/06/03,19:30:00,179.35,109,8243,8352
2021/06/03,20:00:00,180.36,127,8512,8639
2021/06/03,20:30:00,199.76,134,8591,8725
2021/06/03,21:00:00,200.35,132,8455,8587
2021/06/03,21:30:00,200.35,131,8313,8444
2021/06/03,22:00:00,202.28,129,8130,8259
2021/06/03,22:30:00,200.97,129,7864,7993
2021/06/03,23:00:00,180.53,130,7675,7805
2021/06/03,23:30:00,180.02,128,7445,7573
2021/06/04,00:00:00,179.85,124,7178,7302
2021/06/04,00:30:00,179.6,124,7016,7140
2021/06/04,01:00:00,180.02,123,6805,6928
2021/06/04,01:30:00,209.63,126,6644,6770
2021/06/04,02:00:00,179.6,77,6535,6612
2021/06/04,02:30:00,179.77,8,6448,6456
2021/06/04,03:00:00,179.77,6,6374,6380
2021/06/04,03:30:00,179.52,3,6326,6329
2021/06/04,04:00:00,179.94,4,6247,6251
2021/06/04,04:30:00,179.77,5,6279,6284
2021/06/04,05:00:00,180.1,3,6302,6305
2021/06/04,05:30:00,179.77,0,6290,6290
2021/06/04,06:00:00,179.68,0,6157,6157
2021/06/04,06:30:00,179.68,126,6332,6458
2021/06/04,07:00:00,179.52,265,6369,6634
2021/06/04,07:30:00,179.94,493,6538,7031
2021/06/04,08:00:00,179.77,799,6446,7245
2021/06/04,08:30:00,180.02,1151,6438,7589
2021/06/04,09:00:00,180.02,1394,6380,7774
2021/06/04,09:30:00,179.6,1587,6389,7976
2021/06/04,10:00:00,179.6,1736,6341,8077
2021/06/04,10:30:00,179.77,1902,6329,8231
2021/06/04,11:00:00,179.85,1958,6347,8305
2021/06/04,11:30:00,179.6,2020,6369,8389
2021/06/04,12:00:00,179.94,2061,6350,8411
2021/06/04,12:30:00,179.77,2085,6369,8454
2021/06/04,13:00:00,179.85,2084,6375,8459
2021/06/04,13:30:00,179.85,2068,6367,8435
2021/06/04,14:00:00,179.77,2031,6391,8422
2021/06/04,14:30:00,179.35,1995,6240,8235
2021/06/04,15:00:00,180.02,1908,6291,8199
2021/06/04,15:30:00,180.02,1807,6312,8119
2021/06/04,16:00:00,179.6,1661,6287,7948
2021/06/04,16:30:00,180.53,1537,6432,7969
2021/06/04,17:00:00,180.53,1238,6646,7884
2021/06/04,17:30:00,229.03,1015,6914,7929
2021/06/04,18:00:00,226.75,777,7272,8049
2021/06/04,18:30:00,227.86,525,7579,8104
2021/06/04,19:00:00,232.29,450,7773,8223
2021/06/04,19:30:00,234.9,133,7735,7868
2021/06/04,20:00:00,252.63,123,7968,8091
2021/06/04,20:30:00,251.32,131,7907,8038
2021/06/04,21:00:00,251.32,132,7755,7887
2021/06/04,21:30:00,250.42,129,7643,7772
2021/06/04,22:00:00,179.94,128,7448,7576
2021/06/04,22:30:00,181.17,132,7353,7485
2021/06/04,23:00:00,179.6,130,7227,7357
2021/06/04,23:30:00,179.68,131,6999,7130
2021/06/05,00:00:00,179.6,127,6914,7041
2021/06/05,00:30:00,179.94,126,6689,6815
2021/06/05,01:00:00,179.77,124,6572,6696
2021/06/05,01:30:00,179.68,125,6416,6541
2021/06/05,02:00:00,179.52,73,6367,6440
2021/06/05,02:30:00,179.77,6,6306,6312
2021/06/05,03:00:00,179.68,4,6272,6276
2021/06/05,03:30:00,179.68,5,6193,6198
2021/06/05,04:00:00,179.77,3,6161,6164
2021/06/05,04:30:00,179.94,2,6153,6155
2021/06/05,05:00:00,179.43,1,6099,6100
2021/06/05,05:30:00,179.85,1,6008,6009
2021/06/05,06:00:00,180.02,2,5916,5918
2021/06/05,06:30:00,179.77,145,5803,5948
2021/06/05,07:00:00,179.43,288,5749,6037
2021/06/05,07:30:00,179.52,576,5735,6311
2021/06/05,08:00:00,179.43,999,5672,6671
2021/06/05,08:30:00,179.94,1169,5596,6765
2021/06/05,09:00:00,179.68,1429,5504,6933
2021/06/05,09:30:00,179.77,1634,5439,7073
2021/06/05,10:00:00,179.94,1741,5469,7210
2021/06/05,10:30:00,179.94,1867,5467,7334
2021/06/05,11:00:00,179.77,1976,5433,7409
2021/06/05,11:30:00,179.77,2028,5454,7482
2021/06/05,12:00:00,179.6,2061,5460,7521
2021/06/05,12:30:00,179.52,2098,5343,7441
2021/06/05,13:00:00,179.43,2093,5390,7483
2021/06/05,13:30:00,179.68,2076,5437,7513
2021/06/05,14:00:00,179.68,2064,5447,7511
2021/06/05,14:30:00,179.43,2004,5581,7585
2021/06/05,15:00:00,180.1,1943,5516,7459
2021/06/05,15:30:00,179.68,1821,5687,7508
2021/06/05,16:00:00,180.1,1706,5833,7539
2021/06/05,16:30:00,179.68,1523,6077,7600
2021/06/05,17:00:00,179.77,1224,6302,7526
2021/06/05,17:30:00,179.68,1066,6566,7632
2021/06/05,18:00:00,179.77,793,6841,7634
2021/06/05,18:30:00,179.68,581,7134,7715
2021/06/05,19:00:00,179.27,348,7342,7690
2021/06/05,19:30:00,179.68,129,7533,7662
2021/06/05,20:00:00,179.68,125,7902,8027
2021/06/05,20:30:00,199.21,134,7985,8119
2021/06/05,21:00:00,198.17,132,7997,8129
2021/06/05,21:30:00,198.67,132,7981,8113
2021/06/05,22:00:00,199.21,126,7851,7977
2021/06/05,22:30:00,199.21,130,7740,7870
2021/06/05,23:00:00,199.76,131,7496,7627
2021/06/05,23:30:00,199.21,123,7325,7448
2021/06/06,00:00:00,198.67,126,7061,7187
2021/06/06,00:30:00,201.61,131,6830,6961
2021/06/06,01:00:00,179.6,131,6612,6743
2021/06/06,01:30:00,179.68,133,6575,6708
2021/06/06,02:00:00,179.6,132,6434,6566
2021/06/06,02:30:00,180.02,94,6467,6561
2021/06/06,03:00:00,179.6,8,6461,6469
2021/06/06,03:30:00,179.6,6,6362,6368
2021/06/06,04:00:00,179.52,5,6400,6405
2021/06/06,04:30:00,179.77,7,6391,6398
2021/06/06,05:00:00,179.77,5,6501,6506
2021/06/06,05:30:00,179.77,6,6525,6531
2021/06/06,06:00:00,179.68,4,6514,6518
2021/06/06,06:30:00,179.6,167,6692,6859
2021/06/06,07:00:00,179.6,300,6943,7243
2021/06/06,07:30:00,179.6,574,7009,7583
2021/06/06,08:00:00,179.77,904,6895,7799
2021/06/06,08:30:00,179.85,1249,6873,8122
2021/06/06,09:00:00,179.85,1431,6891,8322
2021/06/06,09:30:00,179.68,1636,6915,8551
2021/06/06,10:00:00,179.68,1753,6930,8683
2021/06/06,10:30:00,179.94,1884,6930,8814
2021/06/06,11:00:00,179.77,1982,6958,8940
2021/06/06,11:30:00,179.94,2033,6984,9017
2021/06/06,12:00:00,180.02,2070,6959,9029
2021/06/06,12:30:00,180.02,2084,7012,9096
2021/06/06,13:00:00,179.85,2085,7094,9179
2021/06/06,13:30:00,179.77,2077,7201,9278
2021/06/06,14:00:00,179.94,2050,7321,9371
2021/06/06,14:30:00,179.77,2011,7445,9456
2021/06/06,15:00:00,179.77,1934,7568,9502
2021/06/06,15:30:00,179.94,1830,7631,9461
2021/06/06,16:00:00,179.94,1705,7702,9407
2021/06/06,16:30:00,185.59,1522,7820,9342
2021/06/06,17:00:00,185.59,1271,7910,9181
2021/06/06,17:30:00,180.84,1050,8046,9096
2021/06/06,18:00:00,180.2,820,8211,9031
2021/06/06,18:30:00,199.83,574,8393,8967
2021/06/06,19:00:00,200.36,500,8499,8999
2021/06/06,19:30:00,211.02,125,8537,8662
2021/06/06,20:00:00,219.48,135,8736,8871
2021/06/06,20:30:00,219.64,134,8839,8973
2021/06/06,21:00:00,219.57,132,8743,8875
2021/06/06,21:30:00,205.11,130,8565,8695
2021/06/06,22:00:00,200.36,129,8319,8448
2021/06/06,22:30:00,200.41,128,8072,8200
2021/06/06,23:00:00,200.36,127,7821,7948
2021/06/06,23:30:00,198.38,127,7522,7649
2021/06/07,00:00:00,201.12,128,7262,7390
2021/06/07,00:30:00,205.26,128,7016,7144
2021/06/07,01:00:00,179.52,124,6779,6903
2021/06/07,01:30:00,179.68,125,6760,6885
2021/06/07,02:00:00,179.6,109,6762,6871
2021/06/07,02:30:00,179.77,6,6748,6754
2021/06/07,03:00:00,179.6,5,6691,6696
2021/06/07,03:30:00,179.68,4,6639,6643
2021/06/07,04:00:00,179.85,3,6631,6634
2021/06/07,04:30:00,179.68,3,6674,6677
2021/06/07,05:00:00,179.77,3,6717,6720
2021/06/07,05:30:00,179.94,2,6718,6720
2021/06/07,06:00:00,179.77,0,6713,6713
2021/06/07,06:30:00,179.52,144,6884,7028
2021/06/07,07:00:00,179.6,316,7086,7402
2021/06/07,07:30:00,179.77,528,7247,7775
2021/06/07,08:00:00,179.77,956,7138,8094
2021/06/07,08:30:00,179.35,1186,7271,8457
2021/06/07,09:00:00,179.52,1400,7254,8654
2021/06/07,09:30:00,179.35,1635,6999,8634
2021/06/07,10:00:00,176.49,1759,7015,8774
2021/06/07,10:30:00,179.68,1860,6988,8848
2021/06/07,11:00:00,179.68,1931,7002,8933
2021/06/07,11:30:00,179.77,2008,6991,8999
2021/06/07,12:00:00,175.7,2031,7067,9098
2021/06/07,12:30:00,170.46,2061,7149,9210
2021/06/07,13:00:00,170.91,2060,7253,9313
2021/06/07,13:30:00,170.71,2050,7382,9432
2021/06/07,14:00:00,170.65,2020,7524,9544
2021/06/07,14:30:00,169.85,1981,7700,9681
2021/06/07,15:00:00,170.21,1905,7767,9672
2021/06/07,15:30:00,170.03,1819,7868,9687
2021/06/07,16:00:00,170.21,1676,7872,9548
2021/06/07,16:30:00,216.1,1532,7940,9472
2021/06/07,17:00:00,216.44,1272,7996,9268
2021/06/07,17:30:00,216.1,1023,8103,9126
2021/06/07,18:00:00,215.76,785,8247,9032
2021/06/07,18:30:00,252.47,561,8421,8982
2021/06/07,19:00:00,250.64,453,8476,8929
2021/06/07,19:30:00,250.64,132,8519,8651
2021/06/07,20:00:00,237.84,132,8738,8870
2021/06/07,20:30:00,237.84,128,8851,8979
2021/06/07,21:00:00,215.76,128,8749,8877
2021/06/07,21:30:00,216.44,127,8536,8663
2021/06/07,22:00:00,200.36,128,8331,8459
2021/06/07,22:30:00,201.74,126,8114,8240
2021/06/07,23:00:00,202.77,124,7889,8013
2021/06/07,23:30:00,203.05,122,7594,7716
2021/06/08,00:00:00,203.05,121,7317,7438
2021/06/08,00:30:00,204.49,122,7091,7213
2021/06/08,01:00:00,203.44,122,6848,6970
2021/06/08,01:30:00,179.85,123,6675,6798
2021/06/08,02:00:00,179.94,113,6526,6639
2021/06/08,02:30:00,179.77,66,6466,6532
2021/06/08,03:00:00,180.02,5,6581,6586
2021/06/08,03:30:00,179.85,6,6558,6564
2021/06/08,04:00:00,180.02,4,6535,6539
2021/06/08,04:30:00,179.68,3,6536,6539
2021/06/08,05:00:00,179.94,1,6593,6594
2021/06/08,05:30:00,180.1,1,6611,6612
2021/06/08,06:00:00,179.85,1,6644,6645
2021/06/08,06:30:00,179.43,118,6810,6928
2021/06/08,07:00:00,179.6,278,6984,7262
2021/06/08,07:30:00,179.52,517,7164,7681
2021/06/08,08:00:00,179.85,778,7231,8009
2021/06/08,08:30:00,179.6,1162,7345,8507
2021/06/08,09:00:00,179.52,1430,7265,8695
2021/06/08,09:30:00,179.43,1579,7318,8897
2021/06/08,10:00:00,179.6,1768,7310,9078
2021/06/08,10:30:00,179.68,1824,7280,9104
2021/06/08,11:00:00,179.94,1928,7252,9180
2021/06/08,11:30:00,179.43,1969,7292,9261
2021/06/08,12:00:00,179.1,2015,7283,9298
2021/06/08,12:30:00,179.35,2044,7344,9388
2021/06/08,13:00:00,179.35,2004,7426,9430
2021/06/08,13:30:00,179.6,2019,7488,9507
2021/06/08,14:00:00,179.27,2033,7622,9655
2021/06/08,14:30:00,179.1,1912,7769,9681
2021/06/08,15:00:00,179.94,1764,7685,9449
2021/06/08,15:30:00,180.43,1681,7754,9435
2021/06/08,16:00:00,202.12,1583,7812,9395
2021/06/08,16:30:00,202.77,1518,7781,9299
2021/06/08,17:00:00,199.32,1251,7913,9164
2021/06/08,17:30:00,202.12,1026,8031,9057
2021/06/08,18:00:00,202.77,777,8257,9034
2021/06/08,18:30:00,199.83,561,8368,8929
2021/06/08,19:00:00,200.92,425,8456,8881
2021/06/08,19:30:00,201.51,126,8483,8609
2021/06/08,20:00:00,199.83,134,8739,8873
2021/06/08,20:30:00,200.36,135,8852,8987
2021/06/08,21:00:00,200.36,136,8783,8919
2021/06/08,21:30:00,201.12,137,8616,8753
2021/06/08,22:00:00,200.54,137,8402,8539
2021/06/08,22:30:00,199.98,135,8196,8331
2021/06/08,23:00:00,201.12,133,7951,8084
2021/06/08,23:30:00,201.12,133,7643,7776
2021/06/09,00:00:00,179.77,115,7376,7491
2021/06/09,00:30:00,179.68,45,7180,7225
2021/06/09,01:00:00,179.94,12,6995,7007
2021/06/09,01:30:00,180.02,13,6817,6830
2021/06/09,02:00:00,179.94,9,6664,6673
2021/06/09,02:30:00,179.6,11,6718,6729
2021/06/09,03:00:00,179.77,10,6646,6656
2021/06/09,03:30:00,179.52,10,6599,6609
2021/06/09,04:00:00,179.68,5,6564,6569
2021/06/09,04:30:00,179.85,5,6564,6569
2021/06/09,05:00:00,179.68,4,6618,6622
2021/06/09,05:30:00,179.85,3,6634,6637
2021/06/09,06:00:00,179.77,3,6564,6567
2021/06/09,06:30:00,179.77,136,6765,6901
2021/06/09,07:00:00,180.1,277,7055,7332
2021/06/09,07:30:00,179.77,585,7224,7809
2021/06/09,08:00:00,179.85,904,7233,8137
2021/06/09,08:30:00,179.77,1193,7369,8562
2021/06/09,09:00:00,179.68,1397,7450,8847
2021/06/09,09:30:00,179.43,1579,7566,9145
2021/06/09,10:00:00,179.43,1676,7428,9104
2021/06/09,10:30:00,179.35,1809,7345,9154
2021/06/09,11:00:00,179.85,1879,7410,9289
2021/06/09,11:30:00,180.1,1945,7771,9716
2021/06/09,12:00:00,179.6,1981,7899,9880
2021/06/09,12:30:00,179.6,1991,7988,9979
2021/06/09,13:00:00,179.35,1998,8177,10175
2021/06/09,13:30:00,196.02,1973,8196,10169
2021/06/09,14:00:00,196.35,1938,8455,10393
2021/06/09,14:30:00,196.35,1895,8582,10477
2021/06/09,15:00:00,199.32,1808,8709,10517
2021/06/09,15:30:00,199.83,1721,8795,10516
2021/06/09,16:00:00,214.73,1579,8833,10412
2021/06/09,16:30:00,246.8,1438,8932,10370
2021/06/09,17:00:00,231.34,1168,8995,10163
2021/06/09,17:30:00,231.04,936,9154,10090
2021/06/09,18:00:00,252.78,677,9212,9889
2021/06/09,18:30:00,240.97,436,9275,9711
2021/06/09,19:00:00,242.01,338,9284,9622
2021/06/09,19:30:00,240.46,127,9220,9347
2021/06/09,20:00:00,240.96,126,9420,9546
2021/06/09,20:30:00,240.46,124,9534,9658
2021/06/09,21:00:00,240.46,124,9423,9547
2021/06/09,21:30:00,239.83,124,9293,9417
2021/06/09,22:00:00,231.63,123,9045,9168
2021/06/09,22:30:00,215.8,121,8794,8915
2021/06/09,23:00:00,203.26,121,8498,8619
2021/06/09,23:30:00,203.77,106,8222,8328
2021/06/10,00:00:00,199.83,46,8011,8057
2021/06/10,00:30:00,202.12,0,7736,7736
2021/06/10,01:00:00,202.12,1,7491,7492
2021/06/10,01:30:00,202.12,0,7316,7316
2021/06/10,02:00:00,191.18,0,7141,7141
2021/06/10,02:30:00,181.93,0,7025,7025
2021/06/10,03:00:00,181.93,0,6901,6901
2021/06/10,03:30:00,181.93,0,6977,6977
2021/06/10,04:00:00,181.93,0,6955,6955
2021/06/10,04:30:00,181.63,0,6952,6952
2021/06/10,05:00:00,181.93,0,6982,6982
2021/06/10,05:30:00,182.24,0,6982,6982
2021/06/10,06:00:00,181.93,0,6930,6930
2021/06/10,06:30:00,181.8,124,7136,7260
2021/06/10,07:00:00,181.93,246,7339,7585
2021/06/10,07:30:00,181.93,490,7549,8039
2021/06/10,08:00:00,220,813,7814,8627
2021/06/10,08:30:00,220,1079,7983,9062
2021/06/10,09:00:00,220,1350,8054,9404
2021/06/10,09:30:00,220,1502,8236,9738
2021/06/10,10:00:00,220,1666,8297,9963
2021/06/10,10:30:00,220,1764,8332,10096
2021/06/10,11:00:00,220,1854,8420,10274
2021/06/10,11:30:00,220,1920,8528,10448
2021/06/10,12:00:00,220,1975,8506,10481
2021/06/10,12:30:00,220,1996,8631,10627
2021/06/10,13:00:00,220,1985,8735,10720
2021/06/10,13:30:00,220,1963,8824,10787
2021/06/10,14:00:00,220,1938,8814,10752
2021/06/10,14:30:00,220,1891,8733,10624
2021/06/10,15:00:00,220,1828,8792,10620
2021/06/10,15:30:00,220,1727,8767,10494
2021/06/10,16:00:00,220,1601,8758,10359
2021/06/10,16:30:00,228.74,1455,8757,10212
2021/06/10,17:00:00,228.17,1162,8844,10006
2021/06/10,17:30:00,228.25,1005,9013,10018
2021/06/10,18:00:00,228.1,699,9130,9829
2021/06/10,18:30:00,228.19,513,9156,9669
2021/06/10,19:00:00,227.81,314,9146,9460
2021/06/10,19:30:00,245.5,135,9079,9214
2021/06/10,20:00:00,228.12,136,9238,9374
2021/06/10,20:30:00,238.05,133,9311,9444
2021/06/10,21:00:00,227.37,133,9163,9296
2021/06/10,21:30:00,227.3,135,8960,9095
2021/06/10,22:00:00,220,134,8743,8877
2021/06/10,22:30:00,200.36,131,8487,8618
2021/06/10,23:00:00,200.92,66,8347,8413
2021/06/10,23:30:00,199.85,8,8143,8151
2021/06/11,00:00:00,221.63,7,7912,7919
2021/06/11,00:30:00,223.9,6,7678,7684
2021/06/11,01:00:00,201.12,5,7485,7490
2021/06/11,01:30:00,200.54,7,7251,7258
2021/06/11,02:00:00,201.12,6,7108,7114
2021/06/11,02:30:00,200.99,4,6956,6960
2021/06/11,03:00:00,181.93,4,6830,6834
2021/06/11,03:30:00,182.24,3,6945,6948
2021/06/11,04:00:00,181.93,2,6891,6893
2021/06/11,04:30:00,181.63,4,6864,6868
2021/06/11,05:00:00,181.93,3,6866,6869
2021/06/11,05:30:00,181.93,3,6833,6836
2021/06/11,06:00:00,181.93,1,6706,6707
2021/06/11,06:30:00,182.24,119,6900,7019
2021/06/11,07:00:00,182.24,260,6917,7177
2021/06/11,07:30:00,181.93,483,7061,7544
2021/06/11,08:00:00,182.24,764,7100,7864
2021/06/11,08:30:00,181.93,1075,7121,8196
2021/06/11,09:00:00,182.24,1291,7065,8356
2021/06/11,09:30:00,182.24,1472,7166,8638
2021/06/11,10:00:00,181.93,1610,7146,8756
2021/06/11,10:30:00,181.93,1772,7097,8869
2021/06/11,11:00:00,182.24,1842,7163,9005
2021/06/11,11:30:00,182.24,1929,7166,9095
2021/06/11,12:00:00,182.24,1981,7108,9089
2021/06/11,12:30:00,181.93,2001,7212,9213
2021/06/11,13:00:00,181.93,1983,7280,9263
2021/06/11,13:30:00,181.93,1985,7304,9289
2021/06/11,14:00:00,181.93,1975,7208,9183
2021/06/11,14:30:00,181.63,1928,7246,9174
2021/06/11,15:00:00,182.56,1839,7150,8989
2021/06/11,15:30:00,181.93,1736,7188,8924
2021/06/11,16:00:00,181.32,1591,7324,8915
2021/06/11,16:30:00,182.56,1423,7473,8896
2021/06/11,17:00:00,183.2,1172,7607,8779
2021/06/11,17:30:00,182.24,917,7898,8815
2021/06/11,18:00:00,182.88,715,8192,8907
2021/06/11,18:30:00,182.56,442,8442,8884
2021/06/11,19:00:00,181.93,336,8502,8838
2021/06/11,19:30:00,226.25,130,8454,8584
2021/06/11,20:00:00,228.66,127,8596,8723
2021/06/11,20:30:00,225.23,129,8554,8683
2021/06/11,21:00:00,228.44,128,8370,8498
2021/06/11,21:30:00,232.2,124,8215,8339
2021/06/11,22:00:00,253.19,121,8019,8140
2021/06/11,22:30:00,226.68,122,7916,8038
2021/06/11,23:00:00,226.4,86,7788,7874
2021/06/11,23:30:00,225.91,40,7652,7692
2021/06/12,00:00:00,179.94,8,7519,7527
2021/06/12,00:30:00,179.6,7,7331,7338
2021/06/12,01:00:00,172.52,4,7124,7128
2021/06/12,01:30:00,171.96,4,6986,6990
2021/06/12,02:00:00,172.66,3,6870,6873
2021/06/12,02:30:00,172.59,2,6897,6899
2021/06/12,03:00:00,171.9,2,6807,6809
2021/06/12,03:30:00,175.39,1,6762,6763
2021/06/12,04:00:00,176.97,1,6712,6713
2021/06/12,04:30:00,176.1,1,6710,6711
2021/06/12,05:00:00,176.02,2,6695,6697
2021/06/12,05:30:00,176.25,1,6563,6564
2021/06/12,06:00:00,176.02,0,6446,6446
2021/06/12,06:30:00,176.25,119,6409,6528
2021/06/12,07:00:00,175.86,272,6307,6579
2021/06/12,07:30:00,175.32,499,6207,6706
2021/06/12,08:00:00,175.63,861,6053,6914
2021/06/12,08:30:00,172.94,1137,5981,7118
2021/06/12,09:00:00,172.45,1400,5958,7358
2021/06/12,09:30:00,172.03,1554,6029,7583
2021/06/12,10:00:00,172.1,1688,6053,7741
2021/06/12,10:30:00,172.1,1801,6115,7916
2021/06/12,11:00:00,171.56,1878,6210,8088
2021/06/12,11:30:00,171.9,1944,6299,8243
2021/06/12,12:00:00,171.9,1974,6298,8272
2021/06/12,12:30:00,172.66,2004,6443,8447
2021/06/12,13:00:00,172.1,2007,6602,8609
2021/06/12,13:30:00,172.03,2002,6821,8823
2021/06/12,14:00:00,171.23,1978,6851,8829
2021/06/12,14:30:00,171.83,1932,6954,8886
2021/06/12,15:00:00,172.45,1819,6940,8759
2021/06/12,15:30:00,171.63,1723,6951,8674
2021/06/12,16:00:00,171.9,1579,7126,8705
2021/06/12,16:30:00,171.1,1452,7306,8758
2021/06/12,17:00:00,219.5,1169,7424,8593
2021/06/12,17:30:00,191.43,977,7672,8649
2021/06/12,18:00:00,191.18,696,7897,8593
2021/06/12,18:30:00,233.59,498,8102,8600
2021/06/12,19:00:00,200.36,357,8242,8599
2021/06/12,19:30:00,228.16,118,8312,8430
2021/06/12,20:00:00,228.25,121,8545,8666
2021/06/12,20:30:00,236.1,120,8638,8758
2021/06/12,21:00:00,228.2,119,8608,8727
2021/06/12,21:30:00,231.5,119,8595,8714
2021/06/12,22:00:00,252.78,117,8494,8611
2021/06/12,22:30:00,225.46,117,8381,8498
2021/06/12,23:00:00,201.51,116,8205,8321
2021/06/12,23:30:00,200.54,115,7946,8061
2021/06/13,00:00:00,200.36,0,7840,7840
2021/06/13,00:30:00,200.41,0,7618,7618
2021/06/13,01:00:00,200.54,5,7394,7399
2021/06/13,01:30:00,200.36,6,7242,7248
2021/06/13,02:00:00,201.51,6,7077,7083
2021/06/13,02:30:00,172.59,7,6906,6913
2021/06/13,03:00:00,171.83,6,6808,6814
2021/06/13,03:30:00,172.03,6,6741,6747
2021/06/13,04:00:00,171.76,5,6741,6746
2021/06/13,04:30:00,172.03,5,6738,6743
2021/06/13,05:00:00,171.9,5,6796,6801
2021/06/13,05:30:00,171.83,5,6836,6841
2021/06/13,06:00:00,171.76,4,6765,6769
2021/06/13,06:30:00,172.73,92,6913,7005
2021/06/13,07:00:00,172.24,204,7214,7418
2021/06/13,07:30:00,172.24,447,7572,8019
2021/06/13,08:00:00,172.52,702,7654,8356
2021/06/13,08:30:00,172.03,1064,7762,8826
2021/06/13,09:00:00,172.1,1299,7888,9187
2021/06/13,09:30:00,201.51,1489,7983,9472
2021/06/13,10:00:00,201.51,1686,8159,9845
2021/06/13,10:30:00,200.36,1778,8237,10015
2021/06/13,11:00:00,199.32,1883,8274,10157
2021/06/13,11:30:00,200.36,1943,8330,10273
2021/06/13,12:00:00,201.51,2044,8359,10403
2021/06/13,12:30:00,200.92,2058,8448,10506
2021/06/13,13:00:00,200.65,2075,8567,10642
2021/06/13,13:30:00,199.98,2063,8685,10748
2021/06/13,14:00:00,239.83,2035,8856,10891
2021/06/13,14:30:00,239.03,1970,8891,10861
2021/06/13,15:00:00,239.03,1912,9014,10926
2021/06/13,15:30:00,239.03,1776,9088,10864
2021/06/13,16:00:00,2381.13,1639,9149,10788
2021/06/13,16:30:00,2381.13,1421,9245,10666
2021/06/13,17:00:00,2381.13,1180,9312,10492
2021/06/13,17:30:00,239.03,976,9397,10373
2021/06/13,18:00:00,239.03,688,9478,10166
2021/06/13,18:30:00,239.03,510,9510,10020
2021/06/13,19:00:00,239.03,314,9473,9787
2021/06/13,19:30:00,239.03,108,9422,9530
2021/06/13,20:00:00,239.03,132,9524,9656
2021/06/13,20:30:00,199.98,133,9652,9785
2021/06/13,21:00:00,199.98,133,9474,9607
2021/06/13,21:30:00,200.54,133,9327,9460
2021/06/13,22:00:00,199.44,134,9103,9237
2021/06/13,22:30:00,199.46,133,8849,8982
2021/06/13,23:00:00,199.98,132,8627,8759
2021/06/13,23:30:00,198.45,130,8292,8422
2021/06/14,00:00:00,199.98,130,8010,8140
2021/06/14,00:30:00,171.76,131,7713,7844
2021/06/14,01:00:00,171.96,67,7564,7631
2021/06/14,01:30:00,171.96,10,7408,7418
2021/06/14,02:00:00,172.03,10,7348,7358
2021/06/14,02:30:00,171.76,11,7264,7275
2021/06/14,03:00:00,172.03,12,7163,7175
2021/06/14,03:30:00,171.69,12,7084,7096
2021/06/14,04:00:00,171.56,13,7105,7118
2021/06/14,04:30:00,171.9,14,7116,7130
2021/06/14,05:00:00,171.83,5,7137,7142
2021/06/14,05:30:00,172.03,3,7174,7177
2021/06/14,06:00:00,172.31,1,7227,7228
2021/06/14,06:30:00,171.96,128,7372,7500
2021/06/14,07:00:00,171.76,244,7618,7862
2021/06/14,07:30:00,172.1,416,7884,8300
2021/06/14,08:00:00,171.9,658,8009,8667
2021/06/14,08:30:00,171.56,892,8226,9118
2021/06/14,09:00:00,171.83,1035,8313,9348
2021/06/14,09:30:00,171.76,1218,8337,9555
2021/06/14,10:00:00,171.83,1547,8219,9766
2021/06/14,10:30:00,172.24,1609,8243,9852
2021/06/14,11:00:00,172.66,1858,8074,9932
2021/06/14,11:30:00,172.45,1954,7936,9890
2021/06/14,12:00:00,172.45,2034,7935,9969
2021/06/14,12:30:00,172.52,2110,7958,10068
2021/06/14,13:00:00,172.24,2092,8185,10277
2021/06/14,13:30:00,172.03,2104,8294,10398
2021/06/14,14:00:00,172.17,2064,8297,10361
2021/06/14,14:30:00,172.17,2023,8247,10270
2021/06/14,15:00:00,172.1,1976,8285,10261
2021/06/14,15:30:00,171.9,1879,8345,10224
2021/06/14,16:00:00,172.1,1715,8370,10085
2021/06/14,16:30:00,172.45,1603,8478,10081
2021/06/14,17:00:00,172.03,1279,8515,9794
2021/06/14,17:30:00,171.76,1079,8583,9662
2021/06/14,18:00:00,172.1,843,8728,9571
2021/06/14,18:30:00,172.17,650,8823,9473
2021/06/14,19:00:00,172.03,511,8888,9399
2021/06/14,19:30:00,171.83,125,8914,9039
2021/06/14,20:00:00,175.14,132,9101,9233
2021/06/14,20:30:00,202.77,134,9259,9393
2021/06/14,21:00:00,201.51,138,9140,9278
2021/06/14,21:30:00,202.12,138,8923,9061
2021/06/14,22:00:00,200.92,136,8732,8868
2021/06/14,22:30:00,202.12,129,8520,8649
2021/06/14,23:00:00,202.12,123,8307,8430
2021/06/14,23:30:00,202.12,120,8019,8139
2021/06/15,00:00:00,202.12,121,7728,7849
2021/06/15,00:30:00,172.59,122,7476,7598
2021/06/15,01:00:00,172.59,124,7273,7397
2021/06/15,01:30:00,172.45,123,7216,7339
2021/06/15,02:00:00,172.59,122,7058,7180
2021/06/15,02:30:00,173.15,99,7106,7205
2021/06/15,03:00:00,172.17,66,7039,7105
2021/06/15,03:30:00,172.38,47,6997,7044
2021/06/15,04:00:00,172.31,1,6976,6977
2021/06/15,04:30:00,172.17,1,7058,7059
2021/06/15,05:00:00,172.45,1,7082,7083
2021/06/15,05:30:00,172.45,0,7078,7078
2021/06/15,06:00:00,172.45,0,6998,6998
2021/06/15,06:30:00,172.45,124,7179,7303
2021/06/15,07:00:00,172.31,289,7418,7707
2021/06/15,07:30:00,172.31,540,7589,8129
2021/06/15,08:00:00,173.11,910,7570,8480
2021/06/15,08:30:00,174.11,1119,7757,8876
2021/06/15,09:00:00,174.01,1313,7735,9048
2021/06/15,09:30:00,174.47,1548,7657,9205
2021/06/15,10:00:00,174.35,1762,7401,9163
2021/06/15,10:30:00,174.71,1888,7438,9326
2021/06/15,11:00:00,174.49,1985,7378,9363
2021/06/15,11:30:00,175.34,2064,7362,9426
2021/06/15,12:00:00,174.92,2100,7370,9470
2021/06/15,12:30:00,175.07,2124,7475,9599
2021/06/15,13:00:00,174.52,2127,7581,9708
2021/06/15,13:30:00,175.02,2125,7688,9813
2021/06/15,14:00:00,172.66,2082,7825,9907
2021/06/15,14:30:00,172.66,2039,7916,9955
2021/06/15,15:00:00,251.62,1964,8032,9996
2021/06/15,15:30:00,253.12,1896,8080,9976
2021/06/15,16:00:00,172.52,1731,8103,9834
2021/06/15,16:30:00,197.02,1587,8248,9835
2021/06/15,17:00:00,197.57,1328,8326,9654
2021/06/15,17:30:00,197.57,1091,8455,9546
2021/06/15,18:00:00,197.57,859,8596,9455
2021/06/15,18:30:00,200.41,619,8763,9382
2021/06/15,19:00:00,200.41,522,8790,9312
2021/06/15,19:30:00,221.83,128,8816,8944
2021/06/15,20:00:00,234.11,135,9023,9158
2021/06/15,20:30:00,221.83,132,9135,9267
2021/06/15,21:00:00,253.12,132,9068,9200
2021/06/15,21:30:00,238.03,130,8862,8992
2021/06/15,22:00:00,236.87,130,8625,8755
2021/06/15,22:30:00,236.77,129,8448,8577
2021/06/15,23:00:00,201.51,128,8216,8344
2021/06/15,23:30:00,199.98,127,7936,8063
2021/06/16,00:00:00,192.26,125,7673,7798
2021/06/16,00:30:00,173.08,126,7403,7529
2021/06/16,01:00:00,173.08,123,7150,7273
2021/06/16,01:30:00,172.52,122,6978,7100
2021/06/16,02:00:00,173.08,122,7000,7122
2021/06/16,02:30:00,172.03,120,6888,7008
2021/06/16,03:00:00,172.17,92,6775,6867
2021/06/16,03:30:00,172.17,52,6776,6828
2021/06/16,04:00:00,172.24,1,6800,6801
2021/06/16,04:30:00,172.24,1,6811,6812
2021/06/16,05:00:00,191.3,1,6876,6877
2021/06/16,05:30:00,172.31,1,6892,6893
2021/06/16,06:00:00,173.3,1,6973,6974
2021/06/16,06:30:00,172.38,134,7123,7257
2021/06/16,07:00:00,172.03,315,7309,7624
2021/06/16,07:30:00,171.96,476,7530,8006
2021/06/16,08:00:00,178.6,815,7588,8403
2021/06/16,08:30:00,238.14,1064,7746,8810
2021/06/16,09:00:00,238.14,1197,7816,9013
2021/06/16,09:30:00,173.95,1262,7793,9055
2021/06/16,10:00:00,175.32,1495,7568,9063
2021/06/16,10:30:00,174.59,1710,7485,9195
2021/06/16,11:00:00,190.71,1934,7425,9359
2021/06/16,11:30:00,190.94,1966,7413,9379
2021/06/16,12:00:00,190.94,2089,7394,9483
2021/06/16,12:30:00,191.18,2105,7434,9539
2021/06/16,13:00:00,207.38,2112,7551,9663
2021/06/16,13:30:00,195.69,2114,7652,9766
2021/06/16,14:00:00,195.69,2086,7743,9829
2021/06/16,14:30:00,195.69,2035,7913,9948
2021/06/16,15:00:00,195.69,1972,8012,9984
2021/06/16,15:30:00,195.69,1870,8073,9943
2021/06/16,16:00:00,195.69,1736,8129,9865
2021/06/16,16:30:00,197.57,1581,8250,9831
2021/06/16,17:00:00,197.02,1268,8280,9548
2021/06/16,17:30:00,198.81,1093,8364,9457
2021/06/16,18:00:00,199.85,853,8501,9354
2021/06/16,18:30:00,199.85,579,8638,9217
2021/06/16,19:00:00,200.41,543,8705,9248
2021/06/16,19:30:00,214.87,96,8772,8868
2021/06/16,20:00:00,228.02,98,9017,9115
2021/06/16,20:30:00,227.76,122,9088,9210
2021/06/16,21:00:00,199.85,125,8964,9089
2021/06/16,21:30:00,199.85,122,8825,8947
2021/06/16,22:00:00,199.31,122,8670,8792
2021/06/16,22:30:00,200.41,121,8457,8578
2021/06/16,23:00:00,200.41,122,8222,8344
2021/06/16,23:30:00,200.99,123,7990,8113
2021/06/17,00:00:00,199.85,123,7681,7804
2021/06/17,00:30:00,199.85,121,7481,7602
2021/06/17,01:00:00,172.17,120,7253,7373
2021/06/17,01:30:00,172.45,121,7011,7132
2021/06/17,02:00:00,171.83,122,6860,6982
2021/06/17,02:30:00,171.9,100,6747,6847
2021/06/17,03:00:00,171.76,62,6698,6760
2021/06/17,03:30:00,171.63,47,6660,6707
2021/06/17,04:00:00,171.83,42,6616,6658
2021/06/17,04:30:00,172.38,18,6810,6828
2021/06/17,05:00:00,172.03,1,6889,6890
2021/06/17,05:30:00,172.45,1,6914,6915
2021/06/17,06:00:00,172.03,1,6814,6815
2021/06/17,06:30:00,172.24,140,7210,7350
2021/06/17,07:00:00,178.6,320,7369,7689
2021/06/17,07:30:00,178.6,576,7529,8105
2021/06/17,08:00:00,171.9,828,7573,8401
2021/06/17,08:30:00,172.03,1045,7730,8775
2021/06/17,09:00:00,172.24,1130,7913,9043
2021/06/17,09:30:00,172.17,1357,7885,9242
2021/06/17,10:00:00,171.69,1558,7821,9379
2021/06/17,10:30:00,172.38,1630,7796,9426
2021/06/17,11:00:00,171.76,1731,7715,9446
2021/06/17,11:30:00,171.96,1924,7651,9575
2021/06/17,12:00:00,171.76,1965,7634,9599
2021/06/17,12:30:00,172.03,1946,7682,9628
2021/06/17,13:00:00,171.9,1990,7766,9756
2021/06/17,13:30:00,172.1,2047,7796,9843
2021/06/17,14:00:00,171.9,2096,7845,9941
2021/06/17,14:30:00,171.76,2058,7934,9992
2021/06/17,15:00:00,183.35,1981,7815,9796
2021/06/17,15:30:00,174.96,1873,7725,9598
2021/06/17,16:00:00,174.18,1747,7765,9512
2021/06/17,16:30:00,197.57,1584,7840,9424
2021/06/17,17:00:00,197.57,1323,7949,9272
2021/06/17,17:30:00,198.12,1090,8082,9172
2021/06/17,18:00:00,197.57,833,8298,9131
2021/06/17,18:30:00,197.57,570,8458,9028
2021/06/17,19:00:00,199.85,507,8494,9001
2021/06/17,19:30:00,199.85,98,8601,8699
2021/06/17,20:00:00,199.85,109,8757,8866
2021/06/17,20:30:00,200.41,131,8869,9000
2021/06/17,21:00:00,200.41,131,8785,8916
2021/06/17,21:30:00,196.82,132,8610,8742
2021/06/17,22:00:00,179.57,133,8387,8520
2021/06/17,22:30:00,197.02,133,8203,8336
2021/06/17,23:00:00,198.12,131,8000,8131
2021/06/17,23:30:00,197.57,131,7762,7893
2021/06/18,00:00:00,172.17,128,7517,7645
2021/06/18,00:30:00,172.38,128,7258,7386
2021/06/18,01:00:00,174.17,128,7020,7148
2021/06/18,01:30:00,180.53,130,6877,7007
2021/06/18,02:00:00,172.59,131,6724,6855
2021/06/18,02:30:00,172.24,128,6610,6738
2021/06/18,03:00:00,172.66,113,6502,6615
2021/06/18,03:30:00,171.76,60,6500,6560
2021/06/18,04:00:00,172.38,48,6492,6540
2021/06/18,04:30:00,172.38,6,6519,6525
2021/06/18,05:00:00,172.31,3,6527,6530
2021/06/18,05:30:00,172.66,4,6478,6482
2021/06/18,06:00:00,172.66,3,6573,6576
2021/06/18,06:30:00,172.24,121,6665,6786
2021/06/18,07:00:00,172.03,240,6702,6942
2021/06/18,07:30:00,172.17,372,6854,7226
2021/06/18,08:00:00,172.17,571,6922,7493
2021/06/18,08:30:00,171.83,906,6956,7862
2021/06/18,09:00:00,171.83,1173,6897,8070
2021/06/18,09:30:00,171.83,1573,6828,8401
2021/06/18,10:00:00,172.1,1826,6679,8505
2021/06/18,10:30:00,180.53,1938,6711,8649
2021/06/18,11:00:00,180.53,2025,6736,8761
2021/06/18,11:30:00,180.53,2092,6785,8877
2021/06/18,12:00:00,180.53,2129,6761,8890
2021/06/18,12:30:00,180.53,2148,6810,8958
2021/06/18,13:00:00,180.53,2144,6799,8943
2021/06/18,13:30:00,180.53,2131,6699,8830
2021/06/18,14:00:00,179.87,2112,6559,8671
2021/06/18,14:30:00,180.53,2060,6589,8649
2021/06/18,15:00:00,181.17,1996,6673,8669
2021/06/18,15:30:00,179.87,1874,6720,8594
2021/06/18,16:00:00,180.53,1761,6853,8614
2021/06/18,16:30:00,181.17,1583,6951,8534
2021/06/18,17:00:00,180.53,1316,7213,8529
2021/06/18,17:30:00,180.53,1093,7508,8601
2021/06/18,18:00:00,179.87,830,7849,8679
2021/06/18,18:30:00,199.31,634,8156,8790
2021/06/18,19:00:00,199.83,469,8313,8782
2021/06/18,19:30:00,200.41,127,8327,8454
2021/06/18,20:00:00,199.85,124,8407,8531
2021/06/18,20:30:00,199.85,120,8428,8548
2021/06/18,21:00:00,199.85,129,8258,8387
2021/06/18,21:30:00,199.85,132,8106,8238
2021/06/18,22:00:00,199.31,130,7936,8066
2021/06/18,22:30:00,200.41,127,7803,7930
2021/06/18,23:00:00,199.85,125,7669,7794
2021/06/18,23:30:00,180.53,124,7477,7601
2021/06/19,00:00:00,172.1,124,7312,7436
2021/06/19,00:30:00,172.73,124,7128,7252
2021/06/19,01:00:00,172.45,126,6941,7067
2021/06/19,01:30:00,171.96,127,6813,6940
2021/06/19,02:00:00,172.52,130,6661,6791
2021/06/19,02:30:00,172.52,124,6592,6716
2021/06/19,03:00:00,172.59,100,6524,6624
2021/06/19,03:30:00,172.24,48,6495,6543
2021/06/19,04:00:00,172.38,50,6483,6533
2021/06/19,04:30:00,172.66,32,6625,6657
2021/06/19,05:00:00,172.24,3,6627,6630
2021/06/19,05:30:00,172.94,2,6503,6505
2021/06/19,06:00:00,172.66,2,6356,6358
2021/06/19,06:30:00,172.38,151,6341,6492
2021/06/19,07:00:00,172.24,262,6375,6637
2021/06/19,07:30:00,172.59,522,6307,6829
2021/06/19,08:00:00,172.52,803,6187,6990
2021/06/19,08:30:00,172.52,1053,6182,7235
2021/06/19,09:00:00,172.73,1274,6145,7419
2021/06/19,09:30:00,172.59,1516,6126,7642
2021/06/19,10:00:00,172.52,1686,6150,7836
2021/06/19,10:30:00,180.53,1885,6112,7997
2021/06/19,11:00:00,181.17,1979,6120,8099
2021/06/19,11:30:00,180.53,2037,6153,8190
2021/06/19,12:00:00,172.24,2092,6143,8235
2021/06/19,12:30:00,172.52,2120,6210,8330
2021/06/19,13:00:00,171.96,2129,6284,8413
2021/06/19,13:30:00,172.38,2115,6379,8494
2021/06/19,14:00:00,172.66,2082,6418,8500
2021/06/19,14:30:00,173.44,2038,6265,8303
2021/06/19,15:00:00,171.9,1980,6364,8344
2021/06/19,15:30:00,171.76,1865,6492,8357
2021/06/19,16:00:00,172.1,1742,6643,8385
2021/06/19,16:30:00,180.53,1574,6843,8417
2021/06/19,17:00:00,180.53,1263,7042,8305
2021/06/19,17:30:00,180.53,1091,7274,8365
2021/06/19,18:00:00,179.87,834,7532,8366
2021/06/19,18:30:00,180.53,613,7767,8380
2021/06/19,19:00:00,219.5,423,7940,8363
2021/06/19,19:30:00,219.5,117,8076,8193
2021/06/19,20:00:00,222.44,128,8302,8430
2021/06/19,20:30:00,223.05,137,8452,8589
2021/06/19,21:00:00,199.31,132,8439,8571
2021/06/19,21:30:00,199.85,134,8440,8574
2021/06/19,22:00:00,240.56,126,8332,8458
2021/06/19,22:30:00,200.41,123,8179,8302
2021/06/19,23:00:00,200.41,122,7969,8091
2021/06/19,23:30:00,171.9,122,7725,7847
2021/06/20,00:00:00,172.1,123,7502,7625
2021/06/20,00:30:00,172.17,121,7221,7342
2021/06/20,01:00:00,172.17,123,7008,7131
2021/06/20,01:30:00,172.52,122,6817,6939
2021/06/20,02:00:00,172.66,124,6655,6779
2021/06/20,02:30:00,172.8,112,6693,6805
2021/06/20,03:00:00,172.52,82,6754,6836
2021/06/20,03:30:00,172.73,40,6714,6754
2021/06/20,04:00:00,172.52,37,6706,6743
2021/06/20,04:30:00,172.45,4,6763,6767
2021/06/20,05:00:00,173.08,7,6789,6796
2021/06/20,05:30:00,172.8,3,6801,6804
2021/06/20,06:00:00,172.66,0,6739,6739
2021/06/20,06:30:00,172.52,140,6916,7056
2021/06/20,07:00:00,172.45,292,7161,7453
2021/06/20,07:30:00,172.45,600,7364,7964
2021/06/20,08:00:00,172.38,1007,7368,8375
2021/06/20,08:30:00,172.52,1231,7559,8790
2021/06/20,09:00:00,171.43,1443,7596,9039
2021/06/20,09:30:00,172.24,1620,7398,9018
2021/06/20,10:00:00,171.76,1800,7390,9190
2021/06/20,10:30:00,180.53,1888,7436,9324
2021/06/20,11:00:00,171.76,1963,7482,9445
2021/06/20,11:30:00,180.53,2031,7522,9553
2021/06/20,12:00:00,172.24,2088,7531,9619
2021/06/20,12:30:00,172.03,2104,7628,9732
2021/06/20,13:00:00,172.03,2101,7790,9891
2021/06/20,13:30:00,172.1,2104,7895,9999
2021/06/20,14:00:00,172.1,140,9562,9702
2021/06/20,14:30:00,172.03,2045,8135,10180
2021/06/20,15:00:00,171.76,1969,8209,10178
2021/06/20,15:30:00,170.97,1867,8345,10212
2021/06/20,16:00:00,169.2,1707,8424,10131
2021/06/20,16:30:00,169.38,1548,8521,10069
2021/06/20,17:00:00,168.82,1262,8611,9873
2021/06/20,17:30:00,168.86,1070,8703,9773
2021/06/20,18:00:00,201.12,825,8818,9643
2021/06/20,18:30:00,200.54,616,8976,9592
2021/06/20,19:00:00,201.12,472,9010,9482
2021/06/20,19:30:00,200.54,129,9018,9147
2021/06/20,20:00:00,200.54,135,9201,9336
2021/06/20,20:30:00,200.54,136,9311,9447
2021/06/20,21:00:00,201.12,132,9228,9360
2021/06/20,21:30:00,201.12,128,9079,9207
2021/06/20,22:00:00,199.98,127,8822,8949
2021/06/20,22:30:00,199.83,124,8611,8735
2021/06/20,23:00:00,170.4,124,8361,8485
2021/06/20,23:30:00,170.71,122,8023,8145
2021/06/21,00:00:00,170.4,123,7747,7870
2021/06/21,00:30:00,170.84,121,7447,7568
2021/06/21,01:00:00,170.84,120,7243,7363
2021/06/21,01:30:00,171.36,120,7036,7156
2021/06/21,02:00:00,171.76,121,7016,7137
2021/06/21,02:30:00,171.29,103,7089,7192
2021/06/21,03:00:00,171.23,79,6994,7073
2021/06/21,03:30:00,170.91,53,6942,6995
2021/06/21,04:00:00,172.24,1,6987,6988
2021/06/21,04:30:00,172.31,1,6998,6999
2021/06/21,05:00:00,172.1,0,7042,7042
2021/06/21,05:30:00,174.45,0,7026,7026
2021/06/21,06:00:00,173.08,1,6970,6971
2021/06/21,06:30:00,178.93,156,7188,7344
2021/06/21,07:00:00,179.94,325,7294,7619
2021/06/21,07:30:00,179.77,640,7435,8075
2021/06/21,08:00:00,179.68,1033,7448,8481
2021/06/21,08:30:00,180.02,1226,7596,8822
2021/06/21,09:00:00,179.94,1455,7701,9156
2021/06/21,09:30:00,179.94,1592,7612,9204
2021/06/21,10:00:00,179.52,1738,7667,9405
2021/06/21,10:30:00,179.77,1856,7659,9515
2021/06/21,11:00:00,179.77,1962,7547,9509
2021/06/21,11:30:00,179.6,2035,7574,9609
2021/06/21,12:00:00,179.68,2065,7618,9683
2021/06/21,12:30:00,175.86,2090,7740,9830
2021/06/21,13:00:00,177.37,2093,7847,9940
2021/06/21,13:30:00,202.25,2094,7978,10072
2021/06/21,14:00:00,238.25,2094,8133,10227
2021/06/21,14:30:00,238.25,2091,8268,10359
2021/06/21,15:00:00,237.97,2087,8365,10452
2021/06/21,15:30:00,236.69,1833,8506,10339
2021/06/21,16:00:00,237.3,1688,8609,10297
2021/06/21,16:30:00,200.36,1561,8761,10322
2021/06/21,17:00:00,200.54,1297,8870,10167
2021/06/21,17:30:00,201.12,1066,9007,10073
2021/06/21,18:00:00,201.12,806,9117,9923
2021/06/21,18:30:00,200.36,583,9260,9843
2021/06/21,19:00:00,219.1,415,9250,9665
2021/06/21,19:30:00,219.7,124,9255,9379
2021/06/21,20:00:00,221.4,123,9432,9555
2021/06/21,20:30:00,212.26,125,9558,9683
2021/06/21,21:00:00,250.65,130,9478,9608
2021/06/21,21:30:00,250.65,125,9298,9423
2021/06/21,22:00:00,238.9,122,9043,9165
2021/06/21,22:30:00,218.27,120,8793,8913
2021/06/21,23:00:00,240.25,120,8580,8700
2021/06/21,23:30:00,199.44,121,8291,8412
2021/06/22,00:00:00,199.98,121,7975,8096
2021/06/22,00:30:00,199.44,120,7706,7826
2021/06/22,01:00:00,201.51,120,7465,7585
2021/06/22,01:30:00,179.1,121,7280,7401
2021/06/22,02:00:00,179.02,120,7126,7246
2021/06/22,02:30:00,178.93,119,6998,7117
2021/06/22,03:00:00,179.02,74,7080,7154
2021/06/22,03:30:00,178.85,51,7034,7085
2021/06/22,04:00:00,178.93,41,7011,7052
2021/06/22,04:30:00,178.35,0,7053,7053
2021/06/22,05:00:00,178.77,0,7109,7109
2021/06/22,05:30:00,178.93,1,7120,7121
2021/06/22,06:00:00,178.93,1,7024,7025
2021/06/22,06:30:00,178.85,127,7172,7299
2021/06/22,07:00:00,178.93,308,7333,7641
2021/06/22,07:30:00,179.02,587,7574,8161
2021/06/22,08:00:00,178.85,984,7725,8709
2021/06/22,08:30:00,179.43,1208,7944,9152
2021/06/22,09:00:00,240.56,1405,8055,9460
2021/06/22,09:30:00,238.43,1577,8168,9745
2021/06/22,10:00:00,240.56,1677,8218,9895
2021/06/22,10:30:00,238.41,1832,8244,10076
2021/06/22,11:00:00,240.01,1913,8266,10179
2021/06/22,11:30:00,238.41,2008,8322,10330
2021/06/22,12:00:00,239.2,1988,8354,10342
2021/06/22,12:30:00,240.01,2063,8448,10511
2021/06/22,13:00:00,240.56,2073,8419,10492
2021/06/22,13:30:00,251.59,2068,8535,10603
2021/06/22,14:00:00,252.25,2052,8690,10742
2021/06/22,14:30:00,250.95,1992,8868,10860
2021/06/22,15:00:00,253.21,1921,8793,10714
2021/06/22,15:30:00,252.3,1763,8999,10762
2021/06/22,16:00:00,252.94,1680,8966,10646
2021/06/22,16:30:00,251.68,1549,9074,10623
2021/06/22,17:00:00,251.72,1265,9139,10404
2021/06/22,17:30:00,250.99,1101,9243,10344
2021/06/22,18:00:00,252.82,839,9340,10179
2021/06/22,18:30:00,251.89,590,9432,10022
2021/06/22,19:00:00,251.01,540,9479,10019
2021/06/22,19:30:00,222.53,125,9477,9602
2021/06/22,20:00:00,251.89,135,9612,9747
2021/06/22,20:30:00,251.89,132,9758,9890
2021/06/22,21:00:00,253.21,129,9665,9794
2021/06/22,21:30:00,251.89,126,9461,9587
2021/06/22,22:00:00,252.82,125,9243,9368
2021/06/22,22:30:00,238.41,125,9011,9136
2021/06/22,23:00:00,199.98,124,8795,8919
2021/06/22,23:30:00,200.36,127,8488,8615
2021/06/23,00:00:00,201.74,123,8171,8294
2021/06/23,00:30:00,200.36,122,7893,8015
2021/06/23,01:00:00,201.51,122,7686,7808
2021/06/23,01:30:00,201.51,120,7486,7606
2021/06/23,02:00:00,200.92,121,7313,7434
2021/06/23,02:30:00,201.51,111,7193,7304
2021/06/23,03:00:00,180.02,78,7137,7215
2021/06/23,03:30:00,179.94,48,7221,7269
2021/06/23,04:00:00,179.77,0,7382,7382
2021/06/23,04:30:00,179.6,0,7391,7391
2021/06/23,05:00:00,179.85,0,7405,7405
2021/06/23,05:30:00,179.77,0,7406,7406
2021/06/23,06:00:00,179.77,0,7307,7307
2021/06/23,06:30:00,225.59,102,7518,7620
2021/06/23,07:00:00,225.49,278,7682,7960
2021/06/23,07:30:00,225.75,467,7979,8446
2021/06/23,08:00:00,225.75,720,8101,8821
2021/06/23,08:30:00,225.75,872,8423,9295
2021/06/23,09:00:00,225.75,1203,8363,9566
2021/06/23,09:30:00,245.55,1438,8326,9764
2021/06/23,10:00:00,242.66,1659,8292,9951
2021/06/23,10:30:00,246.93,1736,8288,10024
2021/06/23,11:00:00,244.84,1927,8325,10252
2021/06/23,11:30:00,244.26,1973,8226,10199
2021/06/23,12:00:00,244.85,2051,8319,10370
2021/06/23,12:30:00,253.43,2041,8438,10479
2021/06/23,13:00:00,251.83,2075,8594,10669
2021/06/23,13:30:00,251.83,2062,8741,10803
2021/06/23,14:00:00,253.43,2040,8858,10898
2021/06/23,14:30:00,251.83,2011,9008,11019
2021/06/23,15:00:00,253.43,1912,8968,10880
2021/06/23,15:30:00,251.93,1834,9081,10915
2021/06/23,16:00:00,253.43,1703,9146,10849
2021/06/23,16:30:00,248.13,1547,9209,10756
2021/06/23,17:00:00,253.43,1287,9282,10569
2021/06/23,17:30:00,229.9,1048,9344,10392
2021/06/23,18:00:00,225.89,809,9459,10268
2021/06/23,18:30:00,220.9,548,9577,10125
2021/06/23,19:00:00,224.46,474,9551,10025
2021/06/23,19:30:00,224.21,118,9576,9694
2021/06/23,20:00:00,224.18,132,9701,9833
2021/06/23,20:30:00,224.18,130,9738,9868
2021/06/23,21:00:00,229.11,128,9657,9785
2021/06/23,21:30:00,244.84,128,9460,9588
2021/06/23,22:00:00,245.53,128,9224,9352
2021/06/23,22:30:00,246.91,127,9107,9234
2021/06/23,23:00:00,246.21,131,8887,9018
2021/06/23,23:30:00,250.12,131,8599,8730
2021/06/24,00:00:00,246.93,133,8320,8453
2021/06/24,00:30:00,246.93,130,8002,8132
2021/06/24,01:00:00,246.93,131,7689,7820
2021/06/24,01:30:00,246.93,128,7600,7728
2021/06/24,02:00:00,246.93,93,7483,7576
2021/06/24,02:30:00,246.93,10,7611,7621
2021/06/24,03:00:00,246.93,7,7516,7523
2021/06/24,03:30:00,246.93,4,7382,7386
2021/06/24,04:00:00,179.77,5,7305,7310
2021/06/24,04:30:00,180.02,2,7327,7329
2021/06/24,05:00:00,179.77,2,7389,7391
2021/06/24,05:30:00,179.77,3,7387,7390
2021/06/24,06:00:00,188.23,1,7338,7339
2021/06/24,06:30:00,179.52,123,7497,7620
2021/06/24,07:00:00,179.68,249,7746,7995
2021/06/24,07:30:00,179.6,445,7926,8371
2021/06/24,08:00:00,179.52,719,8075,8794
2021/06/24,08:30:00,179.85,1121,8126,9247
2021/06/24,09:00:00,179.6,1366,8213,9579
2021/06/24,09:30:00,179.77,1561,8255,9816
2021/06/24,10:00:00,179.85,1699,8247,9946
2021/06/24,10:30:00,183.79,1839,8169,10008
2021/06/24,11:00:00,225.96,1955,8197,10152
2021/06/24,11:30:00,246.93,2018,8278,10296
2021/06/24,12:00:00,245.55,2055,8355,10410
2021/06/24,12:30:00,246.93,2066,8466,10532
2021/06/24,13:00:00,245.55,2065,8646,10711
2021/06/24,13:30:00,244.85,2072,8803,10875
2021/06/24,14:00:00,246.93,2040,8969,11009
2021/06/24,14:30:00,245.55,2010,9142,11152
2021/06/24,15:00:00,245.55,1948,9224,11172
2021/06/24,15:30:00,246.93,1837,9311,11148
2021/06/24,16:00:00,240.93,1726,9321,11047
2021/06/24,16:30:00,254.81,1555,9416,10971
2021/06/24,17:00:00,254.17,1293,9514,10807
2021/06/24,17:30:00,253.74,1091,9612,10703
2021/06/24,18:00:00,232.91,845,9711,10556
2021/06/24,18:30:00,232.96,601,9825,10426
2021/06/24,19:00:00,232.66,468,9824,10292
2021/06/24,19:30:00,232.36,112,9768,9880
2021/06/24,20:00:00,232.47,111,9897,10008
2021/06/24,20:30:00,232.59,119,9896,10015
2021/06/24,21:00:00,232.18,127,9788,9915
2021/06/24,21:30:00,238.39,126,9571,9697
2021/06/24,22:00:00,245.55,125,9341,9466
2021/06/24,22:30:00,255.09,124,9184,9308
2021/06/24,23:00:00,212.61,124,8912,9036
2021/06/24,23:30:00,212.66,124,8654,8778
2021/06/25,00:00:00,240.87,125,8406,8531
2021/06/25,00:30:00,196.43,125,8125,8250
2021/06/25,01:00:00,194.99,124,7892,8016
2021/06/25,01:30:00,203.96,121,7684,7805
2021/06/25,02:00:00,179.85,121,7544,7665
2021/06/25,02:30:00,179.94,120,7502,7622
2021/06/25,03:00:00,180.02,75,7420,7495
2021/06/25,03:30:00,179.6,3,7418,7421
2021/06/25,04:00:00,180.02,1,7358,7359
2021/06/25,04:30:00,180.02,1,7325,7326
2021/06/25,05:00:00,179.6,1,7293,7294
2021/06/25,05:30:00,180.02,2,7183,7185
2021/06/25,06:00:00,180.02,3,7065,7068
2021/06/25,06:30:00,179.6,167,7046,7213
2021/06/25,07:00:00,179.6,338,7192,7530
2021/06/25,07:30:00,179.52,641,7256,7897
2021/06/25,08:00:00,179.6,876,7346,8222
2021/06/25,08:30:00,179.68,1202,7432,8634
2021/06/25,09:00:00,188.24,1436,7532,8968
2021/06/25,09:30:00,191.89,1603,7607,9210
2021/06/25,10:00:00,179.43,1758,7694,9452
2021/06/25,10:30:00,179.77,1871,7782,9653
2021/06/25,11:00:00,178.77,1961,7917,9878
2021/06/25,11:30:00,195.69,2013,8037,10050
2021/06/25,12:00:00,196.67,2060,7990,10050
2021/06/25,12:30:00,196.67,2067,8084,10151
2021/06/25,13:00:00,199.83,2082,8068,10150
2021/06/25,13:30:00,197.31,2071,8225,10296
2021/06/25,14:00:00,199.98,2035,8251,10286
2021/06/25,14:30:00,198.94,1989,8274,10263
2021/06/25,15:00:00,199.98,1932,8367,10299
2021/06/25,15:30:00,199.98,1822,8427,10249
2021/06/25,16:00:00,240.87,1716,8538,10254
2021/06/25,16:30:00,220.82,1531,8707,10238
2021/06/25,17:00:00,290.25,1248,8829,10077
2021/06/25,17:30:00,289.19,1074,9062,10136
2021/06/25,18:00:00,288.26,832,9375,10207
2021/06/25,18:30:00,288.26,578,9597,10175
2021/06/25,19:00:00,288.26,403,9698,10101
2021/06/25,19:30:00,287.98,113,9726,9839
2021/06/25,20:00:00,282.47,116,9692,9808
2021/06/25,20:30:00,289.15,132,9702,9834
2021/06/25,21:00:00,287.79,132,9518,9650
2021/06/25,21:30:00,287.13,130,9321,9451
2021/06/25,22:00:00,302.27,126,9114,9240
2021/06/25,22:30:00,220,127,8978,9105
2021/06/25,23:00:00,220,124,8797,8921
2021/06/25,23:30:00,225.25,123,8595,8718
2021/06/26,00:00:00,239.87,122,8378,8500
2021/06/26,00:30:00,239.87,122,8097,8219
2021/06/26,01:00:00,239.87,124,7869,7993
2021/06/26,01:30:00,220,123,7701,7824
2021/06/26,02:00:00,220,124,7580,7704
2021/06/26,02:30:00,179.43,125,7452,7577
2021/06/26,03:00:00,179.27,76,7527,7603
2021/06/26,03:30:00,180.02,8,7505,7513
2021/06/26,04:00:00,179.77,8,7471,7479
2021/06/26,04:30:00,179.77,7,7408,7415
2021/06/26,05:00:00,179.68,4,7370,7374
2021/06/26,05:30:00,182.1,3,7243,7246
2021/06/26,06:00:00,191.3,2,7198,7200
2021/06/26,06:30:00,191.3,93,7137,7230
2021/06/26,07:00:00,191.89,195,7107,7302
2021/06/26,07:30:00,191.89,434,7059,7493
2021/06/26,08:00:00,191.3,649,7038,7687
2021/06/26,08:30:00,192.47,885,7164,8049
2021/06/26,09:00:00,191.89,1144,7082,8226
2021/06/26,09:30:00,192.47,1458,7055,8513
2021/06/26,10:00:00,191.89,1719,7072,8791
2021/06/26,10:30:00,220,1834,7230,9064
2021/06/26,11:00:00,220,1953,7335,9288
2021/06/26,11:30:00,220,2012,7380,9392
2021/06/26,12:00:00,220,2055,7473,9528
2021/06/26,12:30:00,220,2078,7643,9721
2021/06/26,13:00:00,254.41,2076,7764,9840
2021/06/26,13:30:00,254.41,2066,7865,9931
2021/06/26,14:00:00,254.41,2044,7885,9929
2021/06/26,14:30:00,254.41,2016,7998,10014
2021/06/26,15:00:00,255.41,1936,8118,10054
2021/06/26,15:30:00,254.47,1821,8178,9999
2021/06/26,16:00:00,255.41,1700,8270,9970
2021/06/26,16:30:00,255.13,1550,8445,9995
2021/06/26,17:00:00,255.14,1247,8448,9695
2021/06/26,17:30:00,254.06,1096,8626,9722
2021/06/26,18:00:00,300.68,838,8836,9674
2021/06/26,18:30:00,302.11,633,9016,9649
2021/06/26,19:00:00,300.69,424,9153,9577
2021/06/26,19:30:00,300.68,143,9221,9364
2021/06/26,20:00:00,297.6,155,9379,9534
2021/06/26,20:30:00,295.1,163,9516,9679
2021/06/26,21:00:00,288.37,161,9495,9656
2021/06/26,21:30:00,287.8,160,9593,9753
2021/06/26,22:00:00,280.72,157,9490,9647
2021/06/26,22:30:00,302.7,145,9378,9523
2021/06/26,23:00:00,253.96,130,9138,9268
2021/06/26,23:30:00,253.96,130,8847,8977
2021/06/27,00:00:00,255.04,132,8548,8680
2021/06/27,00:30:00,254.03,131,8271,8402
2021/06/27,01:00:00,201.74,129,7989,8118
2021/06/27,01:30:00,201.12,125,7769,7894
2021/06/27,02:00:00,201.12,124,7570,7694
2021/06/27,02:30:00,199.98,89,7586,7675
2021/06/27,03:00:00,200.54,6,7562,7568
2021/06/27,03:30:00,179.52,7,7481,7488
2021/06/27,04:00:00,180.19,8,7429,7437
2021/06/27,04:30:00,179.1,7,7459,7466
2021/06/27,05:00:00,179.6,7,7433,7440
2021/06/27,05:30:00,179.94,6,7423,7429
2021/06/27,06:00:00,179.6,7,7480,7487
2021/06/27,06:30:00,179.68,128,7701,7829
2021/06/27,07:00:00,179.43,288,7982,8270
2021/06/27,07:30:00,179.94,589,8211,8800
2021/06/27,08:00:00,179.77,968,8317,9285
2021/06/27,08:30:00,204.49,1215,8625,9840
2021/06/27,09:00:00,198,1431,8852,10283
2021/06/27,09:30:00,246.93,1551,8852,10403
2021/06/27,10:00:00,255.46,1734,8925,10659
2021/06/27,10:30:00,253.77,1835,9050,10885
2021/06/27,11:00:00,253.77,1912,9086,10998
2021/06/27,11:30:00,254.46,1960,9223,11183
2021/06/27,12:00:00,255.16,2033,9282,11315
2021/06/27,12:30:00,254.46,2048,9555,11603
2021/06/27,13:00:00,253.77,2061,9747,11808
2021/06/27,13:30:00,255.46,2049,9973,12022
2021/06/27,14:00:00,255.46,1993,10176,12169
2021/06/27,14:30:00,299.4,1978,10351,12329
2021/06/27,15:00:00,298.11,1901,10555,12456
2021/06/27,15:30:00,300.74,1783,10598,12381
2021/06/27,16:00:00,298.11,1681,10680,12361
2021/06/27,16:30:00,255.46,1543,10792,12335
2021/06/27,17:00:00,255.46,1256,10884,12140
2021/06/27,17:30:00,236.72,1061,10931,11992
2021/06/27,18:00:00,237.15,800,11028,11828
2021/06/27,18:30:00,237.41,555,11040,11595
2021/06/27,19:00:00,237.49,404,10936,11340
2021/06/27,19:30:00,238.07,127,10840,10967
2021/06/27,20:00:00,238.14,128,10934,11062
2021/06/27,20:30:00,237.89,133,10924,11057
2021/06/27,21:00:00,237.97,131,10771,10902
2021/06/27,21:30:00,239.09,128,10542,10670
2021/06/27,22:00:00,238.3,129,10228,10357
2021/06/27,22:30:00,237.57,126,10046,10172
2021/06/27,23:00:00,252.06,126,9694,9820
2021/06/27,23:30:00,254.01,124,9422,9546
2021/06/28,00:00:00,255.4,126,9177,9303
2021/06/28,00:30:00,255.4,126,9007,9133
2021/06/28,01:00:00,253.97,118,8728,8846
2021/06/28,01:30:00,201.12,126,8498,8624
2021/06/28,02:00:00,200.54,127,8274,8401
2021/06/28,02:30:00,200.54,114,8152,8266
2021/06/28,03:00:00,201.74,5,8113,8118
2021/06/28,03:30:00,199.98,4,8009,8013
2021/06/28,04:00:00,200.54,3,7979,7982
2021/06/28,04:30:00,200.54,3,7946,7949
2021/06/28,05:00:00,201.74,3,7948,7951
2021/06/28,05:30:00,200.54,3,7920,7923
2021/06/28,06:00:00,224.9,3,7821,7824
2021/06/28,06:30:00,225.68,121,8045,8166
2021/06/28,07:00:00,245.55,289,8234,8523
2021/06/28,07:30:00,246.93,529,8530,9059
2021/06/28,08:00:00,253.01,989,8623,9612
2021/06/28,08:30:00,253.01,1197,8986,10183
2021/06/28,09:00:00,253.01,1429,9238,10667
2021/06/28,09:30:00,255.4,1581,9443,11024
2021/06/28,10:00:00,237.1,1713,9554,11267
2021/06/28,10:30:00,231.32,1839,9407,11246
2021/06/28,11:00:00,232.29,1912,9658,11570
2021/06/28,11:30:00,230.05,1991,9782,11773
2021/06/28,12:00:00,230.54,2025,9878,11903
2021/06/28,12:30:00,230.65,2060,10045,12105
2021/06/28,13:00:00,236.53,2074,10242,12316
2021/06/28,13:30:00,230.77,2086,10494,12580
2021/06/28,14:00:00,232.39,2051,10724,12775
2021/06/28,14:30:00,232.9,2018,10892,12910
2021/06/28,15:00:00,230.82,1940,10980,12920
2021/06/28,15:30:00,238.97,1857,11074,12931
2021/06/28,16:00:00,230.65,1710,11015,12725
2021/06/28,16:30:00,227.43,1573,11147,12720
2021/06/28,17:00:00,229.97,1278,11228,12506
2021/06/28,17:30:00,230.32,1062,11313,12375
2021/06/28,18:00:00,226.1,833,11323,12156
2021/06/28,18:30:00,226.09,575,11342,11917
2021/06/28,19:00:00,229.69,489,11277,11766
2021/06/28,19:30:00,224.91,124,11215,11339
2021/06/28,20:00:00,229.69,135,11236,11371
2021/06/28,20:30:00,229.74,135,11249,11384
2021/06/28,21:00:00,224.37,135,11149,11284
2021/06/28,21:30:00,224.4,132,10935,11067
2021/06/28,22:00:00,227.8,135,10636,10771
2021/06/28,22:30:00,228.64,135,10402,10537
2021/06/28,23:00:00,227.8,134,10095,10229
2021/06/28,23:30:00,253.45,130,9705,9835
2021/06/29,00:00:00,226.37,129,9339,9468
2021/06/29,00:30:00,252.94,121,9000,9121
2021/06/29,01:00:00,255.33,126,8666,8792
2021/06/29,01:30:00,255.33,126,8598,8724
2021/06/29,02:00:00,241.17,130,8519,8649
2021/06/29,02:30:00,201.12,129,8384,8513
2021/06/29,03:00:00,200.54,98,8231,8329
2021/06/29,03:30:00,200.99,11,8260,8271
2021/06/29,04:00:00,200.41,13,8195,8208
2021/06/29,04:30:00,199.85,12,8183,8195
2021/06/29,05:00:00,200.99,11,8135,8146
2021/06/29,05:30:00,200.41,7,8109,8116
2021/06/29,06:00:00,200.41,7,7985,7992
2021/06/29,06:30:00,200.99,205,8163,8368
2021/06/29,07:00:00,200.99,276,8373,8649
2021/06/29,07:30:00,255.33,505,8770,9275
2021/06/29,08:00:00,252.94,895,8915,9810
2021/06/29,08:30:00,255.33,1174,9213,10387
2021/06/29,09:00:00,255.33,1397,9408,10805
2021/06/29,09:30:00,255.33,1591,9532,11123
2021/06/29,10:00:00,239.26,1724,9724,11448
2021/06/29,10:30:00,225.61,1866,9850,11716
2021/06/29,11:00:00,227.28,1937,9853,11790
2021/06/29,11:30:00,227.34,1995,9911,11906
2021/06/29,12:00:00,225.54,2039,10066,12105
2021/06/29,12:30:00,233.43,2062,10206,12268
2021/06/29,13:00:00,225.74,2069,10372,12441
2021/06/29,13:30:00,225.03,2041,10659,12700
2021/06/29,14:00:00,225.04,2043,10841,12884
2021/06/29,14:30:00,227.43,1997,11080,13077
2021/06/29,15:00:00,225.77,1916,11192,13108
2021/06/29,15:30:00,225.75,1840,11324,13164
2021/06/29,16:00:00,225.95,1707,11300,13007
2021/06/29,16:30:00,225.95,1555,11410,12965
2021/06/29,17:00:00,225,1276,11456,12732
2021/06/29,17:30:00,225.45,1036,11529,12565
2021/06/29,18:00:00,225.43,839,11591,12430
2021/06/29,18:30:00,234,587,11624,12211
2021/06/29,19:00:00,226.53,504,11563,12067
2021/06/29,19:30:00,225.85,150,11505,11655
2021/06/29,20:00:00,225.85,156,11554,11710
2021/06/29,20:30:00,2183.01,159,11595,11754
2021/06/29,21:00:00,2119.99,158,11473,11631
2021/06/29,21:30:00,2119.99,153,11241,11394
2021/06/29,22:00:00,225.87,152,10978,11130
2021/06/29,22:30:00,225.21,142,10767,10909
2021/06/29,23:00:00,224.77,126,10429,10555
2021/06/29,23:30:00,224.7,126,10054,10180
2021/06/30,00:00:00,253.1,123,9632,9755
2021/06/30,00:30:00,255.61,122,9437,9559
2021/06/30,01:00:00,255.61,128,9221,9349
2021/06/30,01:30:00,253.1,130,8987,9117
2021/06/30,02:00:00,255.49,131,8789,8920
2021/06/30,02:30:00,255.49,124,8593,8717
2021/06/30,03:00:00,253.1,9,8540,8549
2021/06/30,03:30:00,253.26,9,8459,8468
2021/06/30,04:00:00,252.08,8,8394,8402
2021/06/30,04:30:00,252.91,6,8357,8363
2021/06/30,05:00:00,201.12,6,8373,8379
2021/06/30,05:30:00,201.74,6,8319,8325
2021/06/30,06:00:00,200.54,6,8206,8212
2021/06/30,06:30:00,255.61,149,8363,8512
2021/06/30,07:00:00,255.49,315,8603,8918
2021/06/30,07:30:00,255.49,615,8900,9515
2021/06/30,08:00:00,255.61,927,8981,9908
2021/06/30,08:30:00,255.61,1226,9326,10552
2021/06/30,09:00:00,255.61,1390,9579,10969
2021/06/30,09:30:00,255.49,1587,9752,11339
2021/06/30,10:00:00,229.79,1727,9787,11514
2021/06/30,10:30:00,229.48,1834,9966,11800
2021/06/30,11:00:00,229.85,1941,10083,12024
2021/06/30,11:30:00,231.23,1993,10091,12084
2021/06/30,12:00:00,230.65,2041,10207,12248
2021/06/30,12:30:00,231.46,2063,10562,12625
2021/06/30,13:00:00,231.47,2069,10877,12946
2021/06/30,13:30:00,230.7,2060,11100,13160
2021/06/30,14:00:00,233.24,2036,11213,13249
2021/06/30,14:30:00,233.8,1976,11415,13391
2021/06/30,15:00:00,1939.01,1942,11528,13470
2021/06/30,15:30:00,1916.54,1842,11361,13203
2021/06/30,16:00:00,2097.28,1716,11267,12983
2021/06/30,16:30:00,1927.69,1556,11531,13087
2021/06/30,17:00:00,1859.66,1260,11565,12825
2021/06/30,17:30:00,1822.58,1087,11652,12739
2021/06/30,18:00:00,1900.29,814,11760,12574
2021/06/30,18:30:00,1822.58,597,11809,12406
2021/06/30,19:00:00,1840.69,413,11795,12208
2021/06/30,19:30:00,1822.58,149,11719,11868
2021/06/30,20:00:00,1840.69,153,11694,11847
2021/06/30,20:30:00,1840.69,155,11733,11888
2021/06/30,21:00:00,1822.58,128,11695,11823
2021/06/30,21:30:00,231.69,128,11504,11632
2021/06/30,22:00:00,231.44,127,11231,11358
2021/06/30,22:30:00,255.49,126,10982,11108
2021/06/30,23:00:00,255.15,125,10656,10781
2021/06/30,23:30:00,254.32,125,10186,10311
2021/07/01,00:00:00,258.01,125,9744,9869
2021/07/01,00:30:00,255.79,69,9455,9524
2021/07/01,01:00:00,258.16,8,9206,9214
2021/07/01,01:30:00,258.16,9,8956,8965
2021/07/01,02:00:00,255.79,9,8903,8912
2021/07/01,02:30:00,255.79,8,8869,8877
2021/07/01,03:00:00,258.01,6,8706,8712
2021/07/01,03:30:00,258.16,5,8633,8638
2021/07/01,04:00:00,258.16,6,8578,8584
2021/07/01,04:30:00,258.16,8,8563,8571
2021/07/01,05:00:00,258.16,7,8542,8549
2021/07/01,05:30:00,258.16,6,8505,8511
2021/07/01,06:00:00,258.16,7,8454,8461
2021/07/01,06:30:00,258.16,103,8726,8829
2021/07/01,07:00:00,258.16,240,8854,9094
2021/07/01,07:30:00,258.16,508,9217,9725
2021/07/01,08:00:00,258.16,865,9373,10238
2021/07/01,08:30:00,258.16,1189,9640,10829
2021/07/01,09:00:00,243.3,1430,9846,11276
2021/07/01,09:30:00,256.14,1551,10109,11660
2021/07/01,10:00:00,258.01,1731,10126,11857
2021/07/01,10:30:00,245.34,1850,10223,12073
2021/07/01,11:00:00,243.53,1922,10192,12114
2021/07/01,11:30:00,246.74,1997,10201,12198
2021/07/01,12:00:00,1938.72,2003,10329,12332
2021/07/01,12:30:00,243.76,2065,10465,12530
2021/07/01,13:00:00,243.8,2070,10617,12687
2021/07/01,13:30:00,243.8,2073,10935,13008
2021/07/01,14:00:00,236.14,2051,11087,13138
2021/07/01,14:30:00,235.85,2002,11299,13301
2021/07/01,15:00:00,238.25,1907,11356,13263
2021/07/01,15:30:00,238.25,1841,11399,13240
2021/07/01,16:00:00,234.74,1682,11259,12941
2021/07/01,16:30:00,234.45,1556,11472,13028
2021/07/01,17:00:00,234.44,1267,11496,12763
2021/07/01,17:30:00,234.43,1085,11597,12682
2021/07/01,18:00:00,234.41,847,11686,12533
2021/07/01,18:30:00,234.41,613,11723,12336
2021/07/01,19:00:00,234.41,513,11637,12150
2021/07/01,19:30:00,233.75,164,11513,11677
2021/07/01,20:00:00,233.74,161,11577,11738
2021/07/01,20:30:00,235.47,135,11463,11598
2021/07/01,21:00:00,233.12,133,11364,11497
2021/07/01,21:30:00,234.72,131,11214,11345
2021/07/01,22:00:00,235.48,127,10908,11035
2021/07/01,22:30:00,243.72,127,10575,10702
2021/07/01,23:00:00,243.72,126,10209,10335
2021/07/01,23:30:00,250.18,126,9871,9997
2021/07/02,00:00:00,255.74,125,9519,9644
2021/07/02,00:30:00,200.82,67,9256,9323
2021/07/02,01:00:00,199.14,10,9027,9037
2021/07/02,01:30:00,200.23,11,8780,8791
2021/07/02,02:00:00,204.2,15,8553,8568
2021/07/02,02:30:00,187.2,13,8357,8370
2021/07/02,03:00:00,187,14,8372,8386
2021/07/02,03:30:00,187.2,12,8243,8255
2021/07/02,04:00:00,187,15,8161,8176
2021/07/02,04:30:00,187.4,17,8119,8136
2021/07/02,05:00:00,187,14,8074,8088
2021/07/02,05:30:00,189.92,9,7989,7998
2021/07/02,06:00:00,239.11,7,7999,8006
2021/07/02,06:30:00,239.08,124,8071,8195
2021/07/02,07:00:00,239.06,261,8158,8419
2021/07/02,07:30:00,258.01,547,8267,8814
2021/07/02,08:00:00,254.88,907,8290,9197
2021/07/02,08:30:00,258.01,1199,8486,9685
2021/07/02,09:00:00,267.27,1380,8737,10117
2021/07/02,09:30:00,268.17,1596,8963,10559
2021/07/02,10:00:00,266.38,1727,9146,10873
2021/07/02,10:30:00,258.01,1855,9382,11237
2021/07/02,11:00:00,258.01,1940,9566,11506
2021/07/02,11:30:00,241.66,2008,9786,11794
2021/07/02,12:00:00,241.59,2048,9949,11997
2021/07/02,12:30:00,242.17,2061,9958,12019
2021/07/02,13:00:00,241.87,2074,10042,12116
2021/07/02,13:30:00,242.35,2073,10072,12145
2021/07/02,14:00:00,242.46,2044,10140,12184
2021/07/02,14:30:00,242.07,2000,10219,12219
2021/07/02,15:00:00,240.66,1935,10342,12277
2021/07/02,15:30:00,240.59,1818,10404,12222
2021/07/02,16:00:00,240.77,1714,10473,12187
2021/07/02,16:30:00,240.13,1526,10553,12079
2021/07/02,17:00:00,240.32,1290,10661,11951
2021/07/02,17:30:00,240.23,1070,10876,11946
2021/07/02,18:00:00,239.87,843,11038,11881
2021/07/02,18:30:00,239.78,615,11181,11796
2021/07/02,19:00:00,238.3,462,11206,11668
2021/07/02,19:30:00,238.3,127,11094,11221
2021/07/02,20:00:00,239.11,135,10999,11134
2021/07/02,20:30:00,239.18,137,10908,11045
2021/07/02,21:00:00,251.28,133,10744,10877
2021/07/02,21:30:00,253,133,10495,10628
2021/07/02,22:00:00,252.13,135,10308,10443
2021/07/02,22:30:00,267.21,130,10119,10249
2021/07/02,23:00:00,255.74,127,9953,10080
2021/07/02,23:30:00,256.56,124,9735,9859
2021/07/03,00:00:00,229.51,123,9414,9537
2021/07/03,00:30:00,229.89,64,9148,9212
2021/07/03,01:00:00,229.76,1,8963,8964
2021/07/03,01:30:00,229.7,1,8878,8879
2021/07/03,02:00:00,229.63,1,8835,8836
2021/07/03,02:30:00,258.01,0,8666,8666
2021/07/03,03:00:00,203.27,0,8535,8535
2021/07/03,03:30:00,203.27,0,8431,8431
2021/07/03,04:00:00,203.27,2,8345,8347
2021/07/03,04:30:00,203.27,3,8269,8272
2021/07/03,05:00:00,202.68,3,8203,8206
2021/07/03,05:30:00,203.27,2,8068,8070
2021/07/03,06:00:00,186.23,2,7871,7873
2021/07/03,06:30:00,186.23,102,7815,7917
2021/07/03,07:00:00,186.23,224,7782,8006
2021/07/03,07:30:00,186.42,465,7717,8182
2021/07/03,08:00:00,186.61,785,7720,8505
2021/07/03,08:30:00,186.8,1090,7710,8800
2021/07/03,09:00:00,186.42,1375,7794,9169
2021/07/03,09:30:00,240.77,1526,8010,9536
2021/07/03,10:00:00,240.82,1706,8253,9959
2021/07/03,10:30:00,241.6,1816,8408,10224
2021/07/03,11:00:00,241.62,1919,8581,10500
2021/07/03,11:30:00,241.69,1985,8716,10701
2021/07/03,12:00:00,242.49,2018,8876,10894
2021/07/03,12:30:00,249.29,2051,8851,10902
2021/07/03,13:00:00,252.53,2060,9049,11109
2021/07/03,13:30:00,249.08,2045,9138,11183
2021/07/03,14:00:00,248.9,2020,9241,11261
2021/07/03,14:30:00,257.42,1959,9393,11352
2021/07/03,15:00:00,256.56,1882,9499,11381
2021/07/03,15:30:00,256.56,1788,9636,11424
2021/07/03,16:00:00,248.5,1633,9783,11416
2021/07/03,16:30:00,241.81,1482,9930,11412
2021/07/03,17:00:00,243.77,1210,10100,11310
2021/07/03,17:30:00,241.75,1011,10236,11247
2021/07/03,18:00:00,241.71,765,10484,11249
2021/07/03,18:30:00,242.34,545,10573,11118
2021/07/03,19:00:00,240.94,372,10615,10987
2021/07/03,19:30:00,240.98,153,10622,10775
2021/07/03,20:00:00,240.26,153,10761,10914
2021/07/03,20:30:00,241.01,149,10853,11002
2021/07/03,21:00:00,240.3,141,10782,10923
2021/07/03,21:30:00,240.35,136,10735,10871
2021/07/03,22:00:00,240.36,137,10592,10729
2021/07/03,22:30:00,266.51,122,10415,10537
2021/07/03,23:00:00,201.58,71,10190,10261
2021/07/03,23:30:00,202.68,6,9919,9925
2021/07/04,00:00:00,187.48,3,9591,9594
2021/07/04,00:30:00,187.48,2,9254,9256
2021/07/04,01:00:00,189.1,2,8960,8962
2021/07/04,01:30:00,189.1,3,8728,8731
2021/07/04,02:00:00,186.23,2,8798,8800
2021/07/04,02:30:00,187.48,2,8633,8635
2021/07/04,03:00:00,187.48,2,8487,8489
2021/07/04,03:30:00,187.48,2,8405,8407
2021/07/04,04:00:00,187.48,3,8349,8352
2021/07/04,04:30:00,186.99,5,8343,8348
2021/07/04,05:00:00,187.48,5,8337,8342
2021/07/04,05:30:00,186.23,5,8325,8330
2021/07/04,06:00:00,187.48,5,8296,8301
2021/07/04,06:30:00,188,95,8566,8661
2021/07/04,07:00:00,187.48,273,8794,9067
2021/07/04,07:30:00,187.48,406,9173,9579
2021/07/04,08:00:00,187.48,651,9524,10175
2021/07/04,08:30:00,266.41,855,9813,10668
2021/07/04,09:00:00,266.41,1083,9885,10968
2021/07/04,09:30:00,265.54,1484,9863,11347
2021/07/04,10:00:00,266.41,1643,9631,11274
2021/07/04,10:30:00,267.3,1816,9501,11317
2021/07/04,11:00:00,239.81,1918,9539,11457
2021/07/04,11:30:00,239.81,1893,9753,11646
2021/07/04,12:00:00,239.15,1956,9831,11787
2021/07/04,12:30:00,240,2043,9867,11910
2021/07/04,13:00:00,240.09,2120,9979,12099
2021/07/04,13:30:00,240.09,2120,10242,12362
2021/07/04,14:00:00,239.47,2096,10418,12514
2021/07/04,14:30:00,249.82,2057,10538,12595
2021/07/04,15:00:00,249.73,1989,10612,12601
2021/07/04,15:30:00,250.7,1885,10641,12526
2021/07/04,16:00:00,250.63,1746,10666,12412
2021/07/04,16:30:00,242.65,1544,10771,12315
2021/07/04,17:00:00,242.47,1302,10828,12130
2021/07/04,17:30:00,242.58,1114,10951,12065
2021/07/04,18:00:00,242.58,838,11027,11865
2021/07/04,18:30:00,242.54,629,11042,11671
2021/07/04,19:00:00,242.5,518,10994,11512
2021/07/04,19:30:00,242.79,116,10927,11043
2021/07/04,20:00:00,251.17,126,11051,11177
2021/07/04,20:30:00,250.97,128,11062,11190
2021/07/04,21:00:00,250.97,133,10990,11123
2021/07/04,21:30:00,250.97,132,10860,10992
2021/07/04,22:00:00,251.18,131,10590,10721
2021/07/04,22:30:00,258.01,130,10227,10357
2021/07/04,23:00:00,251.04,129,10003,10132
2021/07/04,23:30:00,273.68,127,9651,9778
2021/07/05,00:00:00,185.49,98,9368,9466
2021/07/05,00:30:00,185.49,13,9154,9167
2021/07/05,01:00:00,185.49,11,8882,8893
2021/07/05,01:30:00,185.49,6,8659,8665
2021/07/05,02:00:00,185.67,7,8582,8589
2021/07/05,02:30:00,185.67,4,8576,8580
2021/07/05,03:00:00,185.49,3,8502,8505
2021/07/05,03:30:00,185.49,2,8416,8418
2021/07/05,04:00:00,185.49,2,8363,8365
2021/07/05,04:30:00,185.67,1,8320,8321
2021/07/05,05:00:00,185.67,1,8306,8307
2021/07/05,05:30:00,220.3,1,8314,8315
2021/07/05,06:00:00,259.52,2,8294,8296
2021/07/05,06:30:00,262.12,102,8522,8624
2021/07/05,07:00:00,262.12,218,8729,8947
2021/07/05,07:30:00,262.12,371,9125,9496
2021/07/05,08:00:00,259.52,564,9376,9940
2021/07/05,08:30:00,262.12,789,9697,10486
2021/07/05,09:00:00,262.12,984,9932,10916
2021/07/05,09:30:00,262.12,1085,9956,11041
2021/07/05,10:00:00,262.12,1571,9755,11326
2021/07/05,10:30:00,262.12,1595,9747,11342
2021/07/05,11:00:00,243.26,1646,9854,11500
2021/07/05,11:30:00,241.46,1785,9833,11618
2021/07/05,12:00:00,258.01,1792,9936,11728
2021/07/05,12:30:00,236.77,1964,9789,11753
2021/07/05,13:00:00,236.77,2039,9743,11782
2021/07/05,13:30:00,238.68,2039,10003,12042
2021/07/05,14:00:00,262.67,2022,10196,12218
2021/07/05,14:30:00,265.52,1986,10317,12303
2021/07/05,15:00:00,266.97,1929,10386,12315
2021/07/05,15:30:00,269.06,1820,10459,12279
2021/07/05,16:00:00,268.26,1718,10458,12176
2021/07/05,16:30:00,267.56,1577,10547,12124
2021/07/05,17:00:00,268.26,1258,10561,11819
2021/07/05,17:30:00,267.55,1078,10698,11776
2021/07/05,18:00:00,269.06,809,10799,11608
2021/07/05,18:30:00,267.55,617,10806,11423
2021/07/05,19:00:00,269.06,490,10763,11253
2021/07/05,19:30:00,267.55,127,10671,10798
2021/07/05,20:00:00,266.87,133,10801,10934
2021/07/05,20:30:00,266.89,132,10776,10908
2021/07/05,21:00:00,260.81,130,10727,10857
2021/07/05,21:30:00,266.83,131,10559,10690
2021/07/05,22:00:00,268.26,129,10293,10422
2021/07/05,22:30:00,259.91,126,9971,10097
2021/07/05,23:00:00,259.03,66,9760,9826
2021/07/05,23:30:00,258.17,6,9429,9435
2021/07/06,00:00:00,258.48,4,9140,9144
2021/07/06,00:30:00,258.48,3,8836,8839
2021/07/06,01:00:00,257.46,1,8717,8718
2021/07/06,01:30:00,189.7,2,8624,8626
2021/07/06,02:00:00,188.54,3,8487,8490
2021/07/06,02:30:00,188.19,2,8305,8307
2021/07/06,03:00:00,186.8,1,8200,8201
2021/07/06,03:30:00,186.61,2,8119,8121
2021/07/06,04:00:00,186.42,2,8024,8026
2021/07/06,04:30:00,186.61,2,8004,8006
2021/07/06,05:00:00,257.01,4,8062,8066
2021/07/06,05:30:00,254.41,2,8006,8008
2021/07/06,06:00:00,266.26,2,7979,7981
2021/07/06,06:30:00,253.99,120,8200,8320
2021/07/06,07:00:00,254.41,267,8413,8680
2021/07/06,07:30:00,271.29,444,8776,9220
2021/07/06,08:00:00,273.68,793,8825,9618
2021/07/06,08:30:00,271.29,994,8968,9962
2021/07/06,09:00:00,265.53,1204,9151,10355
2021/07/06,09:30:00,259.54,1416,9186,10602
2021/07/06,10:00:00,271.29,1421,9207,10628
2021/07/06,10:30:00,271.29,1714,9051,10765
2021/07/06,11:00:00,261.41,1824,8930,10754
2021/07/06,11:30:00,251.25,1873,9011,10884
2021/07/06,12:00:00,247.89,1950,9059,11009
2021/07/06,12:30:00,271.29,1993,9307,11300
2021/07/06,13:00:00,273.31,2033,9449,11482
2021/07/06,13:30:00,273.31,2025,9724,11749
2021/07/06,14:00:00,273.31,2028,9752,11780
2021/07/06,14:30:00,273.34,1997,9863,11860
2021/07/06,15:00:00,273.34,1910,9954,11864
2021/07/06,15:30:00,273.34,1831,10025,11856
2021/07/06,16:00:00,273.34,1720,10051,11771
2021/07/06,16:30:00,242.09,1576,10188,11764
2021/07/06,17:00:00,242.07,1299,10244,11543
2021/07/06,17:30:00,225.09,1066,10401,11467
2021/07/06,18:00:00,241.28,843,10501,11344
2021/07/06,18:30:00,241.29,565,10581,11146
2021/07/06,19:00:00,225.15,472,10540,11012
2021/07/06,19:30:00,225.13,127,10496,10623
2021/07/06,20:00:00,269.91,128,10567,10695
2021/07/06,20:30:00,242.77,128,10615,10743
2021/07/06,21:00:00,225.07,129,10527,10656
2021/07/06,21:30:00,262.15,129,10395,10524
2021/07/06,22:00:00,261.49,127,10143,10270
2021/07/06,22:30:00,261.49,125,9891,10016
2021/07/06,23:00:00,261.49,124,9618,9742
2021/07/06,23:30:00,261.49,123,9282,9405
2021/07/07,00:00:00,260.42,123,8972,9095
2021/07/07,00:30:00,266.38,9,8813,8822
2021/07/07,01:00:00,266.38,7,8800,8807
2021/07/07,01:30:00,186.85,6,8574,8580
2021/07/07,02:00:00,186.42,5,8368,8373
2021/07/07,02:30:00,186.28,4,8212,8216
2021/07/07,03:00:00,186.42,4,8060,8064
2021/07/07,03:30:00,186.04,2,7992,7994
2021/07/07,04:00:00,186.42,3,7931,7934
2021/07/07,04:30:00,186.23,4,7926,7930
2021/07/07,05:00:00,238.47,4,7930,7934
2021/07/07,05:30:00,238.45,4,7928,7932
2021/07/07,06:00:00,273.68,3,7869,7872
2021/07/07,06:30:00,271.29,122,8078,8200
2021/07/07,07:00:00,273.68,245,8265,8510
2021/07/07,07:30:00,271.29,529,8533,9062
2021/07/07,08:00:00,271.29,843,8480,9323
2021/07/07,08:30:00,271.29,1199,8739,9938
2021/07/07,09:00:00,271.29,1390,8884,10274
2021/07/07,09:30:00,271.29,1585,9057,10642
2021/07/07,10:00:00,255.32,1746,9058,10804
2021/07/07,10:30:00,247.64,1848,9017,10865
2021/07/07,11:00:00,246.24,1939,9095,11034
2021/07/07,11:30:00,244.72,2010,9180,11190
2021/07/07,12:00:00,248.81,2056,9320,11376
2021/07/07,12:30:00,242.31,2073,9470,11543
2021/07/07,13:00:00,248.39,2082,9631,11713
2021/07/07,13:30:00,247.18,2078,9927,12005
2021/07/07,14:00:00,248.69,2061,10125,12186
2021/07/07,14:30:00,269.91,2008,10291,12299
2021/07/07,15:00:00,248.04,1954,10400,12354
2021/07/07,15:30:00,243.72,1848,10515,12363
2021/07/07,16:00:00,266.25,1727,10558,12285
2021/07/07,16:30:00,251.07,1567,10705,12272
2021/07/07,17:00:00,268.9,1280,10791,12071
2021/07/07,17:30:00,257.28,1096,10928,12024
2021/07/07,18:00:00,257.28,854,11054,11908
2021/07/07,18:30:00,259.21,623,11102,11725
2021/07/07,19:00:00,259.21,406,11045,11451
2021/07/07,19:30:00,259.21,123,10955,11078
2021/07/07,20:00:00,259.21,133,11025,11158
2021/07/07,20:30:00,259.21,129,11068,11197
2021/07/07,21:00:00,259.21,126,10971,11097
2021/07/07,21:30:00,253.1,125,10809,10934
2021/07/07,22:00:00,259.21,124,10526,10650
2021/07/07,22:30:00,242.89,123,10216,10339
2021/07/07,23:00:00,241.06,122,9953,10075
2021/07/07,23:30:00,268.31,121,9603,9724
2021/07/08,00:00:00,188.54,121,9267,9388
2021/07/08,00:30:00,188,120,8929,9049
2021/07/08,01:00:00,188.54,121,8596,8717
2021/07/08,01:30:00,188.54,121,8571,8692
2021/07/08,02:00:00,188,121,8362,8483
2021/07/08,02:30:00,188,99,8243,8342
2021/07/08,03:00:00,186.99,2,8216,8218
2021/07/08,03:30:00,187.48,2,8119,8121
2021/07/08,04:00:00,188,1,8074,8075
2021/07/08,04:30:00,187.48,2,8039,8041
2021/07/08,05:00:00,188,1,8010,8011
2021/07/08,05:30:00,187.48,2,8008,8010
2021/07/08,06:00:00,238.92,2,7971,7973
2021/07/08,06:30:00,239.84,109,8147,8256
2021/07/08,07:00:00,270.23,192,8421,8613
2021/07/08,07:30:00,266.45,379,8765,9144
2021/07/08,08:00:00,264.75,653,8996,9649
2021/07/08,08:30:00,265.59,856,9339,10195
2021/07/08,09:00:00,269.19,1114,9474,10588
2021/07/08,09:30:00,264.76,1518,9452,10970
2021/07/08,10:00:00,270.19,1696,9487,11183
2021/07/08,10:30:00,249.92,1847,9555,11402
2021/07/08,11:00:00,251.6,1932,9375,11307
2021/07/08,11:30:00,262.77,2021,9483,11504
2021/07/08,12:00:00,257.59,2068,9642,11710
2021/07/08,12:30:00,259.58,2090,9778,11868
2021/07/08,13:00:00,257.64,2095,9924,12019
2021/07/08,13:30:00,254.1,2087,10194,12281
2021/07/08,14:00:00,255.94,2045,10384,12429
2021/07/08,14:30:00,247.54,2018,10488,12506
2021/07/08,15:00:00,267.03,1942,10611,12553
2021/07/08,15:30:00,265.61,1863,10702,12565
2021/07/08,16:00:00,265.59,1716,10741,12457
2021/07/08,16:30:00,266.31,1579,10867,12446
2021/07/08,17:00:00,266.31,1289,10957,12246
2021/07/08,17:30:00,260.37,1084,11090,12174
2021/07/08,18:00:00,262.32,844,11238,12082
2021/07/08,18:30:00,262.32,611,11309,11920
2021/07/08,19:00:00,262.32,533,11231,11764
2021/07/08,19:30:00,262.32,134,11104,11238
2021/07/08,20:00:00,260.37,156,11157,11313
2021/07/08,20:30:00,260.37,157,11119,11276
2021/07/08,21:00:00,257.28,156,10966,11122
2021/07/08,21:30:00,259.21,145,10859,11004
2021/07/08,22:00:00,256.55,122,10615,10737
2021/07/08,22:30:00,267.62,121,10296,10417
2021/07/08,23:00:00,267.62,121,10004,10125
2021/07/08,23:30:00,250.73,122,9682,9804
2021/07/09,00:00:00,236.91,121,9375,9496
2021/07/09,00:30:00,236.84,66,9149,9215
2021/07/09,01:00:00,237.07,8,8927,8935
2021/07/09,01:30:00,272.41,9,8703,8712
2021/07/09,02:00:00,272.41,9,8505,8514
2021/07/09,02:30:00,186.42,9,8309,8318
2021/07/09,03:00:00,187.61,7,8154,8161
2021/07/09,03:30:00,186.8,3,8172,8175
2021/07/09,04:00:00,187.2,3,8095,8098
2021/07/09,04:30:00,187.2,3,8039,8042
2021/07/09,05:00:00,187.2,3,8030,8033
2021/07/09,05:30:00,187,4,7948,7952
2021/07/09,06:00:00,187.2,6,7933,7939
2021/07/09,06:30:00,187.4,136,7965,8101
2021/07/09,07:00:00,187.2,233,8075,8308
2021/07/09,07:30:00,248.55,460,8212,8672
2021/07/09,08:00:00,248.4,833,8179,9012
2021/07/09,08:30:00,248.49,1172,8299,9471
2021/07/09,09:00:00,248.63,1399,8430,9829
2021/07/09,09:30:00,266.75,1590,8686,10276
2021/07/09,10:00:00,271.2,1732,8787,10519
2021/07/09,10:30:00,274.76,1848,8947,10795
2021/07/09,11:00:00,273.01,1943,9111,11054
2021/07/09,11:30:00,274.76,1999,9228,11227
2021/07/09,12:00:00,272.12,2062,9363,11425
2021/07/09,12:30:00,273.01,2083,9543,11626
2021/07/09,13:00:00,274.76,2075,9633,11708
2021/07/09,13:30:00,273.01,2065,9556,11621
2021/07/09,14:00:00,272.12,2055,9660,11715
2021/07/09,14:30:00,251.24,2019,9668,11687
2021/07/09,15:00:00,251.63,1935,9760,11695
2021/07/09,15:30:00,251.13,1832,9783,11615
2021/07/09,16:00:00,250.38,1720,9895,11615
2021/07/09,16:30:00,251.4,1551,9962,11513
2021/07/09,17:00:00,251.4,1285,10178,11463
2021/07/09,17:30:00,250.74,1069,10303,11372
2021/07/09,18:00:00,252.72,851,10551,11402
2021/07/09,18:30:00,250.64,608,10698,11306
2021/07/09,19:00:00,250.62,444,10741,11185
2021/07/09,19:30:00,250.65,143,10629,10772
2021/07/09,20:00:00,259.85,155,10535,10690
2021/07/09,20:30:00,261.28,155,10449,10604
2021/07/09,21:00:00,272.44,155,10290,10445
2021/07/09,21:30:00,274.32,131,10128,10259
2021/07/09,22:00:00,272.92,131,9916,10047
2021/07/09,22:30:00,248.51,131,9766,9897
2021/07/09,23:00:00,249.4,131,9571,9702
2021/07/09,23:30:00,271.2,130,9374,9504
2021/07/10,00:00:00,230.77,130,9121,9251
2021/07/10,00:30:00,273.87,81,8938,9019
2021/07/10,01:00:00,188.54,10,8768,8778
2021/07/10,01:30:00,188.54,10,8565,8575
2021/07/10,02:00:00,187.48,10,8363,8373
2021/07/10,02:30:00,187.48,8,8209,8217
2021/07/10,03:00:00,188.54,6,8380,8386
2021/07/10,03:30:00,187.48,5,8279,8284
2021/07/10,04:00:00,186.99,6,8207,8213
2021/07/10,04:30:00,186.99,6,8151,8157
2021/07/10,05:00:00,187.48,7,8105,8112
2021/07/10,05:30:00,188,8,7997,8005
2021/07/10,06:00:00,187.48,6,7766,7772
2021/07/10,06:30:00,192.93,89,7789,7878
2021/07/10,07:00:00,186.99,196,7707,7903
2021/07/10,07:30:00,186.99,378,7713,8091
2021/07/10,08:00:00,242.31,658,7690,8348
2021/07/10,08:30:00,242.34,854,7790,8644
2021/07/10,09:00:00,270.5,1072,7847,8919
2021/07/10,09:30:00,271.51,1312,7892,9204
2021/07/10,10:00:00,273.87,1610,8043,9653
2021/07/10,10:30:00,272.29,1712,8215,9927
2021/07/10,11:00:00,271.57,1838,8384,10222
2021/07/10,11:30:00,271.57,1837,8478,10315
2021/07/10,12:00:00,272.29,1858,8640,10498
2021/07/10,12:30:00,270.85,2039,8721,10760
2021/07/10,13:00:00,271.57,2064,8797,10861
2021/07/10,13:30:00,270.85,2078,8796,10874
2021/07/10,14:00:00,272.29,2045,8738,10783
2021/07/10,14:30:00,272.29,1989,8913,10902
2021/07/10,15:00:00,271.57,1846,9052,10898
2021/07/10,15:30:00,271.57,1813,9114,10927
2021/07/10,16:00:00,272.29,1684,9236,10920
2021/07/10,16:30:00,272.29,1546,9390,10936
2021/07/10,17:00:00,272.29,1282,9547,10829
2021/07/10,17:30:00,271.57,1056,9780,10836
2021/07/10,18:00:00,272.29,816,9980,10796
2021/07/10,18:30:00,270.85,588,10063,10651
2021/07/10,19:00:00,273.3,376,10165,10541
2021/07/10,19:30:00,274.79,139,10211,10350
2021/07/10,20:00:00,274.79,161,10376,10537
2021/07/10,20:30:00,274.79,161,10492,10653
2021/07/10,21:00:00,274.79,158,10452,10610
2021/07/10,21:30:00,274.79,129,10459,10588
2021/07/10,22:00:00,274.79,127,10308,10435
2021/07/10,22:30:00,274.79,121,10169,10290
2021/07/10,23:00:00,274.79,117,9935,10052
2021/07/10,23:30:00,271.11,119,9600,9719
2021/07/11,00:00:00,266.34,102,9289,9391
2021/07/11,00:30:00,269.02,46,9037,9083
2021/07/11,01:00:00,272.41,5,8798,8803
2021/07/11,01:30:00,269.32,5,8707,8712
2021/07/11,02:00:00,270.96,2,8661,8663
2021/07/11,02:30:00,272.02,4,8506,8510
2021/07/11,03:00:00,270.96,5,8407,8412
2021/07/11,03:30:00,270.96,6,8303,8309
2021/07/11,04:00:00,270.96,7,8237,8244
2021/07/11,04:30:00,270.96,7,8216,8223
2021/07/11,05:00:00,269.94,8,8201,8209
2021/07/11,05:30:00,270.96,10,8216,8226
2021/07/11,06:00:00,269.94,8,8176,8184
2021/07/11,06:30:00,270.96,15,8420,8435
2021/07/11,07:00:00,269.03,232,8695,8927
2021/07/11,07:30:00,270.97,389,9102,9491
2021/07/11,08:00:00,269.94,624,9411,10035
2021/07/11,08:30:00,269.94,874,9721,10595
2021/07/11,09:00:00,270.97,1128,9831,10959
2021/07/11,09:30:00,270,1420,9936,11356
2021/07/11,10:00:00,264.14,1557,9930,11487
2021/07/11,10:30:00,262.72,1757,9966,11723
2021/07/11,11:00:00,262.72,1904,9850,11754
2021/07/11,11:30:00,265.36,1979,9819,11798
2021/07/11,12:00:00,263.71,2055,9987,12042
2021/07/11,12:30:00,262.1,2078,10157,12235
2021/07/11,13:00:00,262.1,2089,10342,12431
2021/07/11,13:30:00,262.11,2057,10652,12709
2021/07/11,14:00:00,262.11,2046,10866,12912
2021/07/11,14:30:00,260.57,2016,11030,13046
2021/07/11,15:00:00,268.51,1920,11132,13052
2021/07/11,15:30:00,262.42,1803,11193,12996
2021/07/11,16:00:00,268.51,1659,11252,12911
2021/07/11,16:30:00,246.51,1369,11454,12823
2021/07/11,17:00:00,245.68,1217,11475,12692
2021/07/11,17:30:00,247.78,1037,11530,12567
2021/07/11,18:00:00,246.66,821,11597,12418
2021/07/11,18:30:00,246.24,572,11623,12195
2021/07/11,19:00:00,271.82,428,11595,12023
2021/07/11,19:30:00,272.49,134,11496,11630
2021/07/11,20:00:00,272.49,146,11541,11687
2021/07/11,20:30:00,271.16,154,11577,11731
2021/07/11,21:00:00,272.49,155,11429,11584
2021/07/11,21:30:00,273.24,144,11300,11444
2021/07/11,22:00:00,252.96,151,11010,11161
2021/07/11,22:30:00,273.89,153,10651,10804
2021/07/11,23:00:00,247.03,127,10341,10468
2021/07/11,23:30:00,252.03,126,9948,10074
2021/07/12,00:00:00,189.69,82,9658,9740
2021/07/12,00:30:00,189.89,6,9431,9437
2021/07/12,01:00:00,190.97,6,9069,9075
2021/07/12,01:30:00,189.89,4,9100,9104
2021/07/12,02:00:00,189.89,4,8900,8904
2021/07/12,02:30:00,189.89,5,8680,8685
2021/07/12,03:00:00,189.89,5,8560,8565
2021/07/12,03:30:00,189.89,5,8479,8484
2021/07/12,04:00:00,189.89,5,8358,8363
2021/07/12,04:30:00,189.69,5,8354,8359
2021/07/12,05:00:00,189.89,3,8349,8352
2021/07/12,05:30:00,189.89,5,8334,8339
2021/07/12,06:00:00,189.89,2,8252,8254
2021/07/12,06:30:00,243.26,100,8477,8577
2021/07/12,07:00:00,270.24,207,8757,8964
2021/07/12,07:30:00,271.25,389,9193,9582
2021/07/12,08:00:00,271.25,720,9320,10040
2021/07/12,08:30:00,272.24,1082,9524,10606
2021/07/12,09:00:00,273.32,1356,9658,11014
2021/07/12,09:30:00,271.26,1561,9613,11174
2021/07/12,10:00:00,271.26,1709,9491,11200
2021/07/12,10:30:00,271.26,1851,9626,11477
2021/07/12,11:00:00,272.28,1929,9744,11673
2021/07/12,11:30:00,273.32,2003,9889,11892
2021/07/12,12:00:00,267.64,2041,10043,12084
2021/07/12,12:30:00,267.64,2069,10196,12265
2021/07/12,13:00:00,265.93,2067,10393,12460
2021/07/12,13:30:00,267.64,2070,10655,12725
2021/07/12,14:00:00,265.93,2038,10854,12892
2021/07/12,14:30:00,269.41,2001,11002,13003
2021/07/12,15:00:00,267.65,1937,11102,13039
2021/07/12,15:30:00,272.45,1837,11182,13019
2021/07/12,16:00:00,269.09,1714,11223,12937
2021/07/12,16:30:00,262.13,1558,11291,12849
2021/07/12,17:00:00,262.71,1284,11396,12680
2021/07/12,17:30:00,272.4,1063,11505,12568
2021/07/12,18:00:00,273.4,832,11595,12427
2021/07/12,18:30:00,275.87,594,11636,12230
2021/07/12,19:00:00,275.87,446,11563,12009
2021/07/12,19:30:00,275.87,147,11494,11641
2021/07/12,20:00:00,275.87,160,11584,11744
2021/07/12,20:30:00,275.87,137,11631,11768
2021/07/12,21:00:00,275.87,135,11525,11660
2021/07/12,21:30:00,274.03,134,11321,11455
2021/07/12,22:00:00,275.35,132,11079,11211
2021/07/12,22:30:00,275.19,133,10704,10837
2021/07/12,23:00:00,275.12,134,10385,10519
2021/07/12,23:30:00,275.12,135,9980,10115
2021/07/13,00:00:00,276.18,74,9684,9758
2021/07/13,00:30:00,235.93,12,9364,9376
2021/07/13,01:00:00,222.38,10,9433,9443
2021/07/13,01:30:00,218.46,4,9193,9197
2021/07/13,02:00:00,219.67,5,9018,9023
2021/07/13,02:30:00,218.46,6,8820,8826
2021/07/13,03:00:00,220.32,5,8726,8731
2021/07/13,03:30:00,219.05,6,8608,8614
2021/07/13,04:00:00,219.67,7,8494,8501
2021/07/13,04:30:00,219.05,7,8495,8502
2021/07/13,05:00:00,219.05,8,8488,8496
2021/07/13,05:30:00,219.05,5,8495,8500
2021/07/13,06:00:00,219.67,8,8405,8413
2021/07/13,06:30:00,219.67,102,8639,8741
2021/07/13,07:00:00,242.43,229,8938,9167
2021/07/13,07:30:00,242.49,363,9297,9660
2021/07/13,08:00:00,271.55,650,9541,10191
2021/07/13,08:30:00,272.58,880,9823,10703
2021/07/13,09:00:00,271.56,1224,9845,11069
2021/07/13,09:30:00,274.73,1565,9777,11342
2021/07/13,10:00:00,273.61,1716,9799,11515
2021/07/13,10:30:00,248.3,1862,9872,11734
2021/07/13,11:00:00,246.37,1906,9931,11837
2021/07/13,11:30:00,248.35,1998,10024,12022
2021/07/13,12:00:00,248.44,2050,10127,12177
2021/07/13,12:30:00,248.44,2090,10249,12339
2021/07/13,13:00:00,248.63,2097,10260,12357
2021/07/13,13:30:00,248.62,2097,10552,12649
2021/07/13,14:00:00,248.62,1965,10843,12808
2021/07/13,14:30:00,248.35,2003,10873,12876
2021/07/13,15:00:00,250.09,1954,10990,12944
2021/07/13,15:30:00,250.63,1856,11061,12917
2021/07/13,16:00:00,250.43,1712,11090,12802
2021/07/13,16:30:00,251.24,1538,11200,12738
2021/07/13,17:00:00,248.48,1288,11285,12573
2021/07/13,17:30:00,250.76,1041,11456,12497
2021/07/13,18:00:00,251.54,813,11546,12359
2021/07/13,18:30:00,252,592,11607,12199
2021/07/13,19:00:00,258.36,480,11523,12003
2021/07/13,19:30:00,257.6,120,11440,11560
2021/07/13,20:00:00,258.48,134,11546,11680
2021/07/13,20:30:00,258.55,133,11554,11687
2021/07/13,21:00:00,257.65,133,11457,11590
2021/07/13,21:30:00,258.55,133,11298,11431
2021/07/13,22:00:00,255.92,135,10980,11115
2021/07/13,22:30:00,247.6,135,10639,10774
2021/07/13,23:00:00,247.78,132,10318,10450
2021/07/13,23:30:00,246.63,128,9913,10041
2021/07/14,00:00:00,278.81,126,9546,9672
2021/07/14,00:30:00,278.81,82,9427,9509
2021/07/14,01:00:00,275.48,7,9362,9369
2021/07/14,01:30:00,276.01,11,9116,9127
2021/07/14,02:00:00,278.81,12,8905,8917
2021/07/14,02:30:00,276.01,11,8750,8761
2021/07/14,03:00:00,276.01,7,8623,8630
2021/07/14,03:30:00,276.01,4,8528,8532
2021/07/14,04:00:00,237.52,4,8464,8468
2021/07/14,04:30:00,207.5,4,8437,8441
2021/07/14,05:00:00,207.5,6,8436,8442
2021/07/14,05:30:00,207.5,7,8438,8445
2021/07/14,06:00:00,207.5,6,8369,8375
2021/07/14,06:30:00,207.5,15,8568,8583
2021/07/14,07:00:00,207.76,241,8872,9113
2021/07/14,07:30:00,276.01,384,9253,9637
2021/07/14,08:00:00,245.16,649,9551,10200
2021/07/14,08:30:00,244.67,758,9838,10596
2021/07/14,09:00:00,244.59,1109,9867,10976
2021/07/14,09:30:00,244.67,1446,9809,11255
2021/07/14,10:00:00,246.95,1712,9709,11421
2021/07/14,10:30:00,247.41,1798,9732,11530
2021/07/14,11:00:00,247.74,1925,9529,11454
2021/07/14,11:30:00,249.93,1976,9617,11593
2021/07/14,12:00:00,251.23,2045,9684,11729
2021/07/14,12:30:00,251.23,2062,9859,11921
2021/07/14,13:00:00,250.19,2077,10005,12082
2021/07/14,13:30:00,251.41,2065,10298,12363
2021/07/14,14:00:00,250.26,2057,10470,12527
2021/07/14,14:30:00,250.38,2005,10624,12629
2021/07/14,15:00:00,254.15,1936,10715,12651
2021/07/14,15:30:00,254.07,1846,10786,12632
2021/07/14,16:00:00,256.69,1706,10836,12542
2021/07/14,16:30:00,256.77,1594,10929,12523
2021/07/14,17:00:00,258.94,1317,11028,12345
2021/07/14,17:30:00,254.89,1087,11149,12236
2021/07/14,18:00:00,259.02,847,11242,12089
2021/07/14,18:30:00,259.11,614,11257,11871
2021/07/14,19:00:00,256.61,502,11206,11708
2021/07/14,19:30:00,256.71,153,11195,11348
2021/07/14,20:00:00,254.84,158,11290,11448
2021/07/14,20:30:00,254.93,133,11341,11474
2021/07/14,21:00:00,254.93,132,11289,11421
2021/07/14,21:30:00,255.5,129,11129,11258
2021/07/14,22:00:00,254.93,127,10830,10957
2021/07/14,22:30:00,250,127,10507,10634
2021/07/14,23:00:00,248.91,131,10171,10302
2021/07/14,23:30:00,274.44,134,9810,9944
2021/07/15,00:00:00,277.11,96,9501,9597
2021/07/15,00:30:00,221,7,9401,9408
2021/07/15,01:00:00,219.19,6,9303,9309
2021/07/15,01:30:00,222.6,3,9076,9079
2021/07/15,02:00:00,220.32,3,8884,8887
2021/07/15,02:30:00,221,7,8703,8710
2021/07/15,03:00:00,207.76,6,8591,8597
2021/07/15,03:30:00,207.5,7,8494,8501
2021/07/15,04:00:00,207.76,6,8429,8435
2021/07/15,04:30:00,207.5,7,8412,8419
2021/07/15,05:00:00,283.39,5,8418,8423
2021/07/15,05:30:00,283.39,4,8438,8442
2021/07/15,06:00:00,283.39,4,8357,8361
2021/07/15,06:30:00,283.39,93,8561,8654
2021/07/15,07:00:00,283.39,166,8847,9013
2021/07/15,07:30:00,279.71,392,9262,9654
2021/07/15,08:00:00,255.95,618,9524,10142
2021/07/15,08:30:00,281.64,814,9945,10759
2021/07/15,09:00:00,273.39,1122,9970,11092
2021/07/15,09:30:00,248.56,1489,9996,11485
2021/07/15,10:00:00,248.56,1670,10040,11710
2021/07/15,10:30:00,251.75,1792,9995,11787
2021/07/15,11:00:00,251.75,1891,9975,11866
2021/07/15,11:30:00,254.59,1974,10087,12061
2021/07/15,12:00:00,254.6,2014,10198,12212
2021/07/15,12:30:00,254.43,2076,10385,12461
2021/07/15,13:00:00,255.7,2082,10526,12608
2021/07/15,13:30:00,253.94,2093,10800,12893
2021/07/15,14:00:00,253.9,2066,11002,13068
2021/07/15,14:30:00,254.97,2022,11202,13224
2021/07/15,15:00:00,259.54,1912,11285,13197
2021/07/15,15:30:00,260.64,1764,11352,13116
2021/07/15,16:00:00,259.29,1694,11400,13094
2021/07/15,16:30:00,260.13,1555,11485,13040
2021/07/15,17:00:00,262.84,1259,11597,12856
2021/07/15,17:30:00,259.84,1036,11758,12794
2021/07/15,18:00:00,260.13,849,11878,12727
2021/07/15,18:30:00,262.46,549,11878,12427
2021/07/15,19:00:00,266.86,452,11804,12256
2021/07/15,19:30:00,266.86,157,11726,11883
2021/07/15,20:00:00,266.52,165,11819,11984
2021/07/15,20:30:00,265.45,163,11796,11959
2021/07/15,21:00:00,262.7,164,11617,11781
2021/07/15,21:30:00,263.78,160,11519,11679
2021/07/15,22:00:00,263.06,163,11160,11323
2021/07/15,22:30:00,252.71,161,10861,11022
2021/07/15,23:00:00,252.79,132,10564,10696
2021/07/15,23:30:00,250.08,131,10199,10330
2021/07/16,00:00:00,278.42,98,9872,9970
2021/07/16,00:30:00,281.84,13,9639,9652
2021/07/16,01:00:00,278.42,11,9389,9400
2021/07/16,01:30:00,283.78,12,9271,9283
2021/07/16,02:00:00,279.73,13,9193,9206
2021/07/16,02:30:00,281.84,11,9019,9030
2021/07/16,03:00:00,278.48,6,8855,8861
2021/07/16,03:30:00,219.81,3,8782,8785
2021/07/16,04:00:00,219.81,4,8696,8700
2021/07/16,04:30:00,220.32,6,8623,8629
2021/07/16,05:00:00,220.32,7,8611,8618
2021/07/16,05:30:00,218.46,6,8540,8546
2021/07/16,06:00:00,208.03,5,8400,8405
2021/07/16,06:30:00,207.76,107,8416,8523
2021/07/16,07:00:00,259.21,229,8474,8703
2021/07/16,07:30:00,258.42,439,8594,9033
2021/07/16,08:00:00,280.86,788,8700,9488
2021/07/16,08:30:00,282.38,1073,8907,9980
2021/07/16,09:00:00,283.91,1228,9102,10330
2021/07/16,09:30:00,285.86,1494,9253,10747
2021/07/16,10:00:00,260.14,1659,9436,11095
2021/07/16,10:30:00,285.86,1833,9498,11331
2021/07/16,11:00:00,263.92,1917,9709,11626
2021/07/16,11:30:00,265.48,1985,9902,11887
2021/07/16,12:00:00,265.55,2037,9934,11971
2021/07/16,12:30:00,264.61,2040,10106,12146
2021/07/16,13:00:00,264.09,2053,10228,12281
2021/07/16,13:30:00,261.2,2065,10345,12410
2021/07/16,14:00:00,261.19,2016,10452,12468
2021/07/16,14:30:00,261.19,1992,10565,12557
2021/07/16,15:00:00,260.35,1916,10614,12530
2021/07/16,15:30:00,265.34,1820,10696,12516
2021/07/16,16:00:00,264.06,1724,10775,12499
2021/07/16,16:30:00,260.74,1563,10895,12458
2021/07/16,17:00:00,260.9,1260,11067,12327
2021/07/16,17:30:00,260.9,1115,11223,12338
2021/07/16,18:00:00,260.12,799,11453,12252
2021/07/16,18:30:00,261.74,597,11553,12150
2021/07/16,19:00:00,260.74,399,11618,12017
2021/07/16,19:30:00,281.84,131,11464,11595
2021/07/16,20:00:00,260.26,136,11372,11508
2021/07/16,20:30:00,260.45,136,11234,11370
2021/07/16,21:00:00,260.45,135,11044,11179
2021/07/16,21:30:00,260.16,132,10835,10967
2021/07/16,22:00:00,264.36,132,10602,10734
2021/07/16,22:30:00,258.31,133,10418,10551
2021/07/16,23:00:00,283.81,131,10221,10352
2021/07/16,23:30:00,283.81,126,9972,10098
2021/07/17,00:00:00,278.98,130,9668,9798
2021/07/17,00:30:00,280.89,132,9402,9534
2021/07/17,01:00:00,278.05,129,9134,9263
2021/07/17,01:30:00,258.32,130,8907,9037
2021/07/17,02:00:00,285.9,128,8705,8833
2021/07/17,02:30:00,282.86,91,8570,8661
2021/07/17,03:00:00,285.9,53,8478,8531
2021/07/17,03:30:00,285.9,2,8579,8581
2021/07/17,04:00:00,283.87,2,8467,8469
2021/07/17,04:30:00,282.86,2,8584,8586
2021/07/17,05:00:00,285.9,3,8486,8489
2021/07/17,05:30:00,282.86,3,8374,8377
2021/07/17,06:00:00,283.87,4,8145,8149
2021/07/17,06:30:00,282.85,150,8091,8241
2021/07/17,07:00:00,283.87,210,8012,8222
2021/07/17,07:30:00,283.87,493,7955,8448
2021/07/17,08:00:00,283.87,796,7921,8717
2021/07/17,08:30:00,285.9,1075,7910,8985
2021/07/17,09:00:00,285.9,1364,8008,9372
2021/07/17,09:30:00,284.17,1555,8195,9750
2021/07/17,10:00:00,285.9,1735,8405,10140
2021/07/17,10:30:00,271.36,1832,8709,10541
2021/07/17,11:00:00,271.3,1954,8880,10834
2021/07/17,11:30:00,273.96,2017,9035,11052
2021/07/17,12:00:00,272.97,2053,9151,11204
2021/07/17,12:30:00,259.77,2074,9298,11372
2021/07/17,13:00:00,258.89,2072,9390,11462
2021/07/17,13:30:00,258.88,2075,9237,11312
2021/07/17,14:00:00,259.07,2048,9311,11359
2021/07/17,14:30:00,260.11,1977,9461,11438
2021/07/17,15:00:00,259.62,1928,9563,11491
2021/07/17,15:30:00,267.98,1846,9719,11565
2021/07/17,16:00:00,269.2,1694,9863,11557
2021/07/17,16:30:00,266.62,1563,10054,11617
2021/07/17,17:00:00,266.62,1303,10221,11524
2021/07/17,17:30:00,271.09,1059,10426,11485
2021/07/17,18:00:00,271.06,863,10590,11453
2021/07/17,18:30:00,271.54,567,10792,11359
2021/07/17,19:00:00,266.28,482,10821,11303
2021/07/17,19:30:00,263.32,147,10843,10990
2021/07/17,20:00:00,263.64,158,10963,11121
2021/07/17,20:30:00,263.64,160,10955,11115
2021/07/17,21:00:00,263.64,152,10714,10866
2021/07/17,21:30:00,271.35,158,10589,10747
2021/07/17,22:00:00,269.07,155,10402,10557
2021/07/17,22:30:00,273.18,149,10172,10321
2021/07/17,23:00:00,285.9,125,9951,10076
2021/07/17,23:30:00,254.04,120,9692,9812
2021/07/18,00:00:00,279.6,122,9365,9487
2021/07/18,00:30:00,257.46,121,9081,9202
2021/07/18,01:00:00,284.5,121,8790,8911
2021/07/18,01:30:00,252.59,121,8745,8866
2021/07/18,02:00:00,255.14,121,8541,8662
2021/07/18,02:30:00,255.43,121,8344,8465
2021/07/18,03:00:00,254.65,0,8435,8435
2021/07/18,03:30:00,280.24,0,8331,8331
2021/07/18,04:00:00,280.23,0,8232,8232
2021/07/18,04:30:00,277.05,0,8176,8176
2021/07/18,05:00:00,279.17,0,8160,8160
2021/07/18,05:30:00,254.07,0,8132,8132
2021/07/18,06:00:00,254.12,0,8028,8028
2021/07/18,06:30:00,283.83,106,8214,8320
2021/07/18,07:00:00,280.23,205,8278,8483
2021/07/18,07:30:00,281.4,392,8422,8814
2021/07/18,08:00:00,280.23,813,8583,9396
2021/07/18,08:30:00,249.92,1127,8818,9945
2021/07/18,09:00:00,250.12,1365,9071,10436
2021/07/18,09:30:00,253.88,1561,9314,10875
2021/07/18,10:00:00,285.83,1685,9440,11125
2021/07/18,10:30:00,284.03,1821,9511,11332
2021/07/18,11:00:00,254.86,1910,9702,11612
2021/07/18,11:30:00,254.86,1972,9911,11883
2021/07/18,12:00:00,254.89,2017,10100,12117
2021/07/18,12:30:00,255.23,2028,10290,12318
2021/07/18,13:00:00,255.49,2031,10495,12526
2021/07/18,13:30:00,256.09,2024,10811,12835
2021/07/18,14:00:00,255.75,2007,10966,12973
2021/07/18,14:30:00,255.7,1956,11151,13107
2021/07/18,15:00:00,259.43,1895,11313,13208
2021/07/18,15:30:00,259.46,1762,11422,13184
2021/07/18,16:00:00,259.43,1662,11549,13211
2021/07/18,16:30:00,259.46,1474,11730,13204
2021/07/18,17:00:00,258.07,1191,11879,13070
2021/07/18,17:30:00,260.33,1028,12033,13061
2021/07/18,18:00:00,260.25,714,12151,12865
2021/07/18,18:30:00,266.89,534,12190,12724
2021/07/18,19:00:00,260.57,369,12113,12482
2021/07/18,19:30:00,260.05,143,11901,12044
2021/07/18,20:00:00,262,144,12012,12156
2021/07/18,20:30:00,258.56,144,11935,12079
2021/07/18,21:00:00,262.34,144,11720,11864
2021/07/18,21:30:00,260.66,150,11526,11676
2021/07/18,22:00:00,265.73,149,11199,11348
2021/07/18,22:30:00,254.17,148,10833,10981
2021/07/18,23:00:00,256.19,123,10559,10682
2021/07/18,23:30:00,278.74,122,10189,10311
2021/07/19,00:00:00,221.17,123,9840,9963
2021/07/19,00:30:00,222.38,124,9537,9661
2021/07/19,01:00:00,221.17,124,9254,9378
2021/07/19,01:30:00,224.42,116,9164,9280
2021/07/19,02:00:00,221.76,67,9145,9212
2021/07/19,02:30:00,224.42,3,8990,8993
2021/07/19,03:00:00,222.38,2,8869,8871
2021/07/19,03:30:00,221.76,5,8755,8760
2021/07/19,04:00:00,222.38,5,8694,8699
2021/07/19,04:30:00,220.46,3,8617,8620
2021/07/19,05:00:00,219.81,4,8620,8624
2021/07/19,05:30:00,220.46,4,8628,8632
2021/07/19,06:00:00,256.24,5,8485,8490
2021/07/19,06:30:00,256.24,139,8715,8854
2021/07/19,07:00:00,287.83,159,8955,9114
2021/07/19,07:30:00,256.24,374,9348,9722
2021/07/19,08:00:00,259.23,585,9598,10183
2021/07/19,08:30:00,258.73,757,9953,10710
2021/07/19,09:00:00,260.03,1132,10036,11168
2021/07/19,09:30:00,290.29,1418,10213,11631
2021/07/19,10:00:00,262.23,1634,10220,11854
2021/07/19,10:30:00,263.31,1744,10191,11935
2021/07/19,11:00:00,263.22,1843,10176,12019
2021/07/19,11:30:00,263.4,1923,10309,12232
2021/07/19,12:00:00,263.59,1972,10438,12410
2021/07/19,12:30:00,284.5,2001,10620,12621
2021/07/19,13:00:00,284.66,2010,10838,12848
2021/07/19,13:30:00,284.66,2012,11081,13093
2021/07/19,14:00:00,286.35,1983,11283,13266
2021/07/19,14:30:00,283.01,1930,11444,13374
2021/07/19,15:00:00,285.58,1841,11518,13359
2021/07/19,15:30:00,285.58,1743,11653,13396
2021/07/19,16:00:00,285.58,1580,11707,13287
2021/07/19,16:30:00,266.86,1427,11813,13240
2021/07/19,17:00:00,278.08,1202,11942,13144
2021/07/19,17:30:00,278.05,955,12102,13057
2021/07/19,18:00:00,279.38,732,12178,12910
2021/07/19,18:30:00,283.2,451,12091,12542
2021/07/19,19:00:00,275.02,323,11988,12311
2021/07/19,19:30:00,269.62,157,11809,11966
2021/07/19,20:00:00,280.36,129,11777,11906
2021/07/19,20:30:00,268.54,128,11750,11878
2021/07/19,21:00:00,274.23,125,11672,11797
2021/07/19,21:30:00,288.57,117,11511,11628
2021/07/19,22:00:00,291.23,48,11282,11330
2021/07/19,22:30:00,293.76,15,11020,11035
2021/07/19,23:00:00,263.68,15,10730,10745
2021/07/19,23:30:00,263.96,15,10362,10377
2021/07/20,00:00:00,291.3,16,10014,10030
2021/07/20,00:30:00,219.67,17,9784,9801
2021/07/20,01:00:00,189.3,14,9513,9527
2021/07/20,01:30:00,190.09,11,9281,9292
2021/07/20,02:00:00,189.49,8,9417,9425
2021/07/20,02:30:00,189.89,3,9219,9222
2021/07/20,03:00:00,189.3,3,9087,9090
2021/07/20,03:30:00,190.09,6,8962,8968
2021/07/20,04:00:00,189.89,5,8872,8877
2021/07/20,04:30:00,189.89,5,8806,8811
2021/07/20,05:00:00,189.3,3,8818,8821
2021/07/20,05:30:00,189.49,1,8848,8849
2021/07/20,06:00:00,189.89,1,8721,8722
2021/07/20,06:30:00,225.19,102,8885,8987
2021/07/20,07:00:00,225.98,179,9113,9292
2021/07/20,07:30:00,223.03,345,9426,9771
2021/07/20,08:00:00,222.38,650,9608,10258
2021/07/20,08:30:00,261.26,863,9788,10651
2021/07/20,09:00:00,261.22,1203,9815,11018
2021/07/20,09:30:00,270.29,1442,9881,11323
2021/07/20,10:00:00,270.29,1615,9872,11487
2021/07/20,10:30:00,277.7,1779,9714,11493
2021/07/20,11:00:00,273.31,1867,9781,11648
2021/07/20,11:30:00,293.44,1940,9883,11823
2021/07/20,12:00:00,288.05,2014,9848,11862
2021/07/20,12:30:00,267.11,2044,9972,12016
2021/07/20,13:00:00,266.4,2054,10026,12080
2021/07/20,13:30:00,267.3,2059,10267,12326
2021/07/20,14:00:00,267.35,2039,10341,12380
2021/07/20,14:30:00,269.01,1986,10396,12382
2021/07/20,15:00:00,269.03,1913,10473,12386
2021/07/20,15:30:00,269.56,1786,10537,12323
2021/07/20,16:00:00,268.85,1627,10620,12247
2021/07/20,16:30:00,278.93,1469,10664,12133
2021/07/20,17:00:00,279.39,1188,10776,11964
2021/07/20,17:30:00,281.33,989,10969,11958
2021/07/20,18:00:00,281.27,689,11095,11784
2021/07/20,18:30:00,281.82,502,11029,11531
2021/07/20,19:00:00,278.81,320,10959,11279
2021/07/20,19:30:00,266.68,159,10816,10975
2021/07/20,20:00:00,268.04,166,11012,11178
2021/07/20,20:30:00,269.92,165,10952,11117
2021/07/20,21:00:00,271.77,166,10868,11034
2021/07/20,21:30:00,271.81,162,10766,10928
2021/07/20,22:00:00,291.61,84,10598,10682
2021/07/20,22:30:00,265.79,50,10357,10407
2021/07/20,23:00:00,263.91,17,10114,10131
2021/07/20,23:30:00,265.98,17,9850,9867
2021/07/21,00:00:00,296.21,17,9553,9570
2021/07/21,00:30:00,297.46,16,9302,9318
2021/07/21,01:00:00,297.46,14,9062,9076
2021/07/21,01:30:00,298.73,9,8835,8844
2021/07/21,02:00:00,300.08,8,8634,8642
2021/07/21,02:30:00,298.73,6,8438,8444
2021/07/21,03:00:00,297.46,4,8607,8611
2021/07/21,03:30:00,293.79,2,8532,8534
2021/07/21,04:00:00,298.73,2,8453,8455
2021/07/21,04:30:00,294.98,1,8410,8411
2021/07/21,05:00:00,297.41,1,8377,8378
2021/07/21,05:30:00,298.73,1,8432,8433
2021/07/21,06:00:00,297.56,1,8329,8330
2021/07/21,06:30:00,295.18,89,8509,8598
2021/07/21,07:00:00,297.56,175,8728,8903
2021/07/21,07:30:00,298.86,369,9067,9436
2021/07/21,08:00:00,297.56,657,9177,9834
2021/07/21,08:30:00,270.53,962,9331,10293
2021/07/21,09:00:00,299.05,1268,9406,10674
2021/07/21,09:30:00,272.41,1442,9456,10898
2021/07/21,10:00:00,284.48,1665,9279,10944
2021/07/21,10:30:00,285.07,1698,9233,10931
2021/07/21,11:00:00,301.05,1831,9258,11089
2021/07/21,11:30:00,298.49,1934,9229,11163
2021/07/21,12:00:00,298.49,2018,9302,11320
2021/07/21,12:30:00,285.66,2032,9450,11482
2021/07/21,13:00:00,278.71,2060,9621,11681
2021/07/21,13:30:00,309.35,2066,9797,11863
2021/07/21,14:00:00,305.02,2025,9954,11979
2021/07/21,14:30:00,309.35,2000,10031,12031
2021/07/21,15:00:00,309.4,1911,10176,12087
2021/07/21,15:30:00,309.97,1807,10271,12078
2021/07/21,16:00:00,309.97,1696,10278,11974
2021/07/21,16:30:00,293.54,1500,10428,11928
2021/07/21,17:00:00,287.4,1268,10545,11813
2021/07/21,17:30:00,285.03,1020,10706,11726
2021/07/21,18:00:00,285.03,823,10832,11655
2021/07/21,18:30:00,289.58,589,10874,11463
2021/07/21,19:00:00,285.72,435,10833,11268
2021/07/21,19:30:00,285.79,124,10779,10903
2021/07/21,20:00:00,309.97,128,10963,11091
2021/07/21,20:30:00,308.2,133,10923,11056
2021/07/21,21:00:00,308.24,134,10863,10997
2021/07/21,21:30:00,309.46,132,10723,10855
2021/07/21,22:00:00,308.24,128,10463,10591
2021/07/21,22:30:00,306.36,123,10208,10331
2021/07/21,23:00:00,307.83,121,9945,10066
2021/07/21,23:30:00,309.97,122,9644,9766
2021/07/22,00:00:00,305.93,120,9403,9523
2021/07/22,00:30:00,309.25,119,9084,9203
2021/07/22,01:00:00,307.57,124,9174,9298
2021/07/22,01:30:00,305.93,71,8998,9069
2021/07/22,02:00:00,307.57,6,8901,8907
2021/07/22,02:30:00,213.21,6,8733,8739
2021/07/22,03:00:00,221,6,8580,8586
2021/07/22,03:30:00,220.32,5,8491,8496
2021/07/22,04:00:00,221,4,8441,8445
2021/07/22,04:30:00,220.32,3,8424,8427
2021/07/22,05:00:00,220.32,1,8399,8400
2021/07/22,05:30:00,220.32,1,8431,8432
2021/07/22,06:00:00,219.67,1,8287,8288
2021/07/22,06:30:00,220.32,5,8496,8501
2021/07/22,07:00:00,220.32,215,8750,8965
2021/07/22,07:30:00,267.75,441,9012,9453
2021/07/22,08:00:00,267.75,762,9092,9854
2021/07/22,08:30:00,298.32,974,9387,10361
2021/07/22,09:00:00,296.1,1146,9538,10684
2021/07/22,09:30:00,299.22,1278,9479,10757
2021/07/22,10:00:00,299.22,1388,9435,10823
2021/07/22,10:30:00,300.29,1655,9365,11020
2021/07/22,11:00:00,301.38,1794,9358,11152
2021/07/22,11:30:00,299.22,1915,9384,11299
2021/07/22,12:00:00,303.64,2028,9334,11362
2021/07/22,12:30:00,301.38,2047,9486,11533
2021/07/22,13:00:00,302.47,2055,9617,11672
2021/07/22,13:30:00,276.11,2049,9810,11859
2021/07/22,14:00:00,276.11,2033,9956,11989
2021/07/22,14:30:00,272.84,1989,10070,12059
2021/07/22,15:00:00,276.15,1935,10189,12124
2021/07/22,15:30:00,279.94,1805,10278,12083
2021/07/22,16:00:00,282.89,1686,10253,11939
2021/07/22,16:30:00,282.85,1528,10416,11944
2021/07/22,17:00:00,283.25,1250,10502,11752
2021/07/22,17:30:00,283.84,1063,10657,11720
2021/07/22,18:00:00,285.69,801,10782,11583
2021/07/22,18:30:00,283.73,564,10813,11377
2021/07/22,19:00:00,283.65,388,10782,11170
2021/07/22,19:30:00,282.54,132,10718,10850
2021/07/22,20:00:00,280.19,133,10841,10974
2021/07/22,20:30:00,280.27,130,10751,10881
2021/07/22,21:00:00,306.69,126,10659,10785
2021/07/22,21:30:00,306.69,123,10553,10676
2021/07/22,22:00:00,304.14,122,10306,10428
2021/07/22,22:30:00,306.5,117,10085,10202
2021/07/22,23:00:00,305.14,114,9871,9985
2021/07/22,23:30:00,279.6,70,9603,9673
2021/07/23,00:00:00,223.03,4,9452,9456
2021/07/23,00:30:00,223.03,4,9173,9177
2021/07/23,01:00:00,223.71,3,8941,8944
2021/07/23,01:30:00,223.71,3,8725,8728
2021/07/23,02:00:00,222.6,3,8548,8551
2021/07/23,02:30:00,220.32,3,8351,8354
2021/07/23,03:00:00,222.46,3,8220,8223
2021/07/23,03:30:00,222.46,1,8246,8247
2021/07/23,04:00:00,222.46,1,8306,8307
2021/07/23,04:30:00,221.72,1,8289,8290
2021/07/23,05:00:00,221.72,1,8263,8264
2021/07/23,05:30:00,222.46,1,8291,8292
2021/07/23,06:00:00,222.46,1,8100,8101
2021/07/23,06:30:00,222.46,1,8151,8152
2021/07/23,07:00:00,189.49,130,8210,8340
2021/07/23,07:30:00,304.57,283,8395,8678
2021/07/23,08:00:00,312.81,459,8488,8947
2021/07/23,08:30:00,312.81,741,8660,9401
2021/07/23,09:00:00,308.88,937,8849,9786
2021/07/23,09:30:00,306.04,1137,9051,10188
2021/07/23,10:00:00,312.81,1250,9142,10392
2021/07/23,10:30:00,312.81,1529,9173,10702
2021/07/23,11:00:00,308.98,1704,9228,10932
2021/07/23,11:30:00,277.11,1673,9354,11027
2021/07/23,12:00:00,277.93,1715,9454,11169
2021/07/23,12:30:00,275.78,1810,9547,11357
2021/07/23,13:00:00,277.32,1861,9641,11502
2021/07/23,13:30:00,275.58,1865,9664,11529
2021/07/23,14:00:00,275.86,1793,9565,11358
2021/07/23,14:30:00,275.75,1850,9558,11408
2021/07/23,15:00:00,276.13,1786,9662,11448
2021/07/23,15:30:00,275.93,1650,9820,11470
2021/07/23,16:00:00,275.84,1598,9825,11423
2021/07/23,16:30:00,276.34,1317,9999,11316
2021/07/23,17:00:00,277.48,1113,10129,11242
2021/07/23,17:30:00,287.44,951,10263,11214
2021/07/23,18:00:00,288.64,730,10444,11174
2021/07/23,18:30:00,287.88,456,10655,11111
2021/07/23,19:00:00,287.57,148,10669,10817
2021/07/23,19:30:00,287.6,147,10550,10697
2021/07/23,20:00:00,287.32,146,10576,10722
2021/07/23,20:30:00,289.91,156,10428,10584
2021/07/23,21:00:00,305.81,156,10294,10450
2021/07/23,21:30:00,295.72,155,10100,10255
2021/07/23,22:00:00,313.55,153,9929,10082
2021/07/23,22:30:00,319.48,151,9838,9989
2021/07/23,23:00:00,319.5,116,9681,9797
2021/07/23,23:30:00,312.81,7,9597,9604
2021/07/24,00:00:00,309.08,6,9393,9399
2021/07/24,00:30:00,312.71,6,9122,9128
2021/07/24,01:00:00,309.08,7,8922,8929
2021/07/24,01:30:00,312.71,8,8723,8731
2021/07/24,02:00:00,312.71,4,8706,8710
2021/07/24,02:30:00,312.71,3,8683,8686
2021/07/24,03:00:00,309.08,2,8626,8628
2021/07/24,03:30:00,309.08,2,8503,8505
2021/07/24,04:00:00,216.38,2,8459,8461
2021/07/24,04:30:00,215.49,2,8417,8419
2021/07/24,05:00:00,216.52,2,8356,8358
2021/07/24,05:30:00,216.38,3,8285,8288
2021/07/24,06:00:00,215.92,4,8074,8078
2021/07/24,06:30:00,216.38,3,8024,8027
2021/07/24,07:00:00,216.38,185,7965,8150
2021/07/24,07:30:00,216.38,324,7941,8265
2021/07/24,08:00:00,215.92,515,7943,8458
2021/07/24,08:30:00,216.38,675,8042,8717
2021/07/24,09:00:00,222.38,919,8088,9007
2021/07/24,09:30:00,221.76,1075,8287,9362
2021/07/24,10:00:00,223.71,1062,8335,9397
2021/07/24,10:30:00,221.17,1335,8375,9710
2021/07/24,11:00:00,221.76,1482,8396,9878
2021/07/24,11:30:00,222.38,1421,8516,9937
2021/07/24,12:00:00,221.76,1672,8455,10127
2021/07/24,12:30:00,221.17,1660,8620,10280
2021/07/24,13:00:00,221.17,1783,8645,10428
2021/07/24,13:30:00,221.76,1673,8693,10366
2021/07/24,14:00:00,221.76,1765,8514,10279
2021/07/24,14:30:00,222.38,1805,8611,10416
2021/07/24,15:00:00,221.76,1784,8702,10486
2021/07/24,15:30:00,222.38,1692,8835,10527
2021/07/24,16:00:00,221.76,1569,8951,10520
2021/07/24,16:30:00,222.38,1338,9260,10598
2021/07/24,17:00:00,221.76,1102,9353,10455
2021/07/24,17:30:00,273.69,954,9528,10482
2021/07/24,18:00:00,273.78,719,9708,10427
2021/07/24,18:30:00,273.95,491,9869,10360
2021/07/24,19:00:00,279.16,338,9949,10287
2021/07/24,19:30:00,280.01,127,10049,10176
2021/07/24,20:00:00,306.57,136,10314,10450
2021/07/24,20:30:00,309.08,121,10406,10527
2021/07/24,21:00:00,305.61,121,10449,10570
2021/07/24,21:30:00,307.82,121,10396,10517
2021/07/24,22:00:00,305.85,113,10309,10422
2021/07/24,22:30:00,306.93,73,10193,10266
2021/07/24,23:00:00,308.12,4,10024,10028
2021/07/24,23:30:00,305.33,4,9758,9762
2021/07/25,00:00:00,302.68,4,9475,9479
2021/07/25,00:30:00,311,3,9189,9192
2021/07/25,01:00:00,288.05,3,8897,8900
2021/07/25,01:30:00,288.04,3,8693,8696
2021/07/25,02:00:00,285.21,3,8796,8799
2021/07/25,02:30:00,273.42,3,8653,8656
2021/07/25,03:00:00,221.17,3,8512,8515
2021/07/25,03:30:00,221.76,3,8430,8433
2021/07/25,04:00:00,222.38,2,8382,8384
2021/07/25,04:30:00,222.38,2,8329,8331
2021/07/25,05:00:00,222.38,3,8352,8355
2021/07/25,05:30:00,222.38,3,8433,8436
2021/07/25,06:00:00,221.76,3,8323,8326
2021/07/25,06:30:00,243.74,7,8596,8603
2021/07/25,07:00:00,306.61,166,8813,8979
2021/07/25,07:30:00,316.08,325,9293,9618
2021/07/25,08:00:00,318.76,488,9574,10062
2021/07/25,08:30:00,314.62,671,9942,10613
2021/07/25,09:00:00,314.62,928,10166,11094
2021/07/25,09:30:00,306.57,1185,10225,11410
2021/07/25,10:00:00,318.76,1396,10211,11607
2021/07/25,10:30:00,317.37,1534,10256,11790
2021/07/25,11:00:00,318.76,1623,10340,11963
2021/07/25,11:30:00,305.11,1760,10504,12264
2021/07/25,12:00:00,280.16,1802,10593,12395
2021/07/25,12:30:00,280.35,1917,10730,12647
2021/07/25,13:00:00,280.44,1948,10928,12876
2021/07/25,13:30:00,280.54,1905,11148,13053
2021/07/25,14:00:00,279.42,1980,11282,13262
2021/07/25,14:30:00,279.33,1880,11459,13339
2021/07/25,15:00:00,281.73,1861,11596,13457
2021/07/25,15:30:00,281.5,1757,11419,13176
2021/07/25,16:00:00,279.78,1609,11501,13110
2021/07/25,16:30:00,282.01,1462,11569,13031
2021/07/25,17:00:00,281.38,1142,11729,12871
2021/07/25,17:30:00,281.41,898,11914,12812
2021/07/25,18:00:00,281.27,669,11963,12632
2021/07/25,18:30:00,281.52,442,11931,12373
2021/07/25,19:00:00,281.73,260,11803,12063
2021/07/25,19:30:00,281.49,108,11706,11814
2021/07/25,20:00:00,287.02,116,11845,11961
2021/07/25,20:30:00,286.94,114,11836,11950
2021/07/25,21:00:00,286.85,119,11715,11834
2021/07/25,21:30:00,285.24,121,11525,11646
2021/07/25,22:00:00,286.61,117,11251,11368
2021/07/25,22:30:00,278.41,117,10908,11025
2021/07/25,23:00:00,306.64,116,10605,10721
2021/07/25,23:30:00,315.04,112,10231,10343
2021/07/26,00:00:00,277.34,112,9892,10004
2021/07/26,00:30:00,278.31,107,9556,9663
2021/07/26,01:00:00,323.05,68,9320,9388
2021/07/26,01:30:00,323.05,4,9174,9178
2021/07/26,02:00:00,323.05,4,9072,9076
2021/07/26,02:30:00,320.18,4,8926,8930
2021/07/26,03:00:00,318.52,4,8910,8914
2021/07/26,03:30:00,318.52,6,8790,8796
2021/07/26,04:00:00,320.18,5,8743,8748
2021/07/26,04:30:00,318.52,4,8726,8730
2021/07/26,05:00:00,320.18,5,8715,8720
2021/07/26,05:30:00,323.05,5,8769,8774
2021/07/26,06:00:00,320.18,4,8691,8695
2021/07/26,06:30:00,321.88,4,8890,8894
2021/07/26,07:00:00,323.05,148,9193,9341
2021/07/26,07:30:00,318.54,305,9576,9881
2021/07/26,08:00:00,316.87,523,9910,10433
2021/07/26,08:30:00,313.02,673,10300,10973
2021/07/26,09:00:00,283.27,827,10526,11353
2021/07/26,09:30:00,281.45,988,10700,11688
2021/07/26,10:00:00,281,1215,10646,11861
2021/07/26,10:30:00,281.45,1414,10621,12035
2021/07/26,11:00:00,301.09,1709,10333,12042
2021/07/26,11:30:00,300.53,1886,10389,12275
2021/07/26,12:00:00,290.59,1932,10497,12429
2021/07/26,12:30:00,289.82,1919,10617,12536
2021/07/26,13:00:00,291.29,1992,10789,12781
2021/07/26,13:30:00,291.44,2010,11058,13068
2021/07/26,14:00:00,291.49,1963,11158,13121
2021/07/26,14:30:00,289.83,1955,11355,13310
2021/07/26,15:00:00,305.74,1830,11505,13335
2021/07/26,15:30:00,303.56,1763,11547,13310
2021/07/26,16:00:00,305.67,1636,11552,13188
2021/07/26,16:30:00,303.99,1452,11657,13109
2021/07/26,17:00:00,292.9,1207,11727,12934
2021/07/26,17:30:00,292.9,967,11860,12827
2021/07/26,18:00:00,292.85,767,11953,12720
2021/07/26,18:30:00,306.1,530,11921,12451
2021/07/26,19:00:00,306.1,341,11832,12173
2021/07/26,19:30:00,310.67,123,11756,11879
2021/07/26,20:00:00,294.02,123,11964,12087
2021/07/26,20:30:00,292.58,122,11925,12047
2021/07/26,21:00:00,294.02,114,11849,11963
2021/07/26,21:30:00,306.39,114,11723,11837
2021/07/26,22:00:00,298.02,109,11387,11496
2021/07/26,22:30:00,301.31,108,11056,11164
2021/07/26,23:00:00,290.41,107,10724,10831
2021/07/26,23:30:00,320.18,58,10388,10446
2021/07/27,00:00:00,333.28,8,10074,10082
2021/07/27,00:30:00,326.12,8,9735,9743
2021/07/27,01:00:00,322.2,6,9616,9622
2021/07/27,01:30:00,290.67,5,9511,9516
2021/07/27,02:00:00,325.3,8,9284,9292
2021/07/27,02:30:00,323.56,7,9116,9123
2021/07/27,03:00:00,318.78,6,9012,9018
2021/07/27,03:30:00,285.23,6,8892,8898
2021/07/27,04:00:00,282.71,6,8820,8826
2021/07/27,04:30:00,318.83,6,8768,8774
2021/07/27,05:00:00,317.34,7,8738,8745
2021/07/27,05:30:00,313.08,6,8816,8822
2021/07/27,06:00:00,317.34,8,8690,8698
2021/07/27,06:30:00,318.83,12,8876,8888
2021/07/27,07:00:00,317.34,203,9115,9318
2021/07/27,07:30:00,284.77,387,9527,9914
2021/07/27,08:00:00,318.73,671,9724,10395
2021/07/27,08:30:00,284.89,969,9816,10785
2021/07/27,09:00:00,287.16,1268,9942,11210
2021/07/27,09:30:00,287.16,1525,10070,11595
2021/07/27,10:00:00,326.94,1697,10062,11759
2021/07/27,10:30:00,326.94,1815,10032,11847
2021/07/27,11:00:00,327.75,1930,10105,12035
2021/07/27,11:30:00,327.75,1998,10223,12221
2021/07/27,12:00:00,329.8,2051,10316,12367
2021/07/27,12:30:00,331.87,2074,10456,12530
2021/07/27,13:00:00,331.87,2098,10582,12680
2021/07/27,13:30:00,331.87,2091,10783,12874
2021/07/27,14:00:00,307.16,2059,10922,12981
2021/07/27,14:30:00,297.47,2008,11091,13099
2021/07/27,15:00:00,297.47,1932,11229,13161
2021/07/27,15:30:00,293.61,1815,11340,13155
2021/07/27,16:00:00,293.51,1665,11384,13049
2021/07/27,16:30:00,299.51,1557,11519,13076
2021/07/27,17:00:00,313.42,1257,11604,12861
2021/07/27,17:30:00,318.22,1042,11833,12875
2021/07/27,18:00:00,296.16,830,11945,12775
2021/07/27,18:30:00,295.54,550,11935,12485
2021/07/27,19:00:00,295.59,434,11915,12349
2021/07/27,19:30:00,292.95,131,11815,11946
2021/07/27,20:00:00,300.56,135,11966,12101
2021/07/27,20:30:00,291.83,136,11946,12082
2021/07/27,21:00:00,300.82,138,11828,11966
2021/07/27,21:30:00,292.35,138,11669,11807
2021/07/27,22:00:00,298.17,135,11383,11518
2021/07/27,22:30:00,294.33,134,11085,11219
2021/07/27,23:00:00,293.88,133,10766,10899
2021/07/27,23:30:00,290.8,133,10390,10523
2021/07/28,00:00:00,336.1,132,10067,10199
2021/07/28,00:30:00,334.61,134,9721,9855
2021/07/28,01:00:00,304.04,131,9459,9590
2021/07/28,01:30:00,345.59,130,9438,9568
2021/07/28,02:00:00,335.48,123,9298,9421
2021/07/28,02:30:00,335.49,68,9157,9225
2021/07/28,03:00:00,338.68,15,9066,9081
2021/07/28,03:30:00,343.77,11,8948,8959
2021/07/28,04:00:00,338.68,14,8905,8919
2021/07/28,04:30:00,222.38,14,8847,8861
2021/07/28,05:00:00,221.17,11,8857,8868
2021/07/28,05:30:00,223.03,11,8867,8878
2021/07/28,06:00:00,222.38,10,8757,8767
2021/07/28,06:30:00,222.38,89,8959,9048
2021/07/28,07:00:00,221.76,203,9192,9395
2021/07/28,07:30:00,345.03,379,9564,9943
2021/07/28,08:00:00,345.03,771,9719,10490
2021/07/28,08:30:00,297.12,1098,9892,10990
2021/07/28,09:00:00,336.32,1324,10078,11402
2021/07/28,09:30:00,316.94,1561,10241,11802
2021/07/28,10:00:00,306.63,1685,10238,11923
2021/07/28,10:30:00,306.63,1819,10332,12151
2021/07/28,11:00:00,343.04,1898,10430,12328
2021/07/28,11:30:00,331.2,1987,10402,12389
2021/07/28,12:00:00,327.24,2029,10393,12422
2021/07/28,12:30:00,335.45,2032,10579,12611
2021/07/28,13:00:00,325.32,2072,10792,12864
2021/07/28,13:30:00,326.18,2064,11030,13094
2021/07/28,14:00:00,329.81,2054,11213,13267
2021/07/28,14:30:00,324.6,2017,11363,13380
2021/07/28,15:00:00,324.6,1946,11488,13434
2021/07/28,15:30:00,340.93,1855,11571,13426
2021/07/28,16:00:00,337.31,1710,11628,13338
2021/07/28,16:30:00,330.29,1522,11787,13309
2021/07/28,17:00:00,312.28,1278,11920,13198
2021/07/28,17:30:00,317.72,1057,12072,13129
2021/07/28,18:00:00,347.54,816,12170,12986
2021/07/28,18:30:00,345.9,573,12187,12760
2021/07/28,19:00:00,326.18,354,12174,12528
2021/07/28,19:30:00,328.37,137,12069,12206
2021/07/28,20:00:00,313.56,141,12275,12416
2021/07/28,20:30:00,313.31,137,12224,12361
2021/07/28,21:00:00,314.38,136,12094,12230
2021/07/28,21:30:00,311.67,136,11923,12059
2021/07/28,22:00:00,312.09,138,11636,11774
2021/07/28,22:30:00,326.79,140,11315,11455
2021/07/28,23:00:00,331.06,141,10973,11114
2021/07/28,23:30:00,339.42,141,10558,10699
2021/07/29,00:00:00,336.53,140,10205,10345
2021/07/29,00:30:00,221.17,131,9925,10056
2021/07/29,01:00:00,222.38,136,9751,9887
2021/07/29,01:30:00,222.38,132,9519,9651
2021/07/29,02:00:00,219.19,114,9329,9443
2021/07/29,02:30:00,219.19,24,9233,9257
2021/07/29,03:00:00,219.19,17,9096,9113
2021/07/29,03:30:00,219.81,16,8967,8983
2021/07/29,04:00:00,219.81,18,8915,8933
2021/07/29,04:30:00,219.81,17,8881,8898
2021/07/29,05:00:00,219.81,16,8874,8890
2021/07/29,05:30:00,218.6,15,8931,8946
2021/07/29,06:00:00,219.81,15,8814,8829
2021/07/29,06:30:00,302.7,10,9033,9043
2021/07/29,07:00:00,337.7,162,9283,9445
2021/07/29,07:30:00,314,334,9711,10045
2021/07/29,08:00:00,308.9,560,10176,10736
2021/07/29,08:30:00,306.65,733,10482,11215
2021/07/29,09:00:00,305.84,968,10653,11621
2021/07/29,09:30:00,305.39,1238,10798,12036
2021/07/29,10:00:00,305.39,1568,10673,12241
2021/07/29,10:30:00,306.65,1754,10701,12455
2021/07/29,11:00:00,319.95,1910,10763,12673
2021/07/29,11:30:00,320.64,1979,10848,12827
2021/07/29,12:00:00,312.44,2055,10978,13033
2021/07/29,12:30:00,310.53,2079,11164,13243
2021/07/29,13:00:00,325.8,2071,11131,13202
2021/07/29,13:30:00,325.71,2071,11270,13341
2021/07/29,14:00:00,325.62,2053,11348,13401
2021/07/29,14:30:00,321.41,2009,11561,13570
2021/07/29,15:00:00,330.25,1920,11678,13598
2021/07/29,15:30:00,322.34,1847,11753,13600
2021/07/29,16:00:00,326.17,1673,11752,13425
2021/07/29,16:30:00,321.23,1548,11884,13432
2021/07/29,17:00:00,333.58,1270,11978,13248
2021/07/29,17:30:00,333.6,1025,12132,13157
2021/07/29,18:00:00,315.94,825,12227,13052
2021/07/29,18:30:00,315.23,532,12278,12810
2021/07/29,19:00:00,318.76,404,12187,12591
2021/07/29,19:30:00,316.32,144,12050,12194
2021/07/29,20:00:00,316.37,167,12210,12377
2021/07/29,20:30:00,320.33,170,12050,12220
2021/07/29,21:00:00,313.06,169,11880,12049
2021/07/29,21:30:00,313.11,169,11783,11952
2021/07/29,22:00:00,313.2,166,11423,11589
2021/07/29,22:30:00,341.67,165,11089,11254
2021/07/29,23:00:00,321.32,166,10794,10960
2021/07/29,23:30:00,342.47,166,10458,10624
2021/07/30,00:00:00,294.61,163,10142,10305
2021/07/30,00:30:00,221.15,164,9864,10028
2021/07/30,01:00:00,222.6,162,9719,9881
2021/07/30,01:30:00,220.46,160,9629,9789
2021/07/30,02:00:00,219.81,118,9419,9537
2021/07/30,02:30:00,220.46,40,9277,9317
2021/07/30,03:00:00,220.46,45,9126,9171
2021/07/30,03:30:00,220.46,45,8999,9044
2021/07/30,04:00:00,220.46,46,8884,8930
2021/07/30,04:30:00,220.46,45,8797,8842
2021/07/30,05:00:00,219.81,39,8785,8824
2021/07/30,05:30:00,219.81,36,8749,8785
2021/07/30,06:00:00,220.46,21,8565,8586
2021/07/30,06:30:00,219.81,18,8595,8613
2021/07/30,07:00:00,220.46,196,8620,8816
2021/07/30,07:30:00,280.11,343,8768,9111
2021/07/30,08:00:00,277.9,582,8892,9474
2021/07/30,08:30:00,279.87,836,9060,9896
2021/07/30,09:00:00,277.86,1158,9092,10250
2021/07/30,09:30:00,277.9,1340,9320,10660
2021/07/30,10:00:00,277.9,1531,9363,10894
2021/07/30,10:30:00,279.87,1644,9414,11058
2021/07/30,11:00:00,294.49,1811,9557,11368
2021/07/30,11:30:00,294.26,1881,9582,11463
2021/07/30,12:00:00,289.28,1954,9741,11695
2021/07/30,12:30:00,303.4,1972,9869,11841
2021/07/30,13:00:00,301.77,1981,9989,11970
2021/07/30,13:30:00,302.45,1966,10102,12068
2021/07/30,14:00:00,301.91,1941,10149,12090
2021/07/30,14:30:00,302.45,1854,10274,12128
2021/07/30,15:00:00,301.84,1774,10380,12154
2021/07/30,15:30:00,302.33,1677,10480,12157
2021/07/30,16:00:00,302.33,1543,10610,12153
2021/07/30,16:30:00,303.66,1407,10727,12134
2021/07/30,17:00:00,305.06,1099,10881,11980
2021/07/30,17:30:00,305.09,955,11089,12044
2021/07/30,18:00:00,304.49,680,11286,11966
2021/07/30,18:30:00,304.77,448,11404,11852
2021/07/30,19:00:00,306.59,293,11437,11730
2021/07/30,19:30:00,305.79,126,11244,11370
2021/07/30,20:00:00,335.58,126,11297,11423
2021/07/30,20:30:00,332.87,131,11085,11216
2021/07/30,21:00:00,333.33,132,10858,10990
2021/07/30,21:30:00,336.43,118,10693,10811
2021/07/30,22:00:00,304.41,16,10582,10598
2021/07/30,22:30:00,308.68,13,10414,10427
2021/07/30,23:00:00,306.16,14,10235,10249
2021/07/30,23:30:00,306.08,13,10012,10025
2021/07/31,00:00:00,310.72,11,9774,9785
2021/07/31,00:30:00,297.88,9,9525,9534
2021/07/31,01:00:00,340.44,6,9297,9303
2021/07/31,01:30:00,345.23,7,9345,9352
2021/07/31,02:00:00,345.23,9,9185,9194
2021/07/31,02:30:00,345.23,7,9018,9025
2021/07/31,03:00:00,340.44,6,8900,8906
2021/07/31,03:30:00,340.44,7,8801,8808
2021/07/31,04:00:00,345.23,7,8709,8716
2021/07/31,04:30:00,345.23,7,8654,8661
2021/07/31,05:00:00,340.44,6,8579,8585
2021/07/31,05:30:00,340.44,7,8515,8522
2021/07/31,06:00:00,340.44,6,8284,8290
2021/07/31,06:30:00,340.44,4,8191,8195
2021/07/31,07:00:00,345.23,149,8104,8253
2021/07/31,07:30:00,340.44,312,8135,8447
2021/07/31,08:00:00,345.23,591,8122,8713
2021/07/31,08:30:00,345.23,911,8066,8977
2021/07/31,09:00:00,335.61,1241,8096,9337
2021/07/31,09:30:00,295.11,1464,8205,9669
2021/07/31,10:00:00,294.57,1625,8378,10003
2021/07/31,10:30:00,295.23,1770,8388,10158
2021/07/31,11:00:00,321.5,1861,8504,10365
2021/07/31,11:30:00,322.9,1931,8690,10621
2021/07/31,12:00:00,301.46,1977,8685,10662
2021/07/31,12:30:00,299,1998,8847,10845
2021/07/31,13:00:00,311.79,2007,9036,11043
2021/07/31,13:30:00,306.72,1999,9144,11143
2021/07/31,14:00:00,311.22,1960,9253,11213
2021/07/31,14:30:00,301.26,1907,9367,11274
2021/07/31,15:00:00,356.08,1844,9537,11381
2021/07/31,15:30:00,356.08,1703,9709,11412
2021/07/31,16:00:00,351.29,1580,9860,11440
2021/07/31,16:30:00,351.29,1412,10076,11488
2021/07/31,17:00:00,356.08,1148,10221,11369
2021/07/31,17:30:00,356.08,975,10426,11401
2021/07/31,18:00:00,351.55,677,10655,11332
2021/07/31,18:30:00,351.55,470,10745,11215
2021/07/31,19:00:00,356.08,341,10735,11076
2021/07/31,19:30:00,356.08,143,10764,10907
2021/07/31,20:00:00,356.08,128,10980,11108
2021/07/31,20:30:00,356.08,130,10963,11093
2021/07/31,21:00:00,350.2,130,10940,11070
2021/07/31,21:30:00,356.08,128,10871,10999
2021/07/31,22:00:00,341.6,127,10697,10824
2021/07/31,22:30:00,309.53,124,10500,10624
2021/07/31,23:00:00,301.25,121,10262,10383
2021/07/31,23:30:00,307.05,120,9933,10053
2021/08/01,00:00:00,284.92,4,9748,9752
2021/08/01,00:30:00,289.9,4,9451,9455
2021/08/01,01:00:00,292.19,4,9311,9315
2021/08/01,01:30:00,292.07,3,9042,9045
2021/08/01,02:00:00,289.83,3,8821,8824
2021/08/01,02:30:00,290.2,2,8767,8769
2021/08/01,03:00:00,293.36,2,8640,8642
2021/08/01,03:30:00,293.34,1,8509,8510
2021/08/01,04:00:00,234.86,1,8429,8430
2021/08/01,04:30:00,234.86,1,8394,8395
2021/08/01,05:00:00,234.86,2,8347,8349
2021/08/01,05:30:00,234.37,1,8393,8394
2021/08/01,06:00:00,234.13,1,8313,8314
2021/08/01,06:30:00,233.66,3,8461,8464
2021/08/01,07:00:00,233.89,166,8579,8745
2021/08/01,07:30:00,233.89,400,8904,9304
2021/08/01,08:00:00,336.98,721,9107,9828
2021/08/01,08:30:00,301.17,1055,9206,10261
2021/08/01,09:00:00,301.61,1318,9453,10771
2021/08/01,09:30:00,304.47,1480,9718,11198
2021/08/01,10:00:00,302.05,1653,9840,11493
2021/08/01,10:30:00,302.74,1771,9981,11752
2021/08/01,11:00:00,327.33,1873,10133,12006
2021/08/01,11:30:00,322.69,1954,10245,12199
2021/08/01,12:00:00,322.9,1985,10426,12411
2021/08/01,12:30:00,328.08,2008,10632,12640
2021/08/01,13:00:00,326.23,2013,10840,12853
2021/08/01,13:30:00,308.84,2005,11113,13118
2021/08/01,14:00:00,309.42,1983,11235,13218
2021/08/01,14:30:00,326.35,1940,11417,13357
2021/08/01,15:00:00,308.96,1866,11585,13451
2021/08/01,15:30:00,308.05,1750,11647,13397
2021/08/01,16:00:00,308.01,1621,11670,13291
2021/08/01,16:30:00,307.94,1432,11811,13243
2021/08/01,17:00:00,308.68,1201,11854,13055
2021/08/01,17:30:00,308.88,1001,11990,12991
2021/08/01,18:00:00,308.81,754,12001,12755
2021/08/01,18:30:00,308.81,493,12025,12518
2021/08/01,19:00:00,332.05,317,11926,12243
2021/08/01,19:30:00,335.49,148,11829,11977
2021/08/01,20:00:00,345.52,167,11942,12109
2021/08/01,20:30:00,335.8,167,11836,12003
2021/08/01,21:00:00,340.45,166,11753,11919
2021/08/01,21:30:00,316.88,168,11565,11733
2021/08/01,22:00:00,337.22,164,11221,11385
2021/08/01,22:30:00,316.66,161,10893,11054
2021/08/01,23:00:00,321.17,162,10573,10735
2021/08/01,23:30:00,302.72,160,10207,10367
2021/08/02,00:00:00,233.89,157,10020,10177
2021/08/02,00:30:00,233.89,159,9681,9840
2021/08/02,01:00:00,234.13,159,9381,9540
2021/08/02,01:30:00,234.13,158,9283,9441
2021/08/02,02:00:00,233.89,156,9057,9213
2021/08/02,02:30:00,234.13,116,8903,9019
2021/08/02,03:00:00,233.89,34,8846,8880
2021/08/02,03:30:00,233.89,34,8689,8723
2021/08/02,04:00:00,233.89,33,8608,8641
2021/08/02,04:30:00,234.13,35,8556,8591
2021/08/02,05:00:00,233.89,31,8544,8575
2021/08/02,05:30:00,233.89,34,8581,8615
2021/08/02,06:00:00,233.89,26,8416,8442
2021/08/02,06:30:00,234.13,7,8645,8652
2021/08/02,07:00:00,234.13,183,8877,9060
2021/08/02,07:30:00,233.89,402,9222,9624
2021/08/02,08:00:00,233.89,723,9330,10053
2021/08/02,08:30:00,233.89,1108,9581,10689
2021/08/02,09:00:00,233.89,1334,9837,11171
2021/08/02,09:30:00,233.89,1509,9977,11486
2021/08/02,10:00:00,233.89,1682,10028,11710
2021/08/02,10:30:00,234.13,1777,10229,12006
2021/08/02,11:00:00,234.13,1892,10231,12123
2021/08/02,11:30:00,234.13,1941,10385,12326
2021/08/02,12:00:00,233.89,1996,10541,12537
2021/08/02,12:30:00,301.21,2028,10786,12814
2021/08/02,13:00:00,340.4,2029,10985,13014
2021/08/02,13:30:00,339.03,2032,11192,13224
2021/08/02,14:00:00,336.4,2002,11368,13370
2021/08/02,14:30:00,337.7,1968,11474,13442
2021/08/02,15:00:00,339.34,1880,11587,13467
2021/08/02,15:30:00,339.34,1798,11663,13461
2021/08/02,16:00:00,339.33,1643,11733,13376
2021/08/02,16:30:00,345.19,1497,11889,13386
2021/08/02,17:00:00,323.23,1210,11955,13165
2021/08/02,17:30:00,343.52,964,12198,13162
2021/08/02,18:00:00,343.85,762,12270,13032
2021/08/02,18:30:00,344.79,460,12260,12720
2021/08/02,19:00:00,341.39,372,12142,12514
2021/08/02,19:30:00,338.28,148,11993,12141
2021/08/02,20:00:00,343.52,166,12121,12287
2021/08/02,20:30:00,340.32,165,12052,12217
2021/08/02,21:00:00,343.26,163,11924,12087
2021/08/02,21:30:00,332.22,157,11769,11926
2021/08/02,22:00:00,304.78,156,11412,11568
2021/08/02,22:30:00,300.73,155,11100,11255
2021/08/02,23:00:00,352.02,155,10749,10904
2021/08/02,23:30:00,298.21,156,10369,10525
2021/08/03,00:00:00,289.64,155,10057,10212
2021/08/03,00:30:00,282.36,153,9863,10016
2021/08/03,01:00:00,282.19,150,9565,9715
2021/08/03,01:30:00,282.13,147,9468,9615
2021/08/03,02:00:00,284.51,112,9235,9347
2021/08/03,02:30:00,286.24,29,9168,9197
2021/08/03,03:00:00,289.5,27,8982,9009
2021/08/03,03:30:00,263.84,27,8870,8897
2021/08/03,04:00:00,263.76,32,8750,8782
2021/08/03,04:30:00,263.46,32,8734,8766
2021/08/03,05:00:00,234.61,31,8681,8712
2021/08/03,05:30:00,234.61,30,8711,8741
2021/08/03,06:00:00,234.86,18,8603,8621
2021/08/03,06:30:00,234.61,16,8729,8745
2021/08/03,07:00:00,234.37,194,8863,9057
2021/08/03,07:30:00,234.37,399,9130,9529
2021/08/03,08:00:00,266.67,703,9340,10043
2021/08/03,08:30:00,292.83,1080,9621,10701
2021/08/03,09:00:00,343.63,1270,9906,11176
2021/08/03,09:30:00,335,1490,10217,11707
2021/08/03,10:00:00,336.42,1631,10302,11933
2021/08/03,10:30:00,337.88,1767,10403,12170
2021/08/03,11:00:00,341.47,1863,10579,12442
2021/08/03,11:30:00,341.7,1929,10517,12446
2021/08/03,12:00:00,340.35,1983,10695,12678
2021/08/03,12:30:00,343.17,2000,10924,12924
2021/08/03,13:00:00,341.7,2005,11128,13133
2021/08/03,13:30:00,341.7,2007,11410,13417
2021/08/03,14:00:00,338.09,1979,11571,13550
2021/08/03,14:30:00,338.09,1908,11801,13709
2021/08/03,15:00:00,339.59,1838,11942,13780
2021/08/03,15:30:00,340.89,1737,12074,13811
2021/08/03,16:00:00,320.33,1604,12105,13709
2021/08/03,16:30:00,1963.12,1491,12256,13747
2021/08/03,17:00:00,1986.14,1160,12352,13512
2021/08/03,17:30:00,1963.12,953,12542,13495
2021/08/03,18:00:00,1974.55,723,12614,13337
2021/08/03,18:30:00,1974.55,472,12540,13012
2021/08/03,19:00:00,1997.9,413,12453,12866
2021/08/03,19:30:00,1986.14,145,12290,12435
2021/08/03,20:00:00,312.44,153,12438,12591
2021/08/03,20:30:00,316.58,156,12264,12420
2021/08/03,21:00:00,343.63,156,12100,12256
2021/08/03,21:30:00,345.7,150,11967,12117
2021/08/03,22:00:00,338.94,151,11609,11760
2021/08/03,22:30:00,336.67,151,11332,11483
2021/08/03,23:00:00,340.31,150,10990,11140
2021/08/03,23:30:00,341.2,150,10564,10714
2021/08/04,00:00:00,295.53,78,10312,10390
2021/08/04,00:30:00,299.07,54,9949,10003
2021/08/04,01:00:00,295.87,32,9830,9862
2021/08/04,01:30:00,295.34,32,9779,9811
2021/08/04,02:00:00,295.36,32,9524,9556
2021/08/04,02:30:00,293.96,32,9357,9389
2021/08/04,03:00:00,337.56,32,9181,9213
2021/08/04,03:30:00,233.66,32,9096,9128
2021/08/04,04:00:00,233.89,32,8989,9021
2021/08/04,04:30:00,233.21,31,8922,8953
2021/08/04,05:00:00,233.89,31,8926,8957
2021/08/04,05:30:00,232.34,30,8917,8947
2021/08/04,06:00:00,233.89,21,8760,8781
2021/08/04,06:30:00,234.37,15,8907,8922
2021/08/04,07:00:00,295.06,169,9098,9267
2021/08/04,07:30:00,295.06,363,9386,9749
2021/08/04,08:00:00,296.69,670,9593,10263
2021/08/04,08:30:00,314.99,952,9893,10845
2021/08/04,09:00:00,317.23,1228,10129,11357
2021/08/04,09:30:00,309.44,1383,10426,11809
2021/08/04,10:00:00,309.45,1516,10510,12026
2021/08/04,10:30:00,311.01,1629,10758,12387
2021/08/04,11:00:00,314.26,1701,10928,12629
2021/08/04,11:30:00,327.73,1914,10851,12765
2021/08/04,12:00:00,322.7,1952,11061,13013
2021/08/04,12:30:00,318.96,1973,11266,13239
2021/08/04,13:00:00,319.98,1952,11569,13521
2021/08/04,13:30:00,321,1955,11817,13772
2021/08/04,14:00:00,336.48,1917,12000,13917
2021/08/04,14:30:00,330.89,1905,12101,14006
2021/08/04,15:00:00,340.16,1838,12203,14041
2021/08/04,15:30:00,336.76,1719,12276,13995
2021/08/04,16:00:00,336.77,1605,12326,13931
2021/08/04,16:30:00,327.08,1406,12460,13866
2021/08/04,17:00:00,318.16,1141,12617,13758
2021/08/04,17:30:00,317.2,917,12829,13746
2021/08/04,18:00:00,1731.6,656,12933,13589
2021/08/04,18:30:00,1619.32,452,12875,13327
2021/08/04,19:00:00,1986.14,296,12695,12991
2021/08/04,19:30:00,1986.14,131,12513,12644
2021/08/04,20:00:00,1974.55,127,12609,12736
2021/08/04,20:30:00,1986.14,118,12551,12669
2021/08/04,21:00:00,1952.07,119,12395,12514
2021/08/04,21:30:00,339.99,118,12168,12286
2021/08/04,22:00:00,314.26,114,11884,11998
2021/08/04,22:30:00,338.66,119,11433,11552
2021/08/04,23:00:00,342.78,119,11170,11289
2021/08/04,23:30:00,343.13,112,10767,10879
2021/08/05,00:00:00,342.55,41,10501,10542
2021/08/05,00:30:00,334.44,1,10189,10190
2021/08/05,01:00:00,332.27,1,10189,10190
2021/08/05,01:30:00,294.4,1,9868,9869
2021/08/05,02:00:00,293.43,0,9658,9658
2021/08/05,02:30:00,345.6,1,9465,9466
2021/08/05,03:00:00,234.61,1,9305,9306
2021/08/05,03:30:00,234.61,0,9152,9152
2021/08/05,04:00:00,234.61,0,9087,9087
2021/08/05,04:30:00,234.37,0,9030,9030
2021/08/05,05:00:00,234.86,0,8969,8969
2021/08/05,05:30:00,234.61,0,8971,8971
2021/08/05,06:00:00,234.61,0,8876,8876
2021/08/05,06:30:00,234.61,0,8969,8969
2021/08/05,07:00:00,234.13,126,9180,9306
2021/08/05,07:30:00,296.01,360,9520,9880
2021/08/05,08:00:00,294.85,630,9672,10302
2021/08/05,08:30:00,307.68,931,10009,10940
2021/08/05,09:00:00,321.95,1235,10290,11525
2021/08/05,09:30:00,307.93,1383,10611,11994
2021/08/05,10:00:00,310.4,1573,10811,12384
2021/08/05,10:30:00,310.66,1690,11021,12711
2021/08/05,11:00:00,325.3,1804,11058,12862
2021/08/05,11:30:00,310.91,1892,11305,13197
2021/08/05,12:00:00,313.23,1923,11506,13429
2021/08/05,12:30:00,311.44,1969,11561,13530
2021/08/05,13:00:00,311.54,1966,11776,13742
2021/08/05,13:30:00,312.03,1970,11943,13913
2021/08/05,14:00:00,314.1,1949,12075,14024
2021/08/05,14:30:00,1963.12,1902,12218,14120
2021/08/05,15:00:00,1986.14,1806,12328,14134
2021/08/05,15:30:00,1986.14,1709,12398,14107
2021/08/05,16:00:00,1986.14,1538,12428,13966
2021/08/05,16:30:00,1986.14,1394,12496,13890
2021/08/05,17:00:00,1974.55,1129,12608,13737
2021/08/05,17:30:00,1929.84,883,12778,13661
2021/08/05,18:00:00,1963.12,691,12857,13548
2021/08/05,18:30:00,1997.9,452,12824,13276
2021/08/05,19:00:00,1997.9,346,12614,12960
2021/08/05,19:30:00,1986.14,154,12469,12623
2021/08/05,20:00:00,1929.84,155,12627,12782
2021/08/05,20:30:00,1929.84,154,12474,12628
2021/08/05,21:00:00,312.99,153,12270,12423
2021/08/05,21:30:00,312.74,148,12065,12213
2021/08/05,22:00:00,341.99,145,11702,11847
2021/08/05,22:30:00,325.7,76,11431,11507
2021/08/05,23:00:00,331.96,33,11141,11174
2021/08/05,23:30:00,341.07,33,10792,10825
2021/08/06,00:00:00,302.74,32,10466,10498
2021/08/06,00:30:00,355.81,33,10216,10249
2021/08/06,01:00:00,302.87,33,9913,9946
2021/08/06,01:30:00,302.79,34,9581,9615
2021/08/06,02:00:00,355.81,35,9376,9411
2021/08/06,02:30:00,351.48,35,9473,9508
2021/08/06,03:00:00,301.79,35,9260,9295
2021/08/06,03:30:00,340.23,35,9135,9170
2021/08/06,04:00:00,297.96,35,9052,9087
2021/08/06,04:30:00,335.58,36,8972,9008
2021/08/06,05:00:00,339.37,33,8938,8971
2021/08/06,05:30:00,335.58,28,8912,8940
2021/08/06,06:00:00,335.58,24,8690,8714
2021/08/06,06:30:00,312.39,19,8618,8637
2021/08/06,07:00:00,300.72,162,8683,8845
2021/08/06,07:30:00,308.76,370,8799,9169
2021/08/06,08:00:00,303.72,608,8900,9508
2021/08/06,08:30:00,306.6,969,9011,9980
2021/08/06,09:00:00,304.59,1223,9229,10452
2021/08/06,09:30:00,307.5,1422,9554,10976
2021/08/06,10:00:00,306.55,1596,9820,11416
2021/08/06,10:30:00,306.79,1697,10049,11746
2021/08/06,11:00:00,341.15,1804,10280,12084
2021/08/06,11:30:00,325.36,1879,10491,12370
2021/08/06,12:00:00,327.8,1920,10511,12431
2021/08/06,12:30:00,322.95,1957,10711,12668
2021/08/06,13:00:00,323.53,1972,10828,12800
2021/08/06,13:30:00,323.6,1964,10811,12775
2021/08/06,14:00:00,328.47,1938,10898,12836
2021/08/06,14:30:00,328.53,1883,11042,12925
2021/08/06,15:00:00,323.75,1794,11131,12925
2021/08/06,15:30:00,323.71,1690,11230,12920
2021/08/06,16:00:00,326.28,1537,11309,12846
2021/08/06,16:30:00,323.78,1344,11456,12800
2021/08/06,17:00:00,320.9,1133,11528,12661
2021/08/06,17:30:00,320.9,867,11695,12562
2021/08/06,18:00:00,320.78,645,11876,12521
2021/08/06,18:30:00,321.04,423,11934,12357
2021/08/06,19:00:00,325.94,280,11914,12194
2021/08/06,19:30:00,351.43,132,11667,11799
2021/08/06,20:00:00,352.89,150,11619,11769
2021/08/06,20:30:00,339.04,154,11397,11551
2021/08/06,21:00:00,355.81,153,11196,11349
2021/08/06,21:30:00,355.81,152,10996,11148
2021/08/06,22:00:00,352.81,152,10816,10968
2021/08/06,22:30:00,335.01,153,10603,10756
2021/08/06,23:00:00,338.42,150,10431,10581
2021/08/06,23:30:00,337.87,153,10234,10387
2021/08/07,00:00:00,291.17,143,9976,10119
2021/08/07,00:30:00,293.15,79,9773,9852
2021/08/07,01:00:00,288.82,33,9542,9575
2021/08/07,01:30:00,338.25,33,9462,9495
2021/08/07,02:00:00,294.5,33,9239,9272
2021/08/07,02:30:00,233.43,33,9205,9238
2021/08/07,03:00:00,233.21,32,9057,9089
2021/08/07,03:30:00,233.21,32,8933,8965
2021/08/07,04:00:00,232.99,33,8847,8880
2021/08/07,04:30:00,233.43,34,8775,8809
2021/08/07,05:00:00,233.43,33,8726,8759
2021/08/07,05:30:00,233.66,32,8636,8668
2021/08/07,06:00:00,233.75,22,8416,8438
2021/08/07,06:30:00,233.43,14,8327,8341
2021/08/07,07:00:00,233.21,168,8257,8425
2021/08/07,07:30:00,233.66,398,8244,8642
2021/08/07,08:00:00,233.21,698,8186,8884
2021/08/07,08:30:00,233.89,1051,8203,9254
2021/08/07,09:00:00,233.89,1303,8366,9669
2021/08/07,09:30:00,275.5,1467,8694,10161
2021/08/07,10:00:00,276.32,1669,9000,10669
2021/08/07,10:30:00,314.46,1775,9296,11071
2021/08/07,11:00:00,303.91,1878,9533,11411
2021/08/07,11:30:00,303.96,1953,9696,11649
2021/08/07,12:00:00,301.85,1994,9867,11861
2021/08/07,12:30:00,317.08,2017,10062,12079
2021/08/07,13:00:00,333.24,2022,10142,12164
2021/08/07,13:30:00,334.3,2017,10303,12320
2021/08/07,14:00:00,335.41,1989,10249,12238
2021/08/07,14:30:00,335.41,1949,10359,12308
2021/08/07,15:00:00,335.41,1828,10495,12323
2021/08/07,15:30:00,354.3,1718,10677,12395
2021/08/07,16:00:00,355.93,1562,10909,12471
2021/08/07,16:30:00,355.93,1344,11100,12444
2021/08/07,17:00:00,355.98,1133,11199,12332
2021/08/07,17:30:00,355.98,872,11468,12340
2021/08/07,18:00:00,349.95,608,11607,12215
2021/08/07,18:30:00,355.91,391,11656,12047
2021/08/07,19:00:00,350.19,144,11587,11731
2021/08/07,19:30:00,351.54,145,11583,11728
2021/08/07,20:00:00,350.19,151,11820,11971
2021/08/07,20:30:00,351.54,154,11747,11901
2021/08/07,21:00:00,351.36,161,11789,11950
2021/08/07,21:30:00,354.39,159,11708,11867
2021/08/07,22:00:00,354.25,161,11569,11730
2021/08/07,22:30:00,355.93,157,11381,11538
2021/08/07,23:00:00,355.93,155,11145,11300
2021/08/07,23:30:00,299.28,155,10806,10961
2021/08/08,00:00:00,294.05,153,10454,10607
2021/08/08,00:30:00,293.97,153,10073,10226
2021/08/08,01:00:00,292.22,152,9801,9953
2021/08/08,01:30:00,292.26,122,9598,9720
2021/08/08,02:00:00,339.4,34,9470,9504
2021/08/08,02:30:00,232.77,34,9573,9607
2021/08/08,03:00:00,232.99,35,9441,9476
2021/08/08,03:30:00,232.99,33,9354,9387
2021/08/08,04:00:00,232.77,33,9301,9334
2021/08/08,04:30:00,232.77,33,9262,9295
2021/08/08,05:00:00,232.77,33,9271,9304
2021/08/08,05:30:00,232.77,32,9345,9377
2021/08/08,06:00:00,232.99,29,9253,9282
2021/08/08,06:30:00,232.99,20,9455,9475
2021/08/08,07:00:00,232.77,141,9745,9886
2021/08/08,07:30:00,291.73,329,10190,10519
2021/08/08,08:00:00,294.83,510,10505,11015
2021/08/08,08:30:00,324.19,728,10863,11591
2021/08/08,09:00:00,308.66,944,11041,11985
2021/08/08,09:30:00,309.14,1187,11185,12372
2021/08/08,10:00:00,309.09,1451,11088,12539
2021/08/08,10:30:00,311.21,1605,10935,12540
2021/08/08,11:00:00,327.53,1753,10836,12589
2021/08/08,11:30:00,331.79,1900,10882,12782
2021/08/08,12:00:00,322.46,1952,10971,12923
2021/08/08,12:30:00,326.95,2010,11098,13108
2021/08/08,13:00:00,322.77,2003,11338,13341
2021/08/08,13:30:00,312.72,2017,11532,13549
2021/08/08,14:00:00,313.91,1977,11748,13725
2021/08/08,14:30:00,316.99,1945,11907,13852
2021/08/08,15:00:00,328.84,1849,12030,13879
2021/08/08,15:30:00,333.09,1766,12082,13848
2021/08/08,16:00:00,340.12,1634,12063,13697
2021/08/08,16:30:00,316.02,1447,12222,13669
2021/08/08,17:00:00,312.96,1169,12256,13425
2021/08/08,17:30:00,311.94,979,12376,13355
2021/08/08,18:00:00,314.6,733,12445,13178
2021/08/08,18:30:00,314.88,484,12459,12943
2021/08/08,19:00:00,316.26,139,12337,12476
2021/08/08,19:30:00,340.25,156,12229,12385
2021/08/08,20:00:00,316.41,163,12483,12646
2021/08/08,20:30:00,316.41,160,12432,12592
2021/08/08,21:00:00,347,162,12288,12450
2021/08/08,21:30:00,341.3,161,12139,12300
2021/08/08,22:00:00,342.67,158,11796,11954
2021/08/08,22:30:00,344.96,159,11508,11667
2021/08/08,23:00:00,298.5,158,11104,11262
2021/08/08,23:30:00,282.34,158,10698,10856
2021/08/09,00:00:00,269.53,156,10359,10515
2021/08/09,00:30:00,330.83,37,10135,10172
2021/08/09,01:00:00,269.49,35,9834,9869
2021/08/09,01:30:00,330.83,35,9726,9761
2021/08/09,02:00:00,293.35,33,9646,9679
2021/08/09,02:30:00,268.03,34,9464,9498
2021/08/09,03:00:00,234.61,35,9297,9332
2021/08/09,03:30:00,234.61,34,9253,9287
2021/08/09,04:00:00,234.86,33,9152,9185
2021/08/09,04:30:00,234.86,33,9182,9215
2021/08/09,05:00:00,234.86,32,9195,9227
2021/08/09,05:30:00,234.86,32,9170,9202
2021/08/09,06:00:00,234.86,29,9133,9162
2021/08/09,06:30:00,234.86,24,9287,9311
2021/08/09,07:00:00,234.86,136,9529,9665
2021/08/09,07:30:00,299.79,350,9919,10269
2021/08/09,08:00:00,297.26,574,10175,10749
2021/08/09,08:30:00,329.59,841,10451,11292
2021/08/09,09:00:00,337.96,1049,10669,11718
2021/08/09,09:30:00,335.42,1227,10882,12109
2021/08/09,10:00:00,346.51,1600,10785,12385
2021/08/09,10:30:00,335.42,1704,10613,12317
2021/08/09,11:00:00,324.34,1854,10715,12569
2021/08/09,11:30:00,344.9,1920,10680,12600
2021/08/09,12:00:00,339.22,1944,10820,12764
2021/08/09,12:30:00,344.9,2023,11009,13032
2021/08/09,13:00:00,324.39,2046,11254,13300
2021/08/09,13:30:00,329.6,2006,11444,13450
2021/08/09,14:00:00,333.02,1983,11605,13588
2021/08/09,14:30:00,314.7,1965,11702,13667
2021/08/09,15:00:00,313.21,1872,11815,13687
2021/08/09,15:30:00,331.97,1762,11941,13703
2021/08/09,16:00:00,345.03,1521,12039,13560
2021/08/09,16:30:00,345.42,1416,12149,13565
2021/08/09,17:00:00,345.42,1188,12199,13387
2021/08/09,17:30:00,344.34,1003,12369,13372
2021/08/09,18:00:00,346.9,750,12447,13197
2021/08/09,18:30:00,362.78,478,12443,12921
2021/08/09,19:00:00,346.35,344,12355,12699
2021/08/09,19:30:00,346.35,150,12326,12476
2021/08/09,20:00:00,346.35,156,12457,12613
2021/08/09,20:30:00,346.31,162,12354,12516
2021/08/09,21:00:00,345.29,162,12261,12423
2021/08/09,21:30:00,345.29,162,12072,12234
2021/08/09,22:00:00,342.37,163,11739,11902
2021/08/09,22:30:00,324.88,163,11489,11652
2021/08/09,23:00:00,326.89,163,11111,11274
2021/08/09,23:30:00,320.3,163,10754,10917
2021/08/10,00:00:00,317.48,158,10399,10557
2021/08/10,00:30:00,300.26,158,10041,10199
2021/08/10,01:00:00,299.3,159,9731,9890
2021/08/10,01:30:00,299.3,158,9668,9826
2021/08/10,02:00:00,300.06,137,9609,9746
2021/08/10,02:30:00,302.64,87,9438,9525
2021/08/10,03:00:00,302.64,37,9322,9359
2021/08/10,03:30:00,295.56,38,9224,9262
2021/08/10,04:00:00,303.63,37,9153,9190
2021/08/10,04:30:00,303.62,37,9128,9165
2021/08/10,05:00:00,299.25,37,9115,9152
2021/08/10,05:30:00,298.21,37,9168,9205
2021/08/10,06:00:00,338.84,31,9117,9148
2021/08/10,06:30:00,295.15,16,9254,9270
2021/08/10,07:00:00,303.59,154,9502,9656
2021/08/10,07:30:00,298.6,385,9841,10226
2021/08/10,08:00:00,298.79,600,10118,10718
2021/08/10,08:30:00,307.51,1004,10297,11301
2021/08/10,09:00:00,329.94,1290,10307,11597
2021/08/10,09:30:00,309.82,1438,10288,11726
2021/08/10,10:00:00,307.63,1675,10253,11928
2021/08/10,10:30:00,315.21,1794,10376,12170
2021/08/10,11:00:00,318.81,1892,10476,12368
2021/08/10,11:30:00,325.18,1976,10628,12604
2021/08/10,12:00:00,318.9,1984,10751,12735
2021/08/10,12:30:00,328.78,2054,10938,12992
2021/08/10,13:00:00,342.61,2055,11149,13204
2021/08/10,13:30:00,338.7,2020,11361,13381
2021/08/10,14:00:00,333.69,2011,11503,13514
2021/08/10,14:30:00,1986.14,2001,11664,13665
2021/08/10,15:00:00,1986.14,1908,11795,13703
2021/08/10,15:30:00,1986.14,1803,11867,13670
2021/08/10,16:00:00,2009.82,1674,11946,13620
2021/08/10,16:30:00,1997.9,1473,12097,13570
2021/08/10,17:00:00,1997.9,1180,12148,13328
2021/08/10,17:30:00,1974.55,1002,12390,13392
2021/08/10,18:00:00,1986.14,724,12501,13225
2021/08/10,18:30:00,1986.14,504,12497,13001
2021/08/10,19:00:00,1974.55,149,12398,12547
2021/08/10,19:30:00,1974.55,152,12356,12508
2021/08/10,20:00:00,1974.55,146,12466,12612
2021/08/10,20:30:00,1908.56,150,12404,12554
2021/08/10,21:00:00,340.68,149,12309,12458
2021/08/10,21:30:00,333.09,151,12097,12248
2021/08/10,22:00:00,334.52,152,11851,12003
2021/08/10,22:30:00,332.65,155,11529,11684
2021/08/10,23:00:00,339.5,156,11171,11327
2021/08/10,23:30:00,344.02,158,10779,10937
2021/08/11,00:00:00,328.98,142,10418,10560
2021/08/11,00:30:00,328.84,88,10069,10157
2021/08/11,01:00:00,318.41,44,9825,9869
2021/08/11,01:30:00,318.3,41,9592,9633
2021/08/11,02:00:00,344.54,40,9683,9723
2021/08/11,02:30:00,334.64,40,9469,9509
2021/08/11,03:00:00,334.64,40,9364,9404
2021/08/11,03:30:00,334.64,38,9179,9217
2021/08/11,04:00:00,332.84,40,9155,9195
2021/08/11,04:30:00,338.38,36,9076,9112
2021/08/11,05:00:00,332.84,36,9036,9072
2021/08/11,05:30:00,331.08,35,9088,9123
2021/08/11,06:00:00,331.08,28,8980,9008
2021/08/11,06:30:00,340.27,13,9143,9156
2021/08/11,07:00:00,331.08,127,9403,9530
2021/08/11,07:30:00,344.36,293,9802,10095
2021/08/11,08:00:00,304.05,548,10070,10618
2021/08/11,08:30:00,337.7,893,10277,11170
2021/08/11,09:00:00,320.59,1237,10426,11663
2021/08/11,09:30:00,335,1374,10463,11837
2021/08/11,10:00:00,343.87,1594,10442,12036
2021/08/11,10:30:00,342.31,1800,10476,12276
2021/08/11,11:00:00,343.88,1870,10781,12651
2021/08/11,11:30:00,343.88,1967,10916,12883
2021/08/11,12:00:00,342.31,2009,11093,13102
2021/08/11,12:30:00,343.88,2006,11154,13160
2021/08/11,13:00:00,343.88,2049,11185,13234
2021/08/11,13:30:00,343.88,2021,11447,13468
2021/08/11,14:00:00,343.88,1985,11635,13620
2021/08/11,14:30:00,342.34,1913,11778,13691
2021/08/11,15:00:00,343.92,1741,11999,13740
2021/08/11,15:30:00,343.92,1634,12040,13674
2021/08/11,16:00:00,342.44,1638,11955,13593
2021/08/11,16:30:00,343.92,1505,12018,13523
2021/08/11,17:00:00,343.93,1171,12139,13310
2021/08/11,17:30:00,341.1,993,12350,13343
2021/08/11,18:00:00,342.17,732,12409,13141
2021/08/11,18:30:00,337.67,473,12506,12979
2021/08/11,19:00:00,344.67,360,12415,12775
2021/08/11,19:30:00,336.96,340,12241,12581
2021/08/11,20:00:00,335.1,127,12598,12725
2021/08/11,20:30:00,334.41,146,12519,12665
2021/08/11,21:00:00,334.15,152,12388,12540
2021/08/11,21:30:00,335.61,155,12298,12453
2021/08/11,22:00:00,339.14,154,12009,12163
2021/08/11,22:30:00,332.76,157,11648,11805
2021/08/11,23:00:00,344.54,151,11318,11469
2021/08/11,23:30:00,320.86,154,10941,11095
2021/08/12,00:00:00,299.95,156,10559,10715
2021/08/12,00:30:00,339.74,101,10287,10388
2021/08/12,01:00:00,336.8,42,10018,10060
2021/08/12,01:30:00,339.74,41,9902,9943
2021/08/12,02:00:00,334.79,38,9808,9846
2021/08/12,02:30:00,338.53,39,9619,9658
2021/08/12,03:00:00,332.99,36,9456,9492
2021/08/12,03:30:00,331.23,37,9352,9389
2021/08/12,04:00:00,340.47,35,9270,9305
2021/08/12,04:30:00,346.63,36,9244,9280
2021/08/12,05:00:00,342.44,37,9222,9259
2021/08/12,05:30:00,331.23,34,9324,9358
2021/08/12,06:00:00,300.63,24,9262,9286
2021/08/12,06:30:00,328.98,15,9422,9437
2021/08/12,07:00:00,334.78,159,9604,9763
2021/08/12,07:30:00,331.23,321,9999,10320
2021/08/12,08:00:00,345.96,657,10124,10781
2021/08/12,08:30:00,344.1,956,10482,11438
2021/08/12,09:00:00,340.87,1155,10729,11884
2021/08/12,09:30:00,345.06,1463,10810,12273
2021/08/12,10:00:00,340.06,1630,10805,12435
2021/08/12,10:30:00,329.23,1728,10897,12625
2021/08/12,11:00:00,317.22,1869,11005,12874
2021/08/12,11:30:00,313.4,1918,11054,12972
2021/08/12,12:00:00,313.4,2000,11163,13163
2021/08/12,12:30:00,317.76,1981,11205,13186
2021/08/12,13:00:00,317.76,1922,11470,13392
2021/08/12,13:30:00,317.76,1881,11604,13485
2021/08/12,14:00:00,328.24,1938,11773,13711
2021/08/12,14:30:00,328.45,1943,11894,13837
2021/08/12,15:00:00,340.69,1832,11996,13828
2021/08/12,15:30:00,339.46,1757,12081,13838
2021/08/12,16:00:00,341.95,1595,12162,13757
2021/08/12,16:30:00,316.25,1374,12321,13695
2021/08/12,17:00:00,341.01,1101,12336,13437
2021/08/12,17:30:00,315.16,966,12471,13437
2021/08/12,18:00:00,343.79,728,12611,13339
2021/08/12,18:30:00,341.64,391,12617,13008
2021/08/12,19:00:00,318.58,135,12525,12660
2021/08/12,19:30:00,326.04,151,12492,12643
2021/08/12,20:00:00,340.24,147,12565,12712
2021/08/12,20:30:00,345.75,129,12477,12606
2021/08/12,21:00:00,316.06,128,12330,12458
2021/08/12,21:30:00,342.94,127,12163,12290
2021/08/12,22:00:00,316.05,126,11860,11986
2021/08/12,22:30:00,330.86,121,11516,11637
2021/08/12,23:00:00,332.79,116,11236,11352
2021/08/12,23:30:00,342.54,91,10913,11004
2021/08/13,00:00:00,301.6,49,10593,10642
2021/08/13,00:30:00,330.98,1,10313,10314
2021/08/13,01:00:00,300.85,0,10027,10027
2021/08/13,01:30:00,297.65,1,9772,9773
2021/08/13,02:00:00,339.31,1,9542,9543
2021/08/13,02:30:00,341.36,2,9451,9453
2021/08/13,03:00:00,341.36,0,9463,9463
2021/08/13,03:30:00,341.36,0,9330,9330
2021/08/13,04:00:00,343.81,0,9191,9191
2021/08/13,04:30:00,341.36,0,9145,9145
2021/08/13,05:00:00,341.36,0,9081,9081
2021/08/13,05:30:00,339.31,0,9015,9015
2021/08/13,06:00:00,339.31,0,8866,8866
2021/08/13,06:30:00,341.36,0,8832,8832
2021/08/13,07:00:00,343.81,124,8855,8979
2021/08/13,07:30:00,344.89,322,9005,9327
2021/08/13,08:00:00,302.16,569,9075,9644
2021/08/13,08:30:00,301.95,933,9262,10195
2021/08/13,09:00:00,302.57,1166,9508,10674
2021/08/13,09:30:00,304.99,1395,9700,11095
2021/08/13,10:00:00,307.82,1654,9793,11447
2021/08/13,10:30:00,308.08,1765,10001,11766
2021/08/13,11:00:00,319.49,1894,10226,12120
2021/08/13,11:30:00,319.69,1968,10396,12364
2021/08/13,12:00:00,310.28,2007,10499,12506
2021/08/13,12:30:00,312.3,2033,10621,12654
2021/08/13,13:00:00,314.3,2037,10773,12810
2021/08/13,13:30:00,314.42,2028,10710,12738
2021/08/13,14:00:00,312.31,2001,10835,12836
2021/08/13,14:30:00,314.79,1952,10913,12865
2021/08/13,15:00:00,314.91,1852,10933,12785
2021/08/13,15:30:00,312.95,1754,11066,12820
2021/08/13,16:00:00,327.55,1596,11127,12723
2021/08/13,16:30:00,313.06,1428,11262,12690
2021/08/13,17:00:00,337.51,1211,11380,12591
2021/08/13,17:30:00,334.71,940,11602,12542
2021/08/13,18:00:00,1974.55,682,11805,12487
2021/08/13,18:30:00,1974.55,446,11942,12388
2021/08/13,19:00:00,1974.55,378,11834,12212
2021/08/13,19:30:00,1986.14,147,11730,11877
2021/08/13,20:00:00,345.32,158,11639,11797
2021/08/13,20:30:00,370.26,159,11431,11590
2021/08/13,21:00:00,370.05,156,11239,11395
2021/08/13,21:30:00,366.69,155,11022,11177
2021/08/13,22:00:00,361.87,154,10825,10979
2021/08/13,22:30:00,358.41,154,10675,10829
2021/08/13,23:00:00,345.45,153,10516,10669
2021/08/13,23:30:00,350.11,152,10279,10431
2021/08/14,00:00:00,324.06,152,10017,10169
2021/08/14,00:30:00,367.25,152,9757,9909
2021/08/14,01:00:00,318.64,149,9488,9637
2021/08/14,01:30:00,318.44,131,9316,9447
2021/08/14,02:00:00,337.71,74,9139,9213
2021/08/14,02:30:00,317.43,31,9050,9081
2021/08/14,03:00:00,373.42,32,8819,8851
2021/08/14,03:30:00,288.28,32,8877,8909
2021/08/14,04:00:00,299.74,32,8795,8827
2021/08/14,04:30:00,299.71,30,8765,8795
2021/08/14,05:00:00,301.98,30,8689,8719
2021/08/14,05:30:00,338.88,30,8798,8828
2021/08/14,06:00:00,234.37,27,8627,8654
2021/08/14,06:30:00,234.86,18,8517,8535
2021/08/14,07:00:00,234.37,119,8442,8561
2021/08/14,07:30:00,234.86,305,8511,8816
2021/08/14,08:00:00,340.1,548,8465,9013
2021/08/14,08:30:00,334.39,764,8545,9309
2021/08/14,09:00:00,334.39,964,8680,9644
2021/08/14,09:30:00,313.98,1103,8888,9991
2021/08/14,10:00:00,305.53,1359,9042,10401
2021/08/14,10:30:00,305.69,1705,9049,10754
2021/08/14,11:00:00,309.87,1837,9203,11040
2021/08/14,11:30:00,339.79,1963,9303,11266
2021/08/14,12:00:00,337.91,2031,9497,11528
2021/08/14,12:30:00,335.19,2039,9591,11630
2021/08/14,13:00:00,333.98,2052,9603,11655
2021/08/14,13:30:00,326.8,2075,9605,11680
2021/08/14,14:00:00,326.92,2050,9668,11718
2021/08/14,14:30:00,313.67,1995,9723,11718
2021/08/14,15:00:00,311.55,1921,9933,11854
2021/08/14,15:30:00,313.54,1794,10064,11858
2021/08/14,16:00:00,310.9,1683,10217,11900
2021/08/14,16:30:00,308.61,1509,10471,11980
2021/08/14,17:00:00,331.36,1175,10609,11784
2021/08/14,17:30:00,331.23,980,10858,11838
2021/08/14,18:00:00,333,679,11054,11733
2021/08/14,18:30:00,332.8,483,11173,11656
2021/08/14,19:00:00,344.03,306,11245,11551
2021/08/14,19:30:00,334.28,123,11340,11463
2021/08/14,20:00:00,341.78,127,11483,11610
2021/08/14,20:30:00,340.91,128,11481,11609
2021/08/14,21:00:00,334.2,130,11485,11615
2021/08/14,21:30:00,334.3,127,11434,11561
2021/08/14,22:00:00,333.34,125,11276,11401
2021/08/14,22:30:00,367.6,125,11131,11256
2021/08/14,23:00:00,368.06,128,10895,11023
2021/08/14,23:30:00,367.84,128,10573,10701
2021/08/15,00:00:00,299.59,128,10206,10334
2021/08/15,00:30:00,344.1,127,9871,9998
2021/08/15,01:00:00,346.27,127,9586,9713
2021/08/15,01:30:00,302.14,104,9441,9545
2021/08/15,02:00:00,336.19,45,9442,9487
2021/08/15,02:30:00,330.11,5,9284,9289
2021/08/15,03:00:00,332.45,5,9107,9112
2021/08/15,03:30:00,329.12,3,8993,8996
2021/08/15,04:00:00,336.18,1,8921,8922
2021/08/15,04:30:00,334.29,1,8884,8885
2021/08/15,05:00:00,338.12,3,8874,8877
2021/08/15,05:30:00,319.76,5,8935,8940
2021/08/15,06:00:00,301.47,4,8890,8894
2021/08/15,06:30:00,300.46,1,9065,9066
2021/08/15,07:00:00,336.18,122,9308,9430
2021/08/15,07:30:00,301.78,273,9709,9982
2021/08/15,08:00:00,332.45,574,10010,10584
2021/08/15,08:30:00,306.81,795,10410,11205
2021/08/15,09:00:00,304.88,1010,10703,11713
2021/08/15,09:30:00,343.68,1376,10710,12086
2021/08/15,10:00:00,317.17,1626,10668,12294
2021/08/15,10:30:00,321.84,1821,10794,12615
2021/08/15,11:00:00,329.74,1892,10748,12640
2021/08/15,11:30:00,322.85,1969,10848,12817
2021/08/15,12:00:00,326.57,2013,10778,12791
2021/08/15,12:30:00,320.27,2068,10926,12994
2021/08/15,13:00:00,322.97,2079,11105,13184
2021/08/15,13:30:00,318.52,2054,11300,13354
2021/08/15,14:00:00,328.43,2052,11431,13483
2021/08/15,14:30:00,339.09,1988,11686,13674
2021/08/15,15:00:00,311.55,1949,11843,13792
2021/08/15,15:30:00,319.27,1821,11993,13814
2021/08/15,16:00:00,324.52,1692,12048,13740
2021/08/15,16:30:00,1986.14,1558,12132,13690
2021/08/15,17:00:00,1974.55,1264,12171,13435
2021/08/15,17:30:00,1974.55,987,12316,13303
2021/08/15,18:00:00,1986.14,760,12208,12968
2021/08/15,18:30:00,1986.14,451,12217,12668
2021/08/15,19:00:00,1974.55,286,12104,12390
2021/08/15,19:30:00,1974.55,131,12129,12260
2021/08/15,20:00:00,1929.84,135,12176,12311
2021/08/15,20:30:00,329.61,136,12122,12258
2021/08/15,21:00:00,329.67,137,12026,12163
2021/08/15,21:30:00,314.7,138,11902,12040
2021/08/15,22:00:00,353.81,134,11633,11767
2021/08/15,22:30:00,341.09,129,11429,11558
2021/08/15,23:00:00,302.73,128,11017,11145
2021/08/15,23:30:00,339.23,126,10658,10784
2021/08/16,00:00:00,293.71,87,10354,10441
2021/08/16,00:30:00,289.43,10,10089,10099
2021/08/16,01:00:00,286.99,10,9741,9751
2021/08/16,01:30:00,287.02,12,9459,9471
2021/08/16,02:00:00,286.99,13,9456,9469
2021/08/16,02:30:00,286.81,14,9381,9395
2021/08/16,03:00:00,287.23,15,9223,9238
2021/08/16,03:30:00,287.1,15,9163,9178
2021/08/16,04:00:00,287,12,9088,9100
2021/08/16,04:30:00,304.11,10,9009,9019
2021/08/16,05:00:00,289.8,12,9083,9095
2021/08/16,05:30:00,289.55,9,9071,9080
2021/08/16,06:00:00,286.62,9,8999,9008
2021/08/16,06:30:00,337.33,8,9159,9167
2021/08/16,07:00:00,337.33,113,9373,9486
2021/08/16,07:30:00,287.88,231,9718,9949
2021/08/16,08:00:00,326.58,342,9977,10319
2021/08/16,08:30:00,332.78,907,10247,11154
2021/08/16,09:00:00,332.81,1194,10353,11547
2021/08/16,09:30:00,355.27,1284,10349,11633
2021/08/16,10:00:00,340.35,567,10336,10903
2021/08/16,10:30:00,348.24,1712,10335,12047
2021/08/16,11:00:00,334.47,1770,10490,12260
2021/08/16,11:30:00,341.65,1972,10553,12525
2021/08/16,12:00:00,350.13,2043,10636,12679
2021/08/16,12:30:00,340.37,2052,10751,12803
2021/08/16,13:00:00,341.7,2092,10945,13037
2021/08/16,13:30:00,341.68,2076,11111,13187
2021/08/16,14:00:00,340.37,2068,11227,13295
2021/08/16,14:30:00,340.37,2007,11399,13406
2021/08/16,15:00:00,350.09,1955,11496,13451
2021/08/16,15:30:00,347.64,1830,11580,13410
2021/08/16,16:00:00,345.75,1712,11679,13391
2021/08/16,16:30:00,351.64,1556,11757,13313
2021/08/16,17:00:00,1974.55,1209,11834,13043
2021/08/16,17:30:00,1963.12,949,11986,12935
2021/08/16,18:00:00,1963.12,754,12083,12837
2021/08/16,18:30:00,1986.14,451,12136,12587
2021/08/16,19:00:00,1974.55,305,12011,12316
2021/08/16,19:30:00,1952.07,134,12053,12187
2021/08/16,20:00:00,1986.14,136,12150,12286
2021/08/16,20:30:00,1986.14,133,12090,12223
2021/08/16,21:00:00,1952.07,133,12001,12134
2021/08/16,21:30:00,1908.56,134,11788,11922
2021/08/16,22:00:00,344.98,134,11484,11618
2021/08/16,22:30:00,340.92,132,11193,11325
2021/08/16,23:00:00,335.73,129,10900,11029
2021/08/16,23:30:00,351.27,128,10433,10561
2021/08/17,00:00:00,294.29,101,10070,10171
2021/08/17,00:30:00,287.42,10,9867,9877
2021/08/17,01:00:00,324.91,10,9641,9651
2021/08/17,01:30:00,336.38,13,9470,9483
2021/08/17,02:00:00,332.69,14,9473,9487
2021/08/17,02:30:00,297.73,13,9236,9249
2021/08/17,03:00:00,337.49,14,9134,9148
2021/08/17,03:30:00,336.38,15,9037,9052
2021/08/17,04:00:00,336.38,15,8957,8972
2021/08/17,04:30:00,337.6,14,8937,8951
2021/08/17,05:00:00,336.38,13,8923,8936
2021/08/17,05:30:00,332.69,12,9027,9039
2021/08/17,06:00:00,332.7,9,8939,8948
2021/08/17,06:30:00,331.17,6,9046,9052
2021/08/17,07:00:00,345.35,145,9254,9399
2021/08/17,07:30:00,313.44,340,9577,9917
2021/08/17,08:00:00,305.08,660,9820,10480
2021/08/17,08:30:00,306.36,941,10039,10980
2021/08/17,09:00:00,306.36,1245,10145,11390
2021/08/17,09:30:00,319.34,1512,10221,11733
2021/08/17,10:00:00,310.9,1669,10286,11955
2021/08/17,10:30:00,319.79,1845,10117,11962
2021/08/17,11:00:00,324.63,1932,10199,12131
2021/08/17,11:30:00,321.15,1964,10149,12113
2021/08/17,12:00:00,337.24,2031,10189,12220
2021/08/17,12:30:00,338.89,2030,10335,12365
2021/08/17,13:00:00,341.9,2063,10543,12606
2021/08/17,13:30:00,329.17,2037,10770,12807
2021/08/17,14:00:00,331.6,2032,10925,12957
2021/08/17,14:30:00,341.96,2000,11112,13112
2021/08/17,15:00:00,333.99,1926,11187,13113
2021/08/17,15:30:00,331.8,1834,11292,13126
2021/08/17,16:00:00,328.17,1672,11386,13058
2021/08/17,16:30:00,318.05,1516,11477,12993
2021/08/17,17:00:00,314.46,1206,11576,12782
2021/08/17,17:30:00,316.22,927,11744,12671
2021/08/17,18:00:00,314.02,742,11839,12581
2021/08/17,18:30:00,1908.56,482,11873,12355
2021/08/17,19:00:00,1908.56,130,11771,11901
2021/08/17,19:30:00,1908.56,126,11867,11993
2021/08/17,20:00:00,1908.56,132,11976,12108
2021/08/17,20:30:00,1868.79,132,11906,12038
2021/08/17,21:00:00,320.33,133,11762,11895
2021/08/17,21:30:00,343.68,131,11648,11779
2021/08/17,22:00:00,316.74,132,11326,11458
2021/08/17,22:30:00,335.56,126,11062,11188
2021/08/17,23:00:00,320.03,125,10694,10819
2021/08/17,23:30:00,345.35,126,10323,10449
2021/08/18,00:00:00,343.56,128,10039,10167
2021/08/18,00:30:00,343.56,128,9828,9956
2021/08/18,01:00:00,328.43,128,9685,9813
2021/08/18,01:30:00,330.76,130,9492,9622
2021/08/18,02:00:00,298.12,124,9212,9336
2021/08/18,02:30:00,297.21,84,9122,9206
2021/08/18,03:00:00,293.55,11,9058,9069
2021/08/18,03:30:00,305.23,11,8968,8979
2021/08/18,04:00:00,305.37,12,8880,8892
2021/08/18,04:30:00,297.13,9,8810,8819
2021/08/18,05:00:00,299.94,7,8855,8862
2021/08/18,05:30:00,299.94,7,8906,8913
2021/08/18,06:00:00,292.74,6,8799,8805
2021/08/18,06:30:00,319.04,3,8908,8911
2021/08/18,07:00:00,317.73,129,9116,9245
2021/08/18,07:30:00,305.03,308,9417,9725
2021/08/18,08:00:00,319.12,591,9591,10182
2021/08/18,08:30:00,306.76,1008,9457,10465
2021/08/18,09:00:00,344.47,1183,9679,10862
2021/08/18,09:30:00,345.57,1303,9743,11046
2021/08/18,10:00:00,345.13,1551,9684,11235
2021/08/18,10:30:00,346.59,1797,9638,11435
2021/08/18,11:00:00,335.74,1907,9673,11580
2021/08/18,11:30:00,234.13,2026,9721,11747
2021/08/18,12:00:00,229.17,2082,9840,11922
2021/08/18,12:30:00,225.68,2095,9998,12093
2021/08/18,13:00:00,226.2,2121,10194,12315
2021/08/18,13:30:00,225.68,2108,10357,12465
2021/08/18,14:00:00,225.68,2076,10531,12607
2021/08/18,14:30:00,223.62,2038,10670,12708
2021/08/18,15:00:00,223.26,1961,10784,12745
2021/08/18,15:30:00,303.83,1850,10866,12716
2021/08/18,16:00:00,311.3,1723,10944,12667
2021/08/18,16:30:00,344.76,1515,11028,12543
2021/08/18,17:00:00,312.79,1237,11077,12314
2021/08/18,17:30:00,341.88,953,11245,12198
2021/08/18,18:00:00,321.28,713,11316,12029
2021/08/18,18:30:00,341.87,497,11334,11831
2021/08/18,19:00:00,341.87,901,11271,12172
2021/08/18,19:30:00,341.87,119,11342,11461
2021/08/18,20:00:00,342.2,119,11391,11510
2021/08/18,20:30:00,340.41,122,11275,11397
2021/08/18,21:00:00,344.56,125,11103,11228
2021/08/18,21:30:00,345.61,123,11012,11135
2021/08/18,22:00:00,342.43,121,10709,10830
2021/08/18,22:30:00,335.52,120,10455,10575
2021/08/18,23:00:00,329.64,116,10159,10275
2021/08/18,23:30:00,308.12,115,9877,9992
2021/08/19,00:00:00,315.51,64,9574,9638
2021/08/19,00:30:00,338.43,7,9334,9341
2021/08/19,01:00:00,299.58,5,9329,9334
2021/08/19,01:30:00,299.44,5,9076,9081
2021/08/19,02:00:00,292.27,3,8885,8888
2021/08/19,02:30:00,299.18,3,8732,8735
2021/08/19,03:00:00,296.58,2,8631,8633
2021/08/19,03:30:00,295.73,5,8490,8495
2021/08/19,04:00:00,291.55,3,8426,8429
2021/08/19,04:30:00,295.48,3,8452,8455
2021/08/19,05:00:00,295.48,5,8446,8451
2021/08/19,05:30:00,298.47,3,8466,8469
2021/08/19,06:00:00,298.32,2,8465,8467
2021/08/19,06:30:00,328.75,2,8564,8566
2021/08/19,07:00:00,337.72,144,8748,8892
2021/08/19,07:30:00,320.56,384,8953,9337
2021/08/19,08:00:00,320.57,727,9024,9751
2021/08/19,08:30:00,313.74,1165,9217,10382
2021/08/19,09:00:00,341.45,1389,9381,10770
2021/08/19,09:30:00,341.45,1538,9418,10956
2021/08/19,10:00:00,317.35,1712,9265,10977
2021/08/19,10:30:00,324.46,1879,9312,11191
2021/08/19,11:00:00,344.57,1964,9377,11341
2021/08/19,11:30:00,328.23,2038,9504,11542
2021/08/19,12:00:00,338.55,2070,9622,11692
2021/08/19,12:30:00,335.52,2094,9823,11917
2021/08/19,13:00:00,333.13,2109,10024,12133
2021/08/19,13:30:00,339.78,2088,10172,12260
2021/08/19,14:00:00,341.05,2086,10324,12410
2021/08/19,14:30:00,337.34,2019,10488,12507
2021/08/19,15:00:00,315.67,1918,10598,12516
2021/08/19,15:30:00,320.01,1803,10706,12509
2021/08/19,16:00:00,340.56,1681,10737,12418
2021/08/19,16:30:00,314.56,1523,10831,12354
2021/08/19,17:00:00,316.93,1168,10912,12080
2021/08/19,17:30:00,341.22,942,11179,12121
2021/08/19,18:00:00,343.98,719,11280,11999
2021/08/19,18:30:00,313.03,480,11290,11770
2021/08/19,19:00:00,346.21,515,11198,11713
2021/08/19,19:30:00,341.75,131,11279,11410
2021/08/19,20:00:00,314.19,130,11283,11413
2021/08/19,20:30:00,314.1,131,11134,11265
2021/08/19,21:00:00,305.65,130,10953,11083
2021/08/19,21:30:00,307.86,128,10855,10983
2021/08/19,22:00:00,318.28,127,10597,10724
2021/08/19,22:30:00,323.06,125,10269,10394
2021/08/19,23:00:00,329.29,120,10010,10130
2021/08/19,23:30:00,335.15,122,9742,9864
2021/08/20,00:00:00,338.47,119,9457,9576
2021/08/20,00:30:00,339.37,58,9222,9280
2021/08/20,01:00:00,333.88,7,9169,9176
2021/08/20,01:30:00,335.37,6,9059,9065
2021/08/20,02:00:00,343.83,5,8836,8841
2021/08/20,02:30:00,330.85,5,8688,8693
2021/08/20,03:00:00,332.33,5,8508,8513
2021/08/20,03:30:00,338.59,4,8420,8424
2021/08/20,04:00:00,344.09,3,8317,8320
2021/08/20,04:30:00,337.85,3,8275,8278
2021/08/20,05:00:00,345.99,3,8258,8261
2021/08/20,05:30:00,341.76,3,8254,8257
2021/08/20,06:00:00,332.32,2,8144,8146
2021/08/20,06:30:00,339.75,1,8116,8117
2021/08/20,07:00:00,345.99,138,8104,8242
2021/08/20,07:30:00,334.66,340,8232,8572
2021/08/20,08:00:00,342.3,772,8212,8984
2021/08/20,08:30:00,343.93,1105,8316,9421
2021/08/20,09:00:00,340.79,1362,8450,9812
2021/08/20,09:30:00,345.6,1598,8599,10197
2021/08/20,10:00:00,343.93,1729,8801,10530
2021/08/20,10:30:00,304.67,1862,8990,10852
2021/08/20,11:00:00,333.7,1977,9100,11077
2021/08/20,11:30:00,328.33,2032,9168,11200
2021/08/20,12:00:00,343.21,2083,9195,11278
2021/08/20,12:30:00,335.75,2104,9354,11458
2021/08/20,13:00:00,339.81,2108,9502,11610
2021/08/20,13:30:00,342.42,2094,9655,11749
2021/08/20,14:00:00,345.12,2060,9854,11914
2021/08/20,14:30:00,339.82,2016,9990,12006
2021/08/20,15:00:00,341.93,1920,10083,12003
2021/08/20,15:30:00,338.04,1829,10179,12008
2021/08/20,16:00:00,336.82,1666,10342,12008
2021/08/20,16:30:00,341.2,1459,10596,12055
2021/08/20,17:00:00,340.82,1224,10669,11893
2021/08/20,17:30:00,344.47,928,10962,11890
2021/08/20,18:00:00,340.46,672,11184,11856
2021/08/20,18:30:00,340.52,479,11392,11871
2021/08/20,19:00:00,342.58,721,11329,12050
2021/08/20,19:30:00,346.1,117,11298,11415
2021/08/20,20:00:00,346.1,130,11193,11323
2021/08/20,20:30:00,340.01,130,10952,11082
2021/08/20,21:00:00,346.83,130,10737,10867
2021/08/20,21:30:00,341.29,128,10519,10647
2021/08/20,22:00:00,340.02,128,10323,10451
2021/08/20,22:30:00,327.02,129,10187,10316
2021/08/20,23:00:00,318.44,126,10002,10128
2021/08/20,23:30:00,340.02,122,9772,9894
2021/08/21,00:00:00,306.32,122,9531,9653
2021/08/21,00:30:00,304.73,122,9250,9372
2021/08/21,01:00:00,305.08,123,9044,9167
2021/08/21,01:30:00,304.55,125,8973,9098
2021/08/21,02:00:00,331.55,124,8941,9065
2021/08/21,02:30:00,340.31,82,8840,8922
2021/08/21,03:00:00,343.86,5,8764,8769
2021/08/21,03:30:00,342.39,5,8654,8659
2021/08/21,04:00:00,334.8,3,8573,8576
2021/08/21,04:30:00,333.01,2,8530,8532
2021/08/21,05:00:00,338.55,1,8455,8456
2021/08/21,05:30:00,234.61,2,8419,8421
2021/08/21,06:00:00,234.37,3,8270,8273
2021/08/21,06:30:00,234.13,339,8187,8526
2021/08/21,07:00:00,234.37,122,8055,8177
2021/08/21,07:30:00,234.13,256,8072,8328
2021/08/21,08:00:00,234.13,444,8054,8498
2021/08/21,08:30:00,336.41,708,8206,8914
2021/08/21,09:00:00,332.46,1049,8138,9187
2021/08/21,09:30:00,330.4,1380,8128,9508
2021/08/21,10:00:00,299.08,1653,8345,9998
2021/08/21,10:30:00,299.04,1830,8585,10415
2021/08/21,11:00:00,300.29,1882,8621,10503
2021/08/21,11:30:00,301.65,2023,8695,10718
2021/08/21,12:00:00,301.72,2045,8821,10866
2021/08/21,12:30:00,303.27,2067,9041,11108
2021/08/21,13:00:00,303.43,2088,9238,11326
2021/08/21,13:30:00,303.54,2086,9402,11488
2021/08/21,14:00:00,307.39,2056,9470,11526
2021/08/21,14:30:00,318.58,1982,9653,11635
2021/08/21,15:00:00,321.36,1915,9836,11751
2021/08/21,15:30:00,318.59,1760,10023,11783
2021/08/21,16:00:00,340.28,1621,10173,11794
2021/08/21,16:30:00,342.19,1449,10380,11829
2021/08/21,17:00:00,342.19,1134,10566,11700
2021/08/21,17:30:00,342.19,855,10807,11662
2021/08/21,18:00:00,345.18,639,10912,11551
2021/08/21,18:30:00,342.67,416,11002,11418
2021/08/21,19:00:00,344.17,763,11024,11787
2021/08/21,19:30:00,341.52,220,11210,11430
2021/08/21,20:00:00,344.17,127,11311,11438
2021/08/21,20:30:00,344.17,124,11318,11442
2021/08/21,21:00:00,343.9,124,11310,11434
2021/08/21,21:30:00,347.76,125,11232,11357
2021/08/21,22:00:00,346.08,124,11110,11234
2021/08/21,22:30:00,341.97,122,10915,11037
2021/08/21,23:00:00,336.61,122,10622,10744
2021/08/21,23:30:00,310.07,78,10360,10438
2021/08/22,00:00:00,316.58,45,10074,10119
2021/08/22,00:30:00,339.74,12,9747,9759
2021/08/22,01:00:00,341.31,13,9449,9462
2021/08/22,01:30:00,342.9,11,9155,9166
2021/08/22,02:00:00,341.31,7,8949,8956
2021/08/22,02:30:00,344.27,6,8988,8994
2021/08/22,03:00:00,342.27,6,8927,8933
2021/08/22,03:30:00,300.99,5,8804,8809
2021/08/22,04:00:00,343.32,4,8752,8756
2021/08/22,04:30:00,332.62,7,8732,8739
2021/08/22,05:00:00,334.3,4,8760,8764
2021/08/22,05:30:00,341.44,4,8840,8844
2021/08/22,06:00:00,297.46,3,8823,8826
2021/08/22,06:30:00,342.27,3,9001,9004
2021/08/22,07:00:00,330.86,114,9268,9382
2021/08/22,07:30:00,308.01,235,9665,9900
2021/08/22,08:00:00,343.39,558,9992,10550
2021/08/22,08:30:00,328.17,796,10351,11147
2021/08/22,09:00:00,337.37,845,10734,11579
2021/08/22,09:30:00,325.32,1230,10859,12089
2021/08/22,10:00:00,321.53,1368,10865,12233
2021/08/22,10:30:00,327.58,1514,10790,12304
2021/08/22,11:00:00,323.9,1821,10823,12644
2021/08/22,11:30:00,328.46,1906,10903,12809
2021/08/22,12:00:00,337.56,1998,11014,13012
2021/08/22,12:30:00,328.44,2066,11037,13103
2021/08/22,13:00:00,339.42,2081,11095,13176
2021/08/22,13:30:00,333.61,2069,11271,13340
2021/08/22,14:00:00,341.98,2051,11459,13510
2021/08/22,14:30:00,1974.55,2013,11592,13605
2021/08/22,15:00:00,1974.55,1921,11698,13619
2021/08/22,15:30:00,1997.9,1816,11818,13634
2021/08/22,16:00:00,1986.14,1678,11859,13537
2021/08/22,16:30:00,1986.14,1437,11971,13408
2021/08/22,17:00:00,1986.14,1206,11960,13166
2021/08/22,17:30:00,1997.9,926,11922,12848
2021/08/22,18:00:00,1986.14,636,12056,12692
2021/08/22,18:30:00,1986.14,465,12000,12465
2021/08/22,19:00:00,1986.14,604,11887,12491
2021/08/22,19:30:00,1974.55,852,11995,12847
2021/08/22,20:00:00,316.79,133,12039,12172
2021/08/22,20:30:00,342.2,133,11978,12111
2021/08/22,21:00:00,344.28,133,11877,12010
2021/08/22,21:30:00,314.49,132,11738,11870
2021/08/22,22:00:00,340.16,89,11426,11515
2021/08/22,22:30:00,344.58,51,11153,11204
2021/08/22,23:00:00,343.02,18,10891,10909
2021/08/22,23:30:00,344.58,14,10550,10564
2021/08/23,00:00:00,319.78,14,10141,10155
2021/08/23,00:30:00,344.9,15,9799,9814
2021/08/23,01:00:00,340.34,15,9542,9557
2021/08/23,01:30:00,325.51,15,9562,9577
2021/08/23,02:00:00,328.47,15,9328,9343
2021/08/23,02:30:00,300.36,15,9178,9193
2021/08/23,03:00:00,303.08,7,9062,9069
2021/08/23,03:30:00,300.19,14,8912,8926
2021/08/23,04:00:00,300.1,13,8844,8857
2021/08/23,04:30:00,303.08,6,8848,8854
2021/08/23,05:00:00,301.02,7,8813,8820
2021/08/23,05:30:00,301.02,7,8877,8884
2021/08/23,06:00:00,339.9,6,8855,8861
2021/08/23,06:30:00,346.65,8,8895,8903
2021/08/23,07:00:00,300.28,151,9133,9284
2021/08/23,07:30:00,313.55,324,9443,9767
2021/08/23,08:00:00,338.58,565,9720,10285
2021/08/23,08:30:00,323.64,827,10005,10832
2021/08/23,09:00:00,316.5,938,10281,11219
2021/08/23,09:30:00,318.78,1176,10372,11548
2021/08/23,10:00:00,311.4,1468,10264,11732
2021/08/23,10:30:00,343.46,1726,10047,11773
2021/08/23,11:00:00,341.69,1913,9863,11776
2021/08/23,11:30:00,345.16,2021,9897,11918
2021/08/23,12:00:00,341.36,2065,10018,12083
2021/08/23,12:30:00,331.15,2064,10220,12284
2021/08/23,13:00:00,327.8,2031,10389,12420
2021/08/23,13:30:00,312.64,2054,10600,12654
2021/08/23,14:00:00,314.66,2037,10755,12792
2021/08/23,14:30:00,312.83,1980,10853,12833
2021/08/23,15:00:00,313.5,1854,10981,12835
2021/08/23,15:30:00,313.21,1820,11086,12906
2021/08/23,16:00:00,313.39,1661,11141,12802
2021/08/23,16:30:00,315.95,1501,11250,12751
2021/08/23,17:00:00,336.11,1182,11298,12480
2021/08/23,17:30:00,342.43,894,11494,12388
2021/08/23,18:00:00,314.09,662,11582,12244
2021/08/23,18:30:00,314.2,495,11545,12040
2021/08/23,19:00:00,314.16,950,11388,12338
2021/08/23,19:30:00,315.02,129,11490,11619
2021/08/23,20:00:00,315.81,126,11504,11630
2021/08/23,20:30:00,315.67,121,11379,11500
2021/08/23,21:00:00,315.62,117,11242,11359
2021/08/23,21:30:00,315.56,119,11047,11166
2021/08/23,22:00:00,342.25,118,10765,10883
2021/08/23,22:30:00,341.45,119,10512,10631
2021/08/23,23:00:00,345.85,118,10157,10275
2021/08/23,23:30:00,318.44,63,9895,9958
2021/08/24,00:00:00,331.63,5,9633,9638
2021/08/24,00:30:00,321.44,2,9338,9340
2021/08/24,01:00:00,321.32,2,8997,8999
2021/08/24,01:30:00,318.85,1,9071,9072
2021/08/24,02:00:00,328.09,3,8867,8870
2021/08/24,02:30:00,312.14,5,8691,8696
2021/08/24,03:00:00,312.04,3,8561,8564
2021/08/24,03:30:00,360.85,6,8466,8472
2021/08/24,04:00:00,357.08,6,8421,8427
2021/08/24,04:30:00,359.09,5,8384,8389
2021/08/24,05:00:00,309.78,5,8393,8398
2021/08/24,05:30:00,309.09,5,8412,8417
2021/08/24,06:00:00,308.88,3,8419,8422
2021/08/24,06:30:00,309.01,3,8500,8503
2021/08/24,07:00:00,351.73,128,8666,8794
2021/08/24,07:30:00,330.26,285,8946,9231
2021/08/24,08:00:00,325.32,640,9073,9713
2021/08/24,08:30:00,342.2,1079,9047,10126
2021/08/24,09:00:00,342.69,1242,9191,10433
2021/08/24,09:30:00,339.59,1488,9352,10840
2021/08/24,10:00:00,345.77,1676,9181,10857
2021/08/24,10:30:00,355.79,1820,9192,11012
2021/08/24,11:00:00,349,1956,9326,11282
2021/08/24,11:30:00,349.43,1997,9469,11466
2021/08/24,12:00:00,333.28,2060,9618,11678
2021/08/24,12:30:00,359.74,2078,9816,11894
2021/08/24,13:00:00,327.38,2083,10006,12089
2021/08/24,13:30:00,357.01,2062,10259,12321
2021/08/24,14:00:00,352.8,2017,10440,12457
2021/08/24,14:30:00,354.17,1972,10592,12564
2021/08/24,15:00:00,360.85,1880,10760,12640
2021/08/24,15:30:00,362.57,1767,10911,12678
2021/08/24,16:00:00,362.57,1647,11006,12653
2021/08/24,16:30:00,360.85,1435,11161,12596
2021/08/24,17:00:00,358.61,1143,11283,12426
2021/08/24,17:30:00,361.25,889,11585,12474
2021/08/24,18:00:00,364,561,11654,12215
2021/08/24,18:30:00,356.09,377,11663,12040
2021/08/24,19:00:00,326.48,124,11499,11623
2021/08/24,19:30:00,356.09,125,11592,11717
2021/08/24,20:00:00,356.56,121,11596,11717
2021/08/24,20:30:00,358.6,121,11499,11620
2021/08/24,21:00:00,364,120,11361,11481
2021/08/24,21:30:00,364,122,11230,11352
2021/08/24,22:00:00,370.49,121,10961,11082
2021/08/24,22:30:00,361.26,120,10691,10811
2021/08/24,23:00:00,352.78,119,10383,10502
2021/08/24,23:30:00,356.08,60,10071,10131
2021/08/25,00:00:00,234.37,3,9750,9753
2021/08/25,00:30:00,234.61,1,9456,9457
2021/08/25,01:00:00,234.37,1,9170,9171
2021/08/25,01:30:00,234.61,1,9035,9036
2021/08/25,02:00:00,234.86,1,9004,9005
2021/08/25,02:30:00,234.37,1,8836,8837
2021/08/25,03:00:00,234.13,1,8692,8693
2021/08/25,03:30:00,234.37,1,8571,8572
2021/08/25,04:00:00,234.61,1,8513,8514
2021/08/25,04:30:00,234.61,1,8450,8451
2021/08/25,05:00:00,234.61,1,8435,8436
2021/08/25,05:30:00,234.61,1,8492,8493
2021/08/25,06:00:00,234.61,1,8458,8459
2021/08/25,06:30:00,234.61,1,8542,8543
2021/08/25,07:00:00,234.61,116,8725,8841
2021/08/25,07:30:00,234.37,261,9008,9269
2021/08/25,08:00:00,234.61,583,9205,9788
2021/08/25,08:30:00,373.68,919,9482,10401
2021/08/25,09:00:00,375.5,1219,9618,10837
2021/08/25,09:30:00,370.15,1492,9807,11299
2021/08/25,10:00:00,368.31,1681,9804,11485
2021/08/25,10:30:00,373.57,1794,9888,11682
2021/08/25,11:00:00,372.43,1926,9875,11801
2021/08/25,11:30:00,370.62,1989,10046,12035
2021/08/25,12:00:00,376.2,2034,10088,12122
2021/08/25,12:30:00,376.24,2058,10316,12374
2021/08/25,13:00:00,376.24,2059,10561,12620
2021/08/25,13:30:00,371.4,2051,10807,12858
2021/08/25,14:00:00,376.24,2015,11048,13063
2021/08/25,14:30:00,376.24,1964,11243,13207
2021/08/25,15:00:00,374.71,1863,11392,13255
2021/08/25,15:30:00,373.47,1754,11540,13294
2021/08/25,16:00:00,371.63,1618,11664,13282
2021/08/25,16:30:00,370.37,1368,11818,13186
2021/08/25,17:00:00,1986.14,1078,11927,13005
2021/08/25,17:30:00,1986.14,837,12127,12964
2021/08/25,18:00:00,1986.14,510,12214,12724
2021/08/25,18:30:00,1974.55,350,12174,12524
2021/08/25,19:00:00,384.33,121,12010,12131
2021/08/25,19:30:00,382.52,121,12163,12284
2021/08/25,20:00:00,382.52,121,12130,12251
2021/08/25,20:30:00,380.83,122,12028,12150
2021/08/25,21:00:00,382.52,122,11913,12035
2021/08/25,21:30:00,384.33,121,11735,11856
2021/08/25,22:00:00,351.37,116,11433,11549
2021/08/25,22:30:00,376.24,70,11187,11257
2021/08/25,23:00:00,383.84,5,10904,10909
2021/08/25,23:30:00,388.28,5,10559,10564
2021/08/26,00:00:00,376.93,5,10186,10191
2021/08/26,00:30:00,376.93,6,9875,9881
2021/08/26,01:00:00,330.1,7,9555,9562
2021/08/26,01:30:00,379.21,6,9471,9477
2021/08/26,02:00:00,389.34,5,9369,9374
2021/08/26,02:30:00,333.31,4,9203,9207
2021/08/26,03:00:00,381.51,4,9050,9054
2021/08/26,03:30:00,383.94,3,8929,8932
2021/08/26,04:00:00,374.83,3,8834,8837
2021/08/26,04:30:00,376.97,3,8778,8781
2021/08/26,05:00:00,383.94,8,8780,8788
2021/08/26,05:30:00,389.34,8,8817,8825
2021/08/26,06:00:00,352.02,7,8804,8811
2021/08/26,06:30:00,383.94,3,8912,8915
2021/08/26,07:00:00,389.34,120,9089,9209
2021/08/26,07:30:00,349.85,193,9474,9667
2021/08/26,08:00:00,329.79,458,9785,10243
2021/08/26,08:30:00,331.01,678,10151,10829
2021/08/26,09:00:00,335.05,878,10414,11292
2021/08/26,09:30:00,332.14,1276,10463,11739
2021/08/26,10:00:00,335.41,1532,10433,11965
2021/08/26,10:30:00,335.79,1753,10426,12179
2021/08/26,11:00:00,362.57,1903,10566,12469
2021/08/26,11:30:00,353.76,1968,10610,12578
2021/08/26,12:00:00,357.73,2006,10654,12660
2021/08/26,12:30:00,343.53,2038,10889,12927
2021/08/26,13:00:00,345.17,2057,11154,13211
2021/08/26,13:30:00,345.62,2045,11417,13462
2021/08/26,14:00:00,1919.06,1994,11661,13655
2021/08/26,14:30:00,1929.84,1944,11868,13812
2021/08/26,15:00:00,1929.84,1816,12019,13835
2021/08/26,15:30:00,2225.51,1684,12176,13860
2021/08/26,16:00:00,2731.28,1536,12281,13817
2021/08/26,16:30:00,2731.28,1273,12426,13699
2021/08/26,17:00:00,2731.28,1014,12519,13533
2021/08/26,17:30:00,2731.28,761,12594,13355
2021/08/26,18:00:00,2731.28,428,12511,12939
2021/08/26,18:30:00,2731.28,272,12352,12624
2021/08/26,19:00:00,2731.28,96,12193,12289
2021/08/26,19:30:00,2564.54,93,12347,12440
2021/08/26,20:00:00,2274.75,54,12342,12396
2021/08/26,20:30:00,2274.75,9,12243,12252
2021/08/26,21:00:00,1986.14,10,12119,12129
2021/08/26,21:30:00,343.68,9,11977,11986
2021/08/26,22:00:00,380.12,5,11793,11798
2021/08/26,22:30:00,385.01,6,11546,11552
2021/08/26,23:00:00,361.1,5,11112,11117
2021/08/26,23:30:00,378.54,5,10788,10793
2021/08/27,00:00:00,327.14,6,10462,10468
2021/08/27,00:30:00,367.14,3,10174,10177
2021/08/27,01:00:00,389.41,4,9889,9893
2021/08/27,01:30:00,326.11,6,9923,9929
2021/08/27,02:00:00,325.76,4,9702,9706
2021/08/27,02:30:00,326.71,7,9515,9522
2021/08/27,03:00:00,325.59,6,9350,9356
2021/08/27,03:30:00,324.6,7,9219,9226
2021/08/27,04:00:00,329.61,6,9131,9137
2021/08/27,04:30:00,325.59,4,9079,9083
2021/08/27,05:00:00,326.55,2,9030,9032
2021/08/27,05:30:00,329.45,2,9048,9050
2021/08/27,06:00:00,326.55,3,8968,8971
2021/08/27,06:30:00,329.61,2,8916,8918
2021/08/27,07:00:00,329.95,89,8951,9040
2021/08/27,07:30:00,336.65,191,9222,9413
2021/08/27,08:00:00,337.7,432,9357,9789
2021/08/27,08:30:00,335.31,656,9570,10226
2021/08/27,09:00:00,335.31,831,9861,10692
2021/08/27,09:30:00,334.44,1102,10088,11190
2021/08/27,10:00:00,337.4,1345,10165,11510
2021/08/27,10:30:00,337.69,1558,10356,11914
2021/08/27,11:00:00,349.08,1757,10482,12239
2021/08/27,11:30:00,349.08,1848,10705,12553
2021/08/27,12:00:00,369.78,1881,10861,12742
2021/08/27,12:30:00,366.68,1935,10960,12895
2021/08/27,13:00:00,346.92,1952,11166,13118
2021/08/27,13:30:00,1986.14,1761,11259,13020
2021/08/27,14:00:00,1859.37,1638,11501,13139
2021/08/27,14:30:00,1859.37,1604,11575,13179
2021/08/27,15:00:00,1908.56,1556,11676,13232
2021/08/27,15:30:00,2208.88,1344,11808,13152
2021/08/27,16:00:00,2352.75,1257,11888,13145
2021/08/27,16:30:00,2352.75,1069,11983,13052
2021/08/27,17:00:00,2352.75,812,12057,12869
2021/08/27,17:30:00,1986.14,586,12092,12678
2021/08/27,18:00:00,1974.55,291,12135,12426
2021/08/27,18:30:00,1952.07,257,12099,12356
2021/08/27,19:00:00,343.17,12,11815,11827
2021/08/27,19:30:00,341.28,12,11821,11833
2021/08/27,20:00:00,343.54,12,11600,11612
2021/08/27,20:30:00,340.89,12,11424,11436
2021/08/27,21:00:00,366.92,10,11229,11239
2021/08/27,21:30:00,370.12,11,10926,10937
2021/08/27,22:00:00,375.29,12,10797,10809
2021/08/27,22:30:00,382.97,11,10684,10695
2021/08/27,23:00:00,341.03,11,10567,10578
2021/08/27,23:30:00,332.17,3,10360,10363
2021/08/28,00:00:00,334.25,1,10120,10121
2021/08/28,00:30:00,343.85,3,9846,9849
2021/08/28,01:00:00,333.03,5,9872,9877
2021/08/28,01:30:00,332.19,11,9668,9679
2021/08/28,02:00:00,331.46,8,9464,9472
2021/08/28,02:30:00,325.48,8,9251,9259
2021/08/28,03:00:00,389.15,4,9167,9171
2021/08/28,03:30:00,325.23,4,9066,9070
2021/08/28,04:00:00,326.35,4,8928,8932
2021/08/28,04:30:00,325.19,4,8894,8898
2021/08/28,05:00:00,330.72,2,8850,8852
2021/08/28,05:30:00,326.35,3,8799,8802
2021/08/28,06:00:00,380.63,4,8654,8658
2021/08/28,06:30:00,375.68,5,8497,8502
2021/08/28,07:00:00,389.15,94,8411,8505
2021/08/28,07:30:00,389.15,217,8431,8648
2021/08/28,08:00:00,333.51,456,8401,8857
2021/08/28,08:30:00,333.19,711,8567,9278
2021/08/28,09:00:00,332.37,926,8660,9586
2021/08/28,09:30:00,333.18,1280,8753,10033
2021/08/28,10:00:00,334.66,1521,8910,10431
2021/08/28,10:30:00,343.85,1707,9040,10747
2021/08/28,11:00:00,355.75,1865,9233,11098
2021/08/28,11:30:00,351.29,1935,9395,11330
2021/08/28,12:00:00,351,1986,9376,11362
2021/08/28,12:30:00,351.38,2012,9424,11436
2021/08/28,13:00:00,356.28,2014,9550,11564
2021/08/28,13:30:00,356.28,2001,9736,11737
2021/08/28,14:00:00,358.11,1977,9779,11756
2021/08/28,14:30:00,359.4,1936,9891,11827
2021/08/28,15:00:00,359.46,1837,10038,11875
2021/08/28,15:30:00,351.92,1704,10191,11895
2021/08/28,16:00:00,347.47,1572,10337,11909
2021/08/28,16:30:00,342.79,1346,10506,11852
2021/08/28,17:00:00,362.86,1045,10658,11703
2021/08/28,17:30:00,339.02,843,10855,11698
2021/08/28,18:00:00,339.02,513,10963,11476
2021/08/28,18:30:00,337.04,342,11013,11355
2021/08/28,19:00:00,336.11,122,11032,11154
2021/08/28,19:30:00,337.23,123,11275,11398
2021/08/28,20:00:00,336.21,124,11246,11370
2021/08/28,20:30:00,336.06,113,11268,11381
2021/08/28,21:00:00,337.49,51,11268,11319
2021/08/28,21:30:00,334.91,13,11225,11238
2021/08/28,22:00:00,341.23,6,11090,11096
2021/08/28,22:30:00,338.58,4,10929,10933
2021/08/28,23:00:00,335.03,6,10685,10691
2021/08/28,23:30:00,336.45,8,10367,10375
2021/08/29,00:00:00,331.03,8,10035,10043
2021/08/29,00:30:00,329.24,8,9891,9899
2021/08/29,01:00:00,331.57,8,9734,9742
2021/08/29,01:30:00,330.85,6,9464,9470
2021/08/29,02:00:00,331.48,5,9242,9247
2021/08/29,02:30:00,330.8,4,9039,9043
2021/08/29,03:00:00,330.76,1,8910,8911
2021/08/29,03:30:00,330.85,2,8824,8826
2021/08/29,04:00:00,377,2,8727,8729
2021/08/29,04:30:00,377,1,8761,8762
2021/08/29,05:00:00,334.89,0,8756,8756
2021/08/29,05:30:00,389.18,0,8823,8823
2021/08/29,06:00:00,331.66,1,8862,8863
2021/08/29,06:30:00,330.85,1,8999,9000
2021/08/29,07:00:00,331.52,91,9256,9347
2021/08/29,07:30:00,332.13,248,9655,9903
2021/08/29,08:00:00,332.04,506,9976,10482
2021/08/29,08:30:00,332.13,751,10201,10952
2021/08/29,09:00:00,334.95,940,10355,11295
2021/08/29,09:30:00,333.71,1232,10426,11658
2021/08/29,10:00:00,346.6,1554,10276,11830
2021/08/29,10:30:00,374.24,1742,10208,11950
2021/08/29,11:00:00,369.62,1907,10323,12230
2021/08/29,11:30:00,369.66,1981,10412,12393
2021/08/29,12:00:00,375.44,2058,10580,12638
2021/08/29,12:30:00,384.65,2068,10755,12823
2021/08/29,13:00:00,344.88,2090,10923,13013
2021/08/29,13:30:00,341.77,2094,11153,13247
2021/08/29,14:00:00,342.34,2052,11350,13402
2021/08/29,14:30:00,370,2001,11571,13572
2021/08/29,15:00:00,341.94,1909,11666,13575
2021/08/29,15:30:00,384.71,1777,11761,13538
2021/08/29,16:00:00,385.18,1641,11857,13498
2021/08/29,16:30:00,343.14,1444,11948,13392
2021/08/29,17:00:00,1869.74,1098,12027,13125
2021/08/29,17:30:00,1869.74,883,12048,12931
2021/08/29,18:00:00,1888.22,589,12113,12702
2021/08/29,18:30:00,1929.84,356,12039,12395
2021/08/29,19:00:00,381.96,127,11884,12011
2021/08/29,19:30:00,356.83,130,12059,12189
2021/08/29,20:00:00,356.83,131,12149,12280
2021/08/29,20:30:00,356.72,131,12035,12166
2021/08/29,21:00:00,385.22,130,11946,12076
2021/08/29,21:30:00,381.96,129,11776,11905
2021/08/29,22:00:00,345.25,80,11579,11659
2021/08/29,22:30:00,341.2,19,11199,11218
2021/08/29,23:00:00,336.81,12,10869,10881
2021/08/29,23:30:00,332.2,13,10523,10536
2021/08/30,00:00:00,355.33,10,10114,10124
2021/08/30,00:30:00,351.24,8,9984,9992
2021/08/30,01:00:00,351.06,2,9653,9655
2021/08/30,01:30:00,351.15,3,9387,9390
2021/08/30,02:00:00,351.15,2,9340,9342
2021/08/30,02:30:00,350.32,1,9111,9112
2021/08/30,03:00:00,405.22,1,8983,8984
2021/08/30,03:30:00,400.35,1,8912,8913
2021/08/30,04:00:00,354.68,1,8798,8799
2021/08/30,04:30:00,405.22,1,8737,8738
2021/08/30,05:00:00,349.97,1,8780,8781
2021/08/30,05:30:00,351.61,1,8794,8795
2021/08/30,06:00:00,349.85,1,8791,8792
2021/08/30,06:30:00,400.35,1,8880,8881
2021/08/30,07:00:00,405.22,120,9082,9202
2021/08/30,07:30:00,348.71,299,9439,9738
2021/08/30,08:00:00,348.99,559,9697,10256
2021/08/30,08:30:00,349.12,933,9965,10898
2021/08/30,09:00:00,352.91,1236,10036,11272
2021/08/30,09:30:00,354.61,1477,10241,11718
2021/08/30,10:00:00,355.8,1726,10225,11951
2021/08/30,10:30:00,357.22,1782,10309,12091
2021/08/30,11:00:00,361.08,1891,10243,12134
2021/08/30,11:30:00,370.99,1989,10267,12256
2021/08/30,12:00:00,369.56,2024,10364,12388
2021/08/30,12:30:00,358.79,2056,10564,12620
2021/08/30,13:00:00,363.71,2070,10857,12927
2021/08/30,13:30:00,378.78,2058,11107,13165
2021/08/30,14:00:00,363.87,2015,11308,13323
2021/08/30,14:30:00,405.22,1954,11476,13430
2021/08/30,15:00:00,368.83,1877,11601,13478
2021/08/30,15:30:00,378.84,1757,11723,13480
2021/08/30,16:00:00,364.32,1580,11794,13374
2021/08/30,16:30:00,405.22,1420,11900,13320
2021/08/30,17:00:00,1974.55,1113,11973,13086
2021/08/30,17:30:00,1986.14,810,12155,12965
2021/08/30,18:00:00,1974.55,555,12149,12704
2021/08/30,18:30:00,1974.55,374,12061,12435
2021/08/30,19:00:00,362.51,130,11936,12066
2021/08/30,19:30:00,405.22,133,12098,12231
2021/08/30,20:00:00,365.16,134,12115,12249
2021/08/30,20:30:00,362.92,133,11984,12117
2021/08/30,21:00:00,363.32,131,11858,11989
2021/08/30,21:30:00,362.97,126,11654,11780
2021/08/30,22:00:00,396.3,57,11458,11515
2021/08/30,22:30:00,358.01,10,11181,11191
2021/08/30,23:00:00,405.22,12,10829,10841
2021/08/30,23:30:00,378.59,11,10468,10479
2021/08/31,00:00:00,325.8,9,10079,10088
2021/08/31,00:30:00,325.67,7,9756,9763
2021/08/31,01:00:00,347.58,5,9476,9481
2021/08/31,01:30:00,322.69,5,9507,9512
2021/08/31,02:00:00,322.65,3,9304,9307
2021/08/31,02:30:00,373.18,3,9197,9200
2021/08/31,03:00:00,321.06,2,9020,9022
2021/08/31,03:30:00,373.18,2,8920,8922
2021/08/31,04:00:00,378.86,2,8825,8827
2021/08/31,04:30:00,373.18,1,8824,8825
2021/08/31,05:00:00,373.18,1,8834,8835
2021/08/31,05:30:00,378.86,0,8885,8885
2021/08/31,06:00:00,347.58,0,8881,8881
2021/08/31,06:30:00,373.18,0,8958,8958
2021/08/31,07:00:00,373.18,117,9165,9282
2021/08/31,07:30:00,322.16,275,9501,9776
2021/08/31,08:00:00,376.46,542,9753,10295
2021/08/31,08:30:00,371.18,799,9942,10741
2021/08/31,09:00:00,372.23,1092,9960,11052
2021/08/31,09:30:00,372.96,1399,10001,11400
2021/08/31,10:00:00,376.46,1497,10009,11506
2021/08/31,10:30:00,377.32,1782,9966,11748
2021/08/31,11:00:00,377.5,1919,10020,11939
2021/08/31,11:30:00,379.45,1987,10157,12144
2021/08/31,12:00:00,378.54,2039,10142,12181
2021/08/31,12:30:00,379.97,2061,10180,12241
2021/08/31,13:00:00,381.65,2052,10443,12495
2021/08/31,13:30:00,381.72,2049,10671,12720
2021/08/31,14:00:00,401.64,2007,10839,12846
2021/08/31,14:30:00,406.75,1946,11071,13017
2021/08/31,15:00:00,399.69,1848,11208,13056
2021/08/31,15:30:00,381.82,1699,11412,13111
2021/08/31,16:00:00,381.85,1543,11501,13044
2021/08/31,16:30:00,380.6,1310,11607,12917
2021/08/31,17:00:00,402.01,1035,11705,12740
2021/08/31,17:30:00,380.65,804,11877,12681
2021/08/31,18:00:00,378.8,454,11929,12383
2021/08/31,18:30:00,402.17,304,11866,12170
2021/08/31,19:00:00,402.17,127,11756,11883
2021/08/31,19:30:00,406.75,125,11950,12075
2021/08/31,20:00:00,406.75,122,11929,12051
2021/08/31,20:30:00,406.75,117,11868,11985
2021/08/31,21:00:00,382.07,73,11827,11900
2021/08/31,21:30:00,406.75,5,11672,11677
2021/08/31,22:00:00,402.14,7,11375,11382
2021/08/31,22:30:00,406.75,7,11049,11056
2021/08/31,23:00:00,406.75,5,10733,10738
2021/08/31,23:30:00,406.75,4,10336,10340
2021/09/01,00:00:00,246.5,2,9957,9959
2021/09/01,00:30:00,246.5,3,9584,9587
2021/09/01,01:00:00,246.75,3,9267,9270
2021/09/01,01:30:00,247.01,5,9239,9244
2021/09/01,02:00:00,246.75,6,9049,9055
2021/09/01,02:30:00,246.5,6,8943,8949
2021/09/01,03:00:00,246.24,4,8750,8754
2021/09/01,03:30:00,246.24,3,8696,8699
2021/09/01,04:00:00,246.5,2,8648,8650
2021/09/01,04:30:00,246.5,2,8620,8622
2021/09/01,05:00:00,246.5,1,8623,8624
2021/09/01,05:30:00,246.5,2,8720,8722
2021/09/01,06:00:00,246.75,1,8769,8770
2021/09/01,06:30:00,246.5,1,8847,8848
2021/09/01,07:00:00,246.24,122,9163,9285
2021/09/01,07:30:00,246.5,248,9421,9669
2021/09/01,08:00:00,246.24,523,9542,10065
2021/09/01,08:30:00,246.5,779,9708,10487
2021/09/01,09:00:00,246.24,1092,9875,10967
2021/09/01,09:30:00,246.75,1409,9793,11202
2021/09/01,10:00:00,246.5,1620,9644,11264
2021/09/01,10:30:00,246.5,1791,9742,11533
2021/09/01,11:00:00,247.01,1891,9859,11750
2021/09/01,11:30:00,247.01,1983,9985,11968
2021/09/01,12:00:00,246.5,2015,10089,12104
2021/09/01,12:30:00,367.19,2048,10393,12441
2021/09/01,13:00:00,385.22,2056,10726,12782
2021/09/01,13:30:00,385.22,2056,11056,13112
2021/09/01,14:00:00,399.81,2010,11247,13257
2021/09/01,14:30:00,399.82,1951,11475,13426
2021/09/01,15:00:00,401.73,1859,11602,13461
2021/09/01,15:30:00,384.12,1705,11690,13395
2021/09/01,16:00:00,400.38,1574,11755,13329
2021/09/01,16:30:00,402.06,1343,11795,13138
2021/09/01,17:00:00,406.75,1034,11866,12900
2021/09/01,17:30:00,406.75,799,11925,12724
2021/09/01,18:00:00,402.06,455,11897,12352
2021/09/01,18:30:00,406.75,320,11780,12100
2021/09/01,19:00:00,406.75,131,11600,11731
2021/09/01,19:30:00,406.75,133,11751,11884
2021/09/01,20:00:00,400.28,131,11776,11907
2021/09/01,20:30:00,402.06,11,11807,11818
2021/09/01,21:00:00,397.74,11,11674,11685
2021/09/01,21:30:00,381.02,12,11445,11457
2021/09/01,22:00:00,380,12,11139,11151
2021/09/01,22:30:00,390.39,10,10874,10884
2021/09/01,23:00:00,406.75,9,10587,10596
2021/09/01,23:30:00,406.75,7,10222,10229
2021/09/02,00:00:00,246.24,7,9810,9817
2021/09/02,00:30:00,246.5,3,9463,9466
2021/09/02,01:00:00,246.5,5,9182,9187
2021/09/02,01:30:00,246.24,5,9044,9049
2021/09/02,02:00:00,246.5,5,8816,8821
2021/09/02,02:30:00,246.75,4,8807,8811
2021/09/02,03:00:00,246.24,2,8695,8697
2021/09/02,03:30:00,246.5,1,8579,8580
2021/09/02,04:00:00,246.5,2,8534,8536
2021/09/02,04:30:00,246.5,1,8548,8549
2021/09/02,05:00:00,246.5,1,8585,8586
2021/09/02,05:30:00,246.5,1,8625,8626
2021/09/02,06:00:00,246.5,1,8649,8650
2021/09/02,06:30:00,246.5,1,8768,8769
2021/09/02,07:00:00,246.5,104,8989,9093
2021/09/02,07:30:00,246.5,275,9270,9545
2021/09/02,08:00:00,246.5,447,9479,9926
2021/09/02,08:30:00,246,650,9774,10424
2021/09/02,09:00:00,387,952,9909,10861
2021/09/02,09:30:00,389.17,1212,9861,11073
2021/09/02,10:00:00,389.17,1553,9810,11363
2021/09/02,10:30:00,390.69,1771,9785,11556
2021/09/02,11:00:00,390.69,1915,9724,11639
2021/09/02,11:30:00,390.69,1999,9701,11700
2021/09/02,12:00:00,335.47,2038,9865,11903
2021/09/02,12:30:00,337.33,2059,10040,12099
2021/09/02,13:00:00,341.36,2057,10263,12320
2021/09/02,13:30:00,376.19,2040,10562,12602
2021/09/02,14:00:00,390.18,2013,10834,12847
2021/09/02,14:30:00,347.67,1942,11091,13033
2021/09/02,15:00:00,387.57,1868,11202,13070
2021/09/02,15:30:00,345.92,1754,11277,13031
2021/09/02,16:00:00,374.39,1565,11306,12871
2021/09/02,16:30:00,374.74,1366,11406,12772
2021/09/02,17:00:00,365.48,1097,11438,12535
2021/09/02,17:30:00,363.65,762,11554,12316
2021/09/02,18:00:00,368.06,501,11624,12125
2021/09/02,18:30:00,387.05,363,11465,11828
2021/09/02,19:00:00,347.38,127,11379,11506
2021/09/02,19:30:00,346.92,128,11546,11674
2021/09/02,20:00:00,344.54,127,11457,11584
2021/09/02,20:30:00,377.5,127,11336,11463
2021/09/02,21:00:00,343.76,128,11166,11294
2021/09/02,21:30:00,378.98,124,10906,11030
2021/09/02,22:00:00,385.88,69,10730,10799
2021/09/02,22:30:00,341.72,4,10524,10528
2021/09/02,23:00:00,380.31,4,10255,10259
2021/09/02,23:30:00,246.75,3,9956,9959
2021/09/03,00:00:00,246.75,2,9593,9595
2021/09/03,00:30:00,247.01,2,9252,9254
2021/09/03,01:00:00,247.01,2,9006,9008
2021/09/03,01:30:00,247.01,2,8739,8741
2021/09/03,02:00:00,246.75,2,8562,8564
2021/09/03,02:30:00,247.01,1,8530,8531
2021/09/03,03:00:00,247.27,1,8547,8548
2021/09/03,03:30:00,246.75,1,8430,8431
2021/09/03,04:00:00,246.75,1,8351,8352
2021/09/03,04:30:00,246.75,1,8315,8316
2021/09/03,05:00:00,246.75,1,8300,8301
2021/09/03,05:30:00,247.01,1,8345,8346
2021/09/03,06:00:00,247.01,1,8284,8285
2021/09/03,06:30:00,247.01,1,8222,8223
2021/09/03,07:00:00,247.01,99,8321,8420
2021/09/03,07:30:00,246.5,217,8525,8742
2021/09/03,08:00:00,247.27,456,8597,9053
2021/09/03,08:30:00,246.5,829,8724,9553
2021/09/03,09:00:00,247.01,1045,8782,9827
2021/09/03,09:30:00,246.75,1197,8835,10032
2021/09/03,10:00:00,246.75,1553,8820,10373
2021/09/03,10:30:00,247.01,1778,8833,10611
2021/09/03,11:00:00,247.01,1904,8960,10864
2021/09/03,11:30:00,247.01,1998,9126,11124
2021/09/03,12:00:00,246.75,2036,9036,11072
2021/09/03,12:30:00,246.75,2060,9288,11348
2021/09/03,13:00:00,353.69,2055,9336,11391
2021/09/03,13:30:00,354.84,2042,9442,11484
2021/09/03,14:00:00,366.52,1994,9590,11584
2021/09/03,14:30:00,366.62,1908,9745,11653
2021/09/03,15:00:00,368.41,1847,9878,11725
2021/09/03,15:30:00,365.08,1723,9963,11686
2021/09/03,16:00:00,368.39,1549,10114,11663
2021/09/03,16:30:00,372.17,1386,10308,11694
2021/09/03,17:00:00,370.75,1051,10482,11533
2021/09/03,17:30:00,386.22,787,10756,11543
2021/09/03,18:00:00,382.59,550,10979,11529
2021/09/03,18:30:00,380.06,322,11119,11441
2021/09/03,19:00:00,386.22,125,11001,11126
2021/09/03,19:30:00,386.22,124,11013,11137
2021/09/03,20:00:00,381.96,122,10860,10982
2021/09/03,20:30:00,381.96,121,10724,10845
2021/09/03,21:00:00,381.85,117,10490,10607
2021/09/03,21:30:00,386.22,85,10345,10430
2021/09/03,22:00:00,249.28,24,10198,10222
2021/09/03,22:30:00,249.22,4,10025,10029
2021/09/03,23:00:00,249.21,4,9864,9868
2021/09/03,23:30:00,249.18,4,9629,9633
2021/09/04,00:00:00,246.75,6,9372,9378
2021/09/04,00:30:00,247.01,6,9096,9102
2021/09/04,01:00:00,247.01,7,8855,8862
2021/09/04,01:30:00,247.01,6,8682,8688
2021/09/04,02:00:00,246.75,4,8509,8513
2021/09/04,02:30:00,247.01,3,8483,8486
2021/09/04,03:00:00,247.01,1,8395,8396
2021/09/04,03:30:00,246.75,1,8285,8286
2021/09/04,04:00:00,247.01,1,8369,8370
2021/09/04,04:30:00,246.5,1,8329,8330
2021/09/04,05:00:00,247.01,1,8302,8303
2021/09/04,05:30:00,246.75,1,8281,8282
2021/09/04,06:00:00,247.01,1,8161,8162
2021/09/04,06:30:00,247.27,1,8012,8013
2021/09/04,07:00:00,246.75,138,7929,8067
2021/09/04,07:30:00,247.27,257,7985,8242
2021/09/04,08:00:00,246.75,572,7891,8463
2021/09/04,08:30:00,246.75,881,7862,8743
2021/09/04,09:00:00,247.01,1251,7875,9126
2021/09/04,09:30:00,247.01,1521,7991,9512
2021/09/04,10:00:00,247.01,1620,8180,9800
2021/09/04,10:30:00,246.5,1786,8338,10124
2021/09/04,11:00:00,247.01,1942,8330,10272
2021/09/04,11:30:00,247.27,1946,8531,10477
2021/09/04,12:00:00,246.5,2026,8472,10498
2021/09/04,12:30:00,247.27,2066,8671,10737
2021/09/04,13:00:00,247.01,2051,8811,10862
2021/09/04,13:30:00,246.5,2017,8978,10995
2021/09/04,14:00:00,246.75,1979,9073,11052
2021/09/04,14:30:00,247.27,1965,9132,11097
2021/09/04,15:00:00,247.27,1878,9313,11191
2021/09/04,15:30:00,247.01,1736,9446,11182
2021/09/04,16:00:00,359.28,1592,9622,11214
2021/09/04,16:30:00,342.35,1393,9897,11290
2021/09/04,17:00:00,355.04,1067,9942,11009
2021/09/04,17:30:00,353.02,836,10206,11042
2021/09/04,18:00:00,362.37,537,10375,10912
2021/09/04,18:30:00,356.18,324,10423,10747
2021/09/04,19:00:00,362.28,321,10296,10617
2021/09/04,19:30:00,369.96,129,10751,10880
2021/09/04,20:00:00,362.17,128,10721,10849
2021/09/04,20:30:00,362.17,127,10806,10933
2021/09/04,21:00:00,367.95,125,10766,10891
2021/09/04,21:30:00,367.88,123,10752,10875
2021/09/04,22:00:00,381.88,122,10615,10737
2021/09/04,22:30:00,382.41,69,10539,10608
2021/09/04,23:00:00,382.29,6,10339,10345
2021/09/04,23:30:00,382.16,6,10002,10008
2021/09/05,00:00:00,382.33,5,9633,9638
2021/09/05,00:30:00,380.86,5,9299,9304
2021/09/05,01:00:00,376.61,4,8980,8984
2021/09/05,01:30:00,380.86,4,8718,8722
2021/09/05,02:00:00,376.61,4,8680,8684
2021/09/05,02:30:00,378.71,4,8469,8473
2021/09/05,03:00:00,245.51,4,8479,8483
2021/09/05,03:30:00,245.27,4,8359,8363
2021/09/05,04:00:00,245.04,3,8294,8297
2021/09/05,04:30:00,245.51,3,8267,8270
2021/09/05,05:00:00,245.51,2,8294,8296
2021/09/05,05:30:00,246,2,8411,8413
2021/09/05,06:00:00,245.27,0,8410,8410
2021/09/05,06:30:00,245.51,1,8539,8540
2021/09/05,07:00:00,245.27,131,8827,8958
2021/09/05,07:30:00,245.27,279,9185,9464
2021/09/05,08:00:00,378.81,504,9418,9922
2021/09/05,08:30:00,376.77,755,9758,10513
2021/09/05,09:00:00,380.9,1138,9802,10940
2021/09/05,09:30:00,383.46,1334,10005,11339
2021/09/05,10:00:00,385.73,1496,9919,11415
2021/09/05,10:30:00,383.57,1738,10035,11773
2021/09/05,11:00:00,385.6,1727,10120,11847
2021/09/05,11:30:00,385.6,1855,9996,11851
2021/09/05,12:00:00,385.6,1974,9903,11877
2021/09/05,12:30:00,386.17,2016,10073,12089
2021/09/05,13:00:00,382.33,2027,10261,12288
2021/09/05,13:30:00,364.87,2043,10491,12534
2021/09/05,14:00:00,386.17,2029,10688,12717
2021/09/05,14:30:00,381.9,1972,10928,12900
2021/09/05,15:00:00,382.02,1868,11092,12960
2021/09/05,15:30:00,386.17,1742,11247,12989
2021/09/05,16:00:00,382.02,1611,11310,12921
2021/09/05,16:30:00,378.74,1383,11397,12780
2021/09/05,17:00:00,380.42,1109,11395,12504
2021/09/05,17:30:00,337.73,823,11509,12332
2021/09/05,18:00:00,351.84,481,11507,11988
2021/09/05,18:30:00,348.81,314,11466,11780
2021/09/05,19:00:00,382.28,132,11352,11484
2021/09/05,19:30:00,386.17,135,11459,11594
2021/09/05,20:00:00,338.24,132,11439,11571
2021/09/05,20:30:00,382.28,131,11351,11482
2021/09/05,21:00:00,386.17,110,11246,11356
2021/09/05,21:30:00,355.78,56,11138,11194
2021/09/05,22:00:00,355.78,14,10913,10927
2021/09/05,22:30:00,355.78,12,10688,10700
2021/09/05,23:00:00,381.01,11,10416,10427
2021/09/05,23:30:00,380.96,8,9996,10004
2021/09/06,00:00:00,381.93,12,9662,9674
2021/09/06,00:30:00,377.41,5,9289,9294
2021/09/06,01:00:00,252.71,5,9006,9011
2021/09/06,01:30:00,253.61,5,8732,8737
2021/09/06,02:00:00,254.06,5,8521,8526
2021/09/06,02:30:00,253.16,5,8466,8471
2021/09/06,03:00:00,253.16,5,8485,8490
2021/09/06,03:30:00,253.61,5,8370,8375
2021/09/06,04:00:00,253.61,5,8300,8305
2021/09/06,04:30:00,253.61,5,8255,8260
2021/09/06,05:00:00,246.5,5,8243,8248
2021/09/06,05:30:00,246.5,5,8286,8291
2021/09/06,06:00:00,246,5,8272,8277
2021/09/06,06:30:00,246.5,5,8201,8206
2021/09/06,07:00:00,246.24,97,8302,8399
2021/09/06,07:30:00,246.24,286,8420,8706
2021/09/06,08:00:00,246.5,556,8517,9073
2021/09/06,08:30:00,246,936,8682,9618
2021/09/06,09:00:00,246.5,1225,8820,10045
2021/09/06,09:30:00,246.5,1290,9088,10378
2021/09/06,10:00:00,246.24,1334,9249,10583
2021/09/06,10:30:00,246.75,1592,9192,10784
2021/09/06,11:00:00,246.24,1681,9267,10948
2021/09/06,11:30:00,246.24,1775,9368,11143
2021/09/06,12:00:00,246.24,1859,9228,11087
2021/09/06,12:30:00,246.5,1831,9376,11207
2021/09/06,13:00:00,246.5,1993,9384,11377
2021/09/06,13:30:00,246.5,1900,9505,11405
2021/09/06,14:00:00,246.5,1937,9643,11580
2021/09/06,14:30:00,246.5,1939,9756,11695
2021/09/06,15:00:00,246.5,1868,9883,11751
2021/09/06,15:30:00,350.09,1740,9984,11724
2021/09/06,16:00:00,381.93,1542,10132,11674
2021/09/06,16:30:00,385.4,1410,10248,11658
2021/09/06,17:00:00,385.4,1136,10376,11512
2021/09/06,17:30:00,385.81,808,10566,11374
2021/09/06,18:00:00,385.81,529,10685,11214
2021/09/06,18:30:00,385.81,375,10603,10978
2021/09/06,19:00:00,385.81,130,10335,10465
2021/09/06,19:30:00,385.81,131,10180,10311
2021/09/06,20:00:00,385.81,127,9870,9997
2021/09/06,20:30:00,378.95,128,9712,9840
2021/09/06,21:00:00,378.95,124,9510,9634
2021/09/06,21:30:00,375.53,72,9405,9477
2021/09/06,22:00:00,376.54,13,9358,9371
2021/09/06,22:30:00,378.48,12,9246,9258
2021/09/06,23:00:00,374.27,5,9134,9139
2021/09/06,23:30:00,246.5,9,9024,9033
2021/09/07,00:00:00,246.5,8,8832,8840
2021/09/07,00:30:00,246.5,5,8655,8660
2021/09/07,01:00:00,247.27,6,8597,8603
2021/09/07,01:30:00,246.24,3,8531,8534
2021/09/07,02:00:00,247.01,3,8331,8334
2021/09/07,02:30:00,246.24,3,8199,8202
2021/09/07,03:00:00,246.5,3,8036,8039
2021/09/07,03:30:00,247.27,3,7975,7978
2021/09/07,04:00:00,246.5,3,7921,7924
2021/09/07,04:30:00,246.75,3,7889,7892
2021/09/07,05:00:00,246.24,3,7845,7848
2021/09/07,05:30:00,246.5,3,7887,7890
2021/09/07,06:00:00,246.75,3,7833,7836
2021/09/07,06:30:00,247.01,0,7692,7692
2021/09/07,07:00:00,246.75,95,7661,7756
2021/09/07,07:30:00,246.75,260,7605,7865
2021/09/07,08:00:00,246.75,512,7551,8063
2021/09/07,08:30:00,246.5,809,7565,8374
2021/09/07,09:00:00,246.5,1098,7527,8625
2021/09/07,09:30:00,246.75,1354,7580,8934
2021/09/07,10:00:00,247.01,1450,7705,9155
2021/09/07,10:30:00,247.01,1591,7629,9220
2021/09/07,11:00:00,246.75,1767,7539,9306
2021/09/07,11:30:00,245.75,1886,7629,9515
2021/09/07,12:00:00,246.5,1919,7764,9683
2021/09/07,12:30:00,246.24,2027,7842,9869
2021/09/07,13:00:00,246,2033,7922,9955
2021/09/07,13:30:00,246.75,2042,8007,10049
2021/09/07,14:00:00,247.01,2003,8091,10094
2021/09/07,14:30:00,246.5,1953,8197,10150
2021/09/07,15:00:00,246.5,1877,8302,10179
2021/09/07,15:30:00,246.5,1736,8484,10220
2021/09/07,16:00:00,246.75,1563,8614,10177
2021/09/07,16:30:00,380.95,1409,8798,10207
2021/09/07,17:00:00,381.15,1081,8984,10065
2021/09/07,17:30:00,381.18,800,9237,10037
2021/09/07,18:00:00,383.26,531,9400,9931
2021/09/07,18:30:00,381.18,307,9514,9821
2021/09/07,19:00:00,383.26,121,9559,9680
2021/09/07,19:30:00,364.08,122,9751,9873
2021/09/07,20:00:00,385.81,122,9769,9891
2021/09/07,20:30:00,379.05,121,9712,9833
2021/09/07,21:00:00,385.25,120,9588,9708
2021/09/07,21:30:00,332.23,119,9522,9641
2021/09/07,22:00:00,335.09,119,9398,9517
2021/09/07,22:30:00,336.08,112,9225,9337
2021/09/07,23:00:00,332.11,40,9113,9153
2021/09/07,23:30:00,246,1,8949,8950
2021/09/08,00:00:00,247.01,1,8675,8676
2021/09/08,00:30:00,247.27,1,8389,8390
2021/09/08,01:00:00,246.75,1,8325,8326
2021/09/08,01:30:00,246.24,1,8251,8252
2021/09/08,02:00:00,246.5,1,8110,8111
2021/09/08,02:30:00,247.01,1,7974,7975
2021/09/08,03:00:00,247.01,1,7867,7868
2021/09/08,03:30:00,246.5,1,7780,7781
2021/09/08,04:00:00,246.5,1,7717,7718
2021/09/08,04:30:00,246.5,1,7692,7693
2021/09/08,05:00:00,247.27,0,7670,7670
2021/09/08,05:30:00,246.5,0,7657,7657
2021/09/08,06:00:00,246.24,0,7644,7644
2021/09/08,06:30:00,246.75,0,7483,7483
2021/09/08,07:00:00,246.5,115,7473,7588
2021/09/08,07:30:00,246.75,252,7435,7687
2021/09/08,08:00:00,247.01,578,7379,7957
2021/09/08,08:30:00,246.75,899,7345,8244
2021/09/08,09:00:00,246.24,1197,7276,8473
2021/09/08,09:30:00,246.5,1556,7239,8795
2021/09/08,10:00:00,246.24,1729,7306,9035
2021/09/08,10:30:00,247.01,1843,7249,9092
2021/09/08,11:00:00,246.75,1952,7248,9200
2021/09/08,11:30:00,246.5,2006,7393,9399
2021/09/08,12:00:00,246.75,2060,7563,9623
2021/09/08,12:30:00,247.27,2080,7689,9769
2021/09/08,13:00:00,246.75,2081,7845,9926
2021/09/08,13:30:00,246.75,2062,7978,10040
2021/09/08,14:00:00,246,2026,8083,10109
2021/09/08,14:30:00,246.5,1972,8258,10230
2021/09/08,15:00:00,247.01,1883,8390,10273
2021/09/08,15:30:00,246.5,1730,8590,10320
2021/09/08,16:00:00,247.01,1591,8794,10385
2021/09/08,16:30:00,246.24,1420,8986,10406
2021/09/08,17:00:00,245.75,1055,9196,10251
2021/09/08,17:30:00,293.53,805,9486,10291
2021/09/08,18:00:00,357.43,489,9667,10156
2021/09/08,18:30:00,363.36,124,9728,9852
2021/09/08,19:00:00,357.4,130,9834,9964
2021/09/08,19:30:00,379.45,129,10047,10176
2021/09/08,20:00:00,373.08,130,10000,10130
2021/09/08,20:30:00,373.33,130,10076,10206
2021/09/08,21:00:00,374.96,131,10064,10195
2021/09/08,21:30:00,368.29,126,10020,10146
2021/09/08,22:00:00,371.68,122,9888,10010
2021/09/08,22:30:00,374.96,121,9675,9796
2021/09/08,23:00:00,352.73,118,9427,9545
2021/09/08,23:30:00,386.22,67,9142,9209
2021/09/09,00:00:00,246.75,4,8916,8920
2021/09/09,00:30:00,246,4,8765,8769
2021/09/09,01:00:00,246.75,3,8662,8665
2021/09/09,01:30:00,247.01,2,8416,8418
2021/09/09,02:00:00,246.24,3,8207,8210
2021/09/09,02:30:00,246.24,2,8089,8091
2021/09/09,03:00:00,246.24,2,7975,7977
2021/09/09,03:30:00,246.5,2,7834,7836
2021/09/09,04:00:00,245.75,2,7816,7818
2021/09/09,04:30:00,247.01,2,7804,7806
2021/09/09,05:00:00,246.24,2,7799,7801
2021/09/09,05:30:00,246.5,2,7916,7918
2021/09/09,06:00:00,246,2,8004,8006
2021/09/09,06:30:00,246,2,7991,7993
2021/09/09,07:00:00,246.5,141,8253,8394
2021/09/09,07:30:00,321.67,273,8571,8844
2021/09/09,08:00:00,318.58,567,8760,9327
2021/09/09,08:30:00,316.66,882,8988,9870
2021/09/09,09:00:00,316.66,1313,9106,10419
2021/09/09,09:30:00,381.61,1539,9280,10819
2021/09/09,10:00:00,379.74,1682,9422,11104
2021/09/09,10:30:00,379.74,1836,9312,11148
2021/09/09,11:00:00,327.49,1924,9410,11334
2021/09/09,11:30:00,327.72,1971,9584,11555
2021/09/09,12:00:00,334.48,2005,9737,11742
2021/09/09,12:30:00,331.25,2044,9958,12002
2021/09/09,13:00:00,331.39,2038,10262,12300
2021/09/09,13:30:00,351.99,2025,10528,12553
2021/09/09,14:00:00,347.95,1982,10796,12778
2021/09/09,14:30:00,1974.55,1931,11056,12987
2021/09/09,15:00:00,1974.55,1823,11201,13024
2021/09/09,15:30:00,1974.55,1681,11312,12993
2021/09/09,16:00:00,1929.5,1557,11425,12982
2021/09/09,16:30:00,1909.08,1292,11518,12810
2021/09/09,17:00:00,1929.5,1002,11615,12617
2021/09/09,17:30:00,1950.85,760,11726,12486
2021/09/09,18:00:00,1929.5,405,11745,12150
2021/09/09,18:30:00,1950.85,300,11628,11928
2021/09/09,19:00:00,385.65,121,11628,11749
2021/09/09,19:30:00,379.79,122,11657,11779
2021/09/09,20:00:00,370.63,111,11570,11681
2021/09/09,20:30:00,337.63,118,11436,11554
2021/09/09,21:00:00,337.8,125,11261,11386
2021/09/09,21:30:00,344.95,124,11012,11136
2021/09/09,22:00:00,336.11,125,10722,10847
2021/09/09,22:30:00,336.91,126,10520,10646
2021/09/09,23:00:00,383.26,124,10247,10371
2021/09/09,23:30:00,385.24,124,9885,10009
2021/09/10,00:00:00,385.73,122,9624,9746
2021/09/10,00:30:00,382.82,4,9452,9456
2021/09/10,01:00:00,385.68,4,9189,9193
2021/09/10,01:30:00,385.68,4,9114,9118
2021/09/10,02:00:00,380.04,4,9099,9103
2021/09/10,02:30:00,377.32,3,8928,8931
2021/09/10,03:00:00,385.68,3,8810,8813
2021/09/10,03:30:00,385.68,3,8753,8756
2021/09/10,04:00:00,380.04,3,8664,8667
2021/09/10,04:30:00,385.68,5,8647,8652
2021/09/10,05:00:00,385.68,6,8662,8668
2021/09/10,05:30:00,382.77,5,8697,8702
2021/09/10,06:00:00,246.75,6,8676,8682
2021/09/10,06:30:00,246.75,5,8557,8562
2021/09/10,07:00:00,246.5,111,8613,8724
2021/09/10,07:30:00,247.27,229,8843,9072
2021/09/10,08:00:00,246.5,434,8919,9353
2021/09/10,08:30:00,247.01,765,9017,9782
2021/09/10,09:00:00,246.75,1088,9095,10183
2021/09/10,09:30:00,246.75,1210,9289,10499
2021/09/10,10:00:00,247.01,1217,9368,10585
2021/09/10,10:30:00,246,1346,9444,10790
2021/09/10,11:00:00,246.24,1421,9544,10965
2021/09/10,11:30:00,246.5,1428,9666,11094
2021/09/10,12:00:00,246.5,1439,9665,11104
2021/09/10,12:30:00,246.5,1410,9756,11166
2021/09/10,13:00:00,246.5,1372,9780,11152
2021/09/10,13:30:00,246.24,1428,9613,11041
2021/09/10,14:00:00,246,1421,9609,11030
2021/09/10,14:30:00,246.75,1422,9662,11084
2021/09/10,15:00:00,246.24,1399,9600,10999
2021/09/10,15:30:00,246.5,1409,9530,10939
2021/09/10,16:00:00,246.24,1186,9578,10764
2021/09/10,16:30:00,246.5,1036,9720,10756
2021/09/10,17:00:00,247.27,783,9879,10662
2021/09/10,17:30:00,247.01,506,10120,10626
2021/09/10,18:00:00,246.5,284,10286,10570
2021/09/10,18:30:00,246.24,201,10291,10492
2021/09/10,19:00:00,246.5,11,10252,10263
2021/09/10,19:30:00,246.5,8,10272,10280
2021/09/10,20:00:00,246.75,12,10157,10169
2021/09/10,20:30:00,246.75,14,9938,9952
2021/09/10,21:00:00,246.5,13,9753,9766
2021/09/10,21:30:00,246.24,15,9605,9620
2021/09/10,22:00:00,246.24,14,9443,9457
2021/09/10,22:30:00,246.24,13,9305,9318
2021/09/10,23:00:00,246.24,4,9174,9178
2021/09/10,23:30:00,246.24,2,8968,8970
2021/09/11,00:00:00,246.5,3,8761,8764
2021/09/11,00:30:00,246.24,3,8522,8525
2021/09/11,01:00:00,246.5,3,8343,8346
2021/09/11,01:30:00,246.5,3,8151,8154
2021/09/11,02:00:00,247.01,5,8000,8005
2021/09/11,02:30:00,246.24,5,8009,8014
2021/09/11,03:00:00,246.24,5,8065,8070
2021/09/11,03:30:00,246.5,7,7946,7953
2021/09/11,04:00:00,246.5,9,7869,7878
2021/09/11,04:30:00,246.5,2,7830,7832
2021/09/11,05:00:00,246.24,5,7801,7806
2021/09/11,05:30:00,246.75,4,7818,7822
2021/09/11,06:00:00,246.5,4,7805,7809
2021/09/11,06:30:00,246.75,2,7614,7616
2021/09/11,07:00:00,246.5,96,7532,7628
2021/09/11,07:30:00,246.5,242,7502,7744
2021/09/11,08:00:00,246.5,444,7426,7870
2021/09/11,08:30:00,246.75,804,7379,8183
2021/09/11,09:00:00,246.5,1064,7373,8437
2021/09/11,09:30:00,246.75,1289,7381,8670
2021/09/11,10:00:00,246.5,1141,7580,8721
2021/09/11,10:30:00,246.5,1586,7332,8918
2021/09/11,11:00:00,246.5,1495,7273,8768
2021/09/11,11:30:00,247.01,1509,7444,8953
2021/09/11,12:00:00,246.5,1600,7484,9084
2021/09/11,12:30:00,246.24,1557,7547,9104
2021/09/11,13:00:00,246.24,1618,7672,9290
2021/09/11,13:30:00,246.5,1500,7699,9199
2021/09/11,14:00:00,246.5,1565,7681,9246
2021/09/11,14:30:00,246.5,1666,7849,9515
2021/09/11,15:00:00,246.5,1594,7797,9391
2021/09/11,15:30:00,246.5,1546,7892,9438
2021/09/11,16:00:00,246.5,1463,8000,9463
2021/09/11,16:30:00,246.5,1317,8218,9535
2021/09/11,17:00:00,246.24,938,8463,9401
2021/09/11,17:30:00,246.24,666,8654,9320
2021/09/11,18:00:00,246.5,414,8848,9262
2021/09/11,18:30:00,291.04,294,8953,9247
2021/09/11,19:00:00,292.83,89,9192,9281
2021/09/11,19:30:00,291.83,68,9404,9472
2021/09/11,20:00:00,291.83,10,9425,9435
2021/09/11,20:30:00,291.83,9,9482,9491
2021/09/11,21:00:00,335.88,7,9427,9434
2021/09/11,21:30:00,246.24,8,9441,9449
2021/09/11,22:00:00,246.24,7,9296,9303
2021/09/11,22:30:00,246,7,9186,9193
2021/09/11,23:00:00,246.24,9,8945,8954
2021/09/11,23:30:00,246.75,11,8693,8704
2021/09/12,00:00:00,246.5,12,8407,8419
2021/09/12,00:30:00,246.24,9,8140,8149
2021/09/12,01:00:00,246.24,9,7924,7933
2021/09/12,01:30:00,246.5,8,7896,7904
2021/09/12,02:00:00,246.5,3,7857,7860
2021/09/12,02:30:00,246.5,4,7732,7736
2021/09/12,03:00:00,247.27,5,7637,7642
2021/09/12,03:30:00,246.5,4,7544,7548
2021/09/12,04:00:00,246.5,6,7492,7498
2021/09/12,04:30:00,245.75,5,7535,7540
2021/09/12,05:00:00,246.5,3,7557,7560
2021/09/12,05:30:00,246.5,3,7694,7697
2021/09/12,06:00:00,246.5,3,7762,7765
2021/09/12,06:30:00,247.27,3,7891,7894
2021/09/12,07:00:00,246.5,167,8124,8291
2021/09/12,07:30:00,246.75,228,8438,8666
2021/09/12,08:00:00,246.24,575,8521,9096
2021/09/12,08:30:00,247.01,924,8697,9621
2021/09/12,09:00:00,246.24,1177,8745,9922
2021/09/12,09:30:00,246.24,1392,8853,10245
2021/09/12,10:00:00,246.24,1431,8702,10133
2021/09/12,10:30:00,246.24,1549,8830,10379
2021/09/12,11:00:00,246.5,1600,8845,10445
2021/09/12,11:30:00,246.75,1487,8861,10348
2021/09/12,12:00:00,243.08,1549,9071,10620
2021/09/12,12:30:00,245.75,1571,9142,10713
2021/09/12,13:00:00,245.75,1523,9324,10847
2021/09/12,13:30:00,375.76,1662,9416,11078
2021/09/12,14:00:00,377.72,1739,9533,11272
2021/09/12,14:30:00,375.76,1700,9607,11307
2021/09/12,15:00:00,374.06,1558,9781,11339
2021/09/12,15:30:00,377.82,1463,9779,11242
2021/09/12,16:00:00,374.06,1453,9753,11206
2021/09/12,16:30:00,374.06,1302,9833,11135
2021/09/12,17:00:00,374.73,998,9872,10870
2021/09/12,17:30:00,374.73,747,9925,10672
2021/09/12,18:00:00,376.42,463,9978,10441
2021/09/12,18:30:00,378.14,117,9959,10076
2021/09/12,19:00:00,376.44,117,10125,10242
2021/09/12,19:30:00,346.08,120,10208,10328
2021/09/12,20:00:00,376.44,118,10130,10248
2021/09/12,20:30:00,343.15,118,10010,10128
2021/09/12,21:00:00,341.74,117,9898,10015
2021/09/12,21:30:00,381.1,114,9728,9842
2021/09/12,22:00:00,245.51,55,9503,9558
2021/09/12,22:30:00,376.44,9,9328,9337
2021/09/12,23:00:00,245.75,8,9063,9071
2021/09/12,23:30:00,245.51,8,8735,8743
2021/09/13,00:00:00,246,5,8406,8411
2021/09/13,00:30:00,246.24,4,8173,8177
2021/09/13,01:00:00,246.24,4,8061,8065
2021/09/13,01:30:00,246,4,8005,8009
2021/09/13,02:00:00,245.75,4,7841,7845
2021/09/13,02:30:00,246,4,7685,7689
2021/09/13,03:00:00,245.27,4,7602,7606
2021/09/13,03:30:00,245.75,4,7526,7530
2021/09/13,04:00:00,246.24,4,7503,7507
2021/09/13,04:30:00,245.75,4,7508,7512
2021/09/13,05:00:00,245.75,4,7530,7534
2021/09/13,05:30:00,245.51,4,7656,7660
2021/09/13,06:00:00,246,4,7702,7706
2021/09/13,06:30:00,245.51,4,7790,7794
2021/09/13,07:00:00,246,18,8007,8025
2021/09/13,07:30:00,246.75,237,8096,8333
2021/09/13,08:00:00,246.24,625,7958,8583
2021/09/13,08:30:00,246.24,964,8070,9034
2021/09/13,09:00:00,246,1300,8041,9341
2021/09/13,09:30:00,246.24,1538,8171,9709
2021/09/13,10:00:00,246,1668,8206,9874
2021/09/13,10:30:00,245.75,1797,8261,10058
2021/09/13,11:00:00,246,1892,8331,10223
2021/09/13,11:30:00,246.24,1951,8419,10370
2021/09/13,12:00:00,246,1945,8584,10529
2021/09/13,12:30:00,246,1946,8722,10668
2021/09/13,13:00:00,245.51,1972,8915,10887
2021/09/13,13:30:00,246.24,1944,9196,11140
2021/09/13,14:00:00,246,1915,9492,11407
2021/09/13,14:30:00,245.75,1859,9692,11551
2021/09/13,15:00:00,245.51,1758,9888,11646
2021/09/13,15:30:00,246,1627,10002,11629
2021/09/13,16:00:00,245.75,1476,10088,11564
2021/09/13,16:30:00,378.24,1227,10264,11491
2021/09/13,17:00:00,384.35,940,10428,11368
2021/09/13,17:30:00,384.35,707,10527,11234
2021/09/13,18:00:00,384.35,410,10532,10942
2021/09/13,18:30:00,384.35,140,10452,10592
2021/09/13,19:00:00,384.35,140,10515,10655
2021/09/13,19:30:00,384.35,150,10609,10759
2021/09/13,20:00:00,384.35,152,10503,10655
2021/09/13,20:30:00,384.35,152,10410,10562
2021/09/13,21:00:00,384.35,151,10292,10443
2021/09/13,21:30:00,377.19,151,10116,10267
2021/09/13,22:00:00,246.24,136,9816,9952
2021/09/13,22:30:00,384.87,92,9674,9766
2021/09/13,23:00:00,330.02,33,9407,9440
2021/09/13,23:30:00,377.78,33,9068,9101
2021/09/14,00:00:00,247.01,33,8752,8785
2021/09/14,00:30:00,246,33,8460,8493
2021/09/14,01:00:00,245.75,33,8244,8277
2021/09/14,01:30:00,246,33,8059,8092
2021/09/14,02:00:00,246,33,8023,8056
2021/09/14,02:30:00,246.5,34,7896,7930
2021/09/14,03:00:00,246,35,7940,7975
2021/09/14,03:30:00,246,36,7828,7864
2021/09/14,04:00:00,246,33,7801,7834
2021/09/14,04:30:00,245.27,34,7834,7868
2021/09/14,05:00:00,246,35,7870,7905
2021/09/14,05:30:00,245.75,35,7950,7985
2021/09/14,06:00:00,246,28,8080,8108
2021/09/14,06:30:00,244.58,26,8138,8164
2021/09/14,07:00:00,244.58,156,8354,8510
2021/09/14,07:30:00,244.36,197,8679,8876
2021/09/14,08:00:00,249.01,492,8837,9329
2021/09/14,08:30:00,245.75,789,9120,9909
2021/09/14,09:00:00,244.81,1000,9222,10222
2021/09/14,09:30:00,376.95,1149,9421,10570
2021/09/14,10:00:00,375.22,1393,9334,10727
2021/09/14,10:30:00,379.48,1671,9323,10994
2021/09/14,11:00:00,375.22,1843,9367,11210
2021/09/14,11:30:00,377.42,1821,9412,11233
2021/09/14,12:00:00,375.53,1870,9392,11262
2021/09/14,12:30:00,379.56,1894,9363,11257
2021/09/14,13:00:00,379.56,1906,9491,11397
2021/09/14,13:30:00,375.68,1890,9722,11612
2021/09/14,14:00:00,379.6,1768,10017,11785
2021/09/14,14:30:00,377.62,1854,10115,11969
2021/09/14,15:00:00,377.62,1801,10279,12080
2021/09/14,15:30:00,377.62,1727,10358,12085
2021/09/14,16:00:00,375.68,1619,10401,12020
2021/09/14,16:30:00,375.68,1388,10477,11865
2021/09/14,17:00:00,376.18,1007,10601,11608
2021/09/14,17:30:00,376.18,706,10692,11398
2021/09/14,18:00:00,376.18,453,10689,11142
2021/09/14,18:30:00,376.18,309,10621,10930
2021/09/14,19:00:00,376.18,151,10685,10836
2021/09/14,19:30:00,380.95,158,10694,10852
2021/09/14,20:00:00,376.2,156,10604,10760
2021/09/14,20:30:00,380.95,160,10483,10643
2021/09/14,21:00:00,242.68,157,10352,10509
2021/09/14,21:30:00,257.51,152,10095,10247
2021/09/14,22:00:00,238.48,105,9927,10032
2021/09/14,22:30:00,238.48,42,9801,9843
2021/09/14,23:00:00,238.12,34,9518,9552
2021/09/14,23:30:00,240.91,34,9199,9233
2021/09/15,00:00:00,240.47,34,8850,8884
2021/09/15,00:30:00,240.69,31,8553,8584
2021/09/15,01:00:00,239.63,31,8252,8283
2021/09/15,01:30:00,240.26,31,8050,8081
2021/09/15,02:00:00,240.47,31,7987,8018
2021/09/15,02:30:00,239.24,31,7952,7983
2021/09/15,03:00:00,239.24,31,7850,7881
2021/09/15,03:30:00,239.24,31,7752,7783
2021/09/15,04:00:00,238.85,31,7699,7730
2021/09/15,04:30:00,239.24,31,7655,7686
2021/09/15,05:00:00,237.6,32,7647,7679
2021/09/15,05:30:00,238.3,32,7701,7733
2021/09/15,06:00:00,237.77,30,7660,7690
2021/09/15,06:30:00,237.94,1,7624,7625
2021/09/15,07:00:00,237.94,106,7639,7745
2021/09/15,07:30:00,237.94,289,7697,7986
2021/09/15,08:00:00,237.94,565,7720,8285
2021/09/15,08:30:00,237.77,887,7824,8711
2021/09/15,09:00:00,238.12,1307,7831,9138
2021/09/15,09:30:00,238.3,1374,8099,9473
2021/09/15,10:00:00,237.77,1631,8117,9748
2021/09/15,10:30:00,237.94,1815,8275,10090
2021/09/15,11:00:00,239.04,1876,8328,10204
2021/09/15,11:30:00,236.84,1909,8340,10249
2021/09/15,12:00:00,237.1,1873,8519,10392
2021/09/15,12:30:00,237.36,1941,8574,10515
2021/09/15,13:00:00,248.68,1827,8760,10587
2021/09/15,13:30:00,237.1,1853,8706,10559
2021/09/15,14:00:00,248.54,1771,8775,10546
2021/09/15,14:30:00,248.68,1678,8895,10573
2021/09/15,15:00:00,248.68,1564,9005,10569
2021/09/15,15:30:00,248.39,1509,9064,10573
2021/09/15,16:00:00,237.1,1361,9243,10604
2021/09/15,16:30:00,380.13,1106,9411,10517
2021/09/15,17:00:00,380.13,834,9567,10401
2021/09/15,17:30:00,380.13,666,9633,10299
2021/09/15,18:00:00,380.13,372,9620,9992
2021/09/15,18:30:00,381.52,147,9460,9607
2021/09/15,19:00:00,376.17,154,9388,9542
2021/09/15,19:30:00,372.85,152,9228,9380
2021/09/15,20:00:00,371.01,148,9070,9218
2021/09/15,20:30:00,371.01,145,8956,9101
2021/09/15,21:00:00,372.85,145,8836,8981
2021/09/15,21:30:00,237.94,121,8742,8863
2021/09/15,22:00:00,238.12,36,8665,8701
2021/09/15,22:30:00,237.94,34,8524,8558
2021/09/15,23:00:00,237.94,33,8337,8370
2021/09/15,23:30:00,240.26,33,8120,8153
2021/09/16,00:00:00,240.26,33,7894,7927
2021/09/16,00:30:00,240.05,33,7698,7731
2021/09/16,01:00:00,239.04,33,7644,7677
2021/09/16,01:30:00,239.63,33,7536,7569
2021/09/16,02:00:00,239.24,33,7559,7592
2021/09/16,02:30:00,240.47,33,7447,7480
2021/09/16,03:00:00,240.26,33,7351,7384
2021/09/16,03:30:00,240.26,33,7287,7320
2021/09/16,04:00:00,240.05,33,7228,7261
2021/09/16,04:30:00,239.84,33,7221,7254
2021/09/16,05:00:00,240.26,33,7198,7231
2021/09/16,05:30:00,240.05,32,7216,7248
2021/09/16,06:00:00,240.69,32,7199,7231
2021/09/16,06:30:00,240.26,16,7057,7073
2021/09/16,07:00:00,240.26,22,6991,7013
2021/09/16,07:30:00,240.26,240,6911,7151
2021/09/16,08:00:00,240.69,498,6849,7347
2021/09/16,08:30:00,240.47,777,6712,7489
2021/09/16,09:00:00,239.43,1161,6508,7669
2021/09/16,09:30:00,240.05,1411,6491,7902
2021/09/16,10:00:00,240.47,1423,6551,7974
2021/09/16,10:30:00,240.26,1583,6507,8090
2021/09/16,11:00:00,239.63,1524,6624,8148
2021/09/16,11:30:00,239.63,1671,6615,8286
2021/09/16,12:00:00,239.84,1575,6794,8369
2021/09/16,12:30:00,240.26,1579,6917,8496
2021/09/16,13:00:00,240.47,1718,6901,8619
2021/09/16,13:30:00,325.13,1678,7072,8750
2021/09/16,14:00:00,325.09,1594,7126,8720
2021/09/16,14:30:00,325.09,1393,7341,8734
2021/09/16,15:00:00,328.38,1450,7378,8828
2021/09/16,15:30:00,348.57,1342,7455,8797
2021/09/16,16:00:00,328.95,1263,7542,8805
2021/09/16,16:30:00,380.89,1152,7621,8773
2021/09/16,17:00:00,385.67,839,7812,8651
2021/09/16,17:30:00,385.67,562,7958,8520
2021/09/16,18:00:00,380.89,361,8091,8452
2021/09/16,18:30:00,380.89,217,8167,8384
2021/09/16,19:00:00,378.82,42,8426,8468
2021/09/16,19:30:00,380.95,43,8861,8904
2021/09/16,20:00:00,380.95,42,8729,8771
2021/09/16,20:30:00,380.95,39,8705,8744
2021/09/16,21:00:00,380.95,40,8683,8723
2021/09/16,21:30:00,380.95,33,8663,8696
2021/09/16,22:00:00,385.67,32,8573,8605
2021/09/16,22:30:00,378.71,32,8501,8533
2021/09/16,23:00:00,380.84,33,8357,8390
2021/09/16,23:30:00,239.63,33,8191,8224
2021/09/17,00:00:00,240.26,33,7933,7966
2021/09/17,00:30:00,240.47,33,7705,7738
2021/09/17,01:00:00,240.47,33,7517,7550
2021/09/17,01:30:00,240.69,33,7304,7337
2021/09/17,02:00:00,239.04,33,7144,7177
2021/09/17,02:30:00,240.69,33,7156,7189
2021/09/17,03:00:00,240.69,33,7164,7197
2021/09/17,03:30:00,240.26,33,7076,7109
2021/09/17,04:00:00,240.26,33,7037,7070
2021/09/17,04:30:00,240.05,33,7029,7062
2021/09/17,05:00:00,240.26,32,7047,7079
2021/09/17,05:30:00,239.84,32,7127,7159
2021/09/17,06:00:00,240.26,32,7153,7185
2021/09/17,06:30:00,240.69,16,7061,7077
2021/09/17,07:00:00,240.26,151,7145,7296
2021/09/17,07:30:00,239.43,263,7271,7534
2021/09/17,08:00:00,239.43,460,7341,7801
2021/09/17,08:30:00,240.05,833,7344,8177
2021/09/17,09:00:00,240.05,1213,7282,8495
2021/09/17,09:30:00,239.43,1485,7266,8751
2021/09/17,10:00:00,239.84,1658,7258,8916
2021/09/17,10:30:00,240.26,1819,7310,9129
2021/09/17,11:00:00,239.63,1904,7363,9267
2021/09/17,11:30:00,240.47,2012,7454,9466
2021/09/17,12:00:00,240.26,2060,7369,9429
2021/09/17,12:30:00,239.24,2069,7343,9412
2021/09/17,13:00:00,239.84,2060,7428,9488
2021/09/17,13:30:00,239.43,2054,7541,9595
2021/09/17,14:00:00,238.66,2012,7623,9635
2021/09/17,14:30:00,240.05,1937,7747,9684
2021/09/17,15:00:00,239.43,1826,7839,9665
2021/09/17,15:30:00,239.43,1727,7949,9676
2021/09/17,16:00:00,239.63,1558,8084,9642
2021/09/17,16:30:00,239.63,1280,8320,9600
2021/09/17,17:00:00,239.63,986,8608,9594
2021/09/17,17:30:00,239.63,720,8924,9644
2021/09/17,18:00:00,239.24,363,9218,9581
2021/09/17,18:30:00,239.24,132,9254,9386
2021/09/17,19:00:00,239.63,140,9359,9499
2021/09/17,19:30:00,239.43,141,9283,9424
2021/09/17,20:00:00,239.24,139,9139,9278
2021/09/17,20:30:00,239.63,145,9004,9149
2021/09/17,21:00:00,239.63,154,8851,9005
2021/09/17,21:30:00,239.24,153,8694,8847
2021/09/17,22:00:00,239.43,153,8517,8670
2021/09/17,22:30:00,239.43,152,8387,8539
2021/09/17,23:00:00,239.63,152,8224,8376
2021/09/17,23:30:00,239.43,150,8016,8166
2021/09/18,00:00:00,239.24,151,7806,7957
2021/09/18,00:30:00,238.12,146,7597,7743
2021/09/18,01:00:00,239.24,38,7549,7587
2021/09/18,01:30:00,240.47,33,7407,7440
2021/09/18,02:00:00,240.05,33,7397,7430
2021/09/18,02:30:00,239.24,32,7454,7486
2021/09/18,03:00:00,240.05,30,7348,7378
2021/09/18,03:30:00,240.05,30,7271,7301
2021/09/18,04:00:00,240.47,29,7211,7240
2021/09/18,04:30:00,240.47,29,7206,7235
2021/09/18,05:00:00,239.84,28,7192,7220
2021/09/18,05:30:00,240.26,28,7209,7237
2021/09/18,06:00:00,240.26,27,7188,7215
2021/09/18,06:30:00,240.05,0,7006,7006
2021/09/18,07:00:00,240.26,11,6897,6908
2021/09/18,07:30:00,240.69,242,6848,7090
2021/09/18,08:00:00,240.26,578,6747,7325
2021/09/18,08:30:00,239.84,950,6612,7562
2021/09/18,09:00:00,240.05,1312,6510,7822
2021/09/18,09:30:00,240.26,1573,6543,8116
2021/09/18,10:00:00,240.05,1662,6633,8295
2021/09/18,10:30:00,240.26,1759,6700,8459
2021/09/18,11:00:00,239.24,1857,6634,8491
2021/09/18,11:30:00,239.43,1968,6678,8646
2021/09/18,12:00:00,239.43,2004,6766,8770
2021/09/18,12:30:00,239.43,2073,6747,8820
2021/09/18,13:00:00,239.24,2025,6852,8877
2021/09/18,13:30:00,239.24,2050,6988,9038
2021/09/18,14:00:00,239.43,1989,7101,9090
2021/09/18,14:30:00,239.43,1944,7260,9204
2021/09/18,15:00:00,239.24,1858,7401,9259
2021/09/18,15:30:00,239.04,1707,7613,9320
2021/09/18,16:00:00,239.24,1532,7838,9370
2021/09/18,16:30:00,239.04,1357,8067,9424
2021/09/18,17:00:00,238.66,1005,8290,9295
2021/09/18,17:30:00,238.66,688,8548,9236
2021/09/18,18:00:00,238.66,437,8724,9161
2021/09/18,18:30:00,238.66,139,8804,8943
2021/09/18,19:00:00,238.3,140,9040,9180
2021/09/18,19:30:00,238.48,148,9121,9269
2021/09/18,20:00:00,238.66,152,9136,9288
2021/09/18,20:30:00,238.66,152,9119,9271
2021/09/18,21:00:00,238.48,152,9053,9205
2021/09/18,21:30:00,238.66,149,9056,9205
2021/09/18,22:00:00,238.48,152,8950,9102
2021/09/18,22:30:00,238.48,155,8786,8941
2021/09/18,23:00:00,238.85,152,8540,8692
2021/09/18,23:30:00,238.66,152,8290,8442
2021/09/19,00:00:00,238.48,152,8008,8160
2021/09/19,00:30:00,239.04,151,7807,7958
2021/09/19,01:00:00,238.48,150,7724,7874
2021/09/19,01:30:00,238.48,131,7681,7812
2021/09/19,02:00:00,238.48,32,7627,7659
2021/09/19,02:30:00,238.66,32,7482,7514
2021/09/19,03:00:00,238.66,32,7372,7404
2021/09/19,03:30:00,238.48,32,7284,7316
2021/09/19,04:00:00,238.48,32,7229,7261
2021/09/19,04:30:00,238.66,32,7227,7259
2021/09/19,05:00:00,238.48,34,7242,7276
2021/09/19,05:30:00,238.48,34,7369,7403
2021/09/19,06:00:00,238.66,32,7457,7489
2021/09/19,06:30:00,238.66,23,7493,7516
2021/09/19,07:00:00,238.48,121,7772,7893
2021/09/19,07:30:00,238.85,269,8042,8311
2021/09/19,08:00:00,238.66,540,8131,8671
2021/09/19,08:30:00,238.66,987,8276,9263
2021/09/19,09:00:00,238.66,1341,8301,9642
2021/09/19,09:30:00,238.48,1536,8425,9961
2021/09/19,10:00:00,238.66,1713,8440,10153
2021/09/19,10:30:00,238.66,1840,8516,10356
2021/09/19,11:00:00,238.48,1908,8535,10443
2021/09/19,11:30:00,238.66,1987,8457,10444
2021/09/19,12:00:00,238.66,2027,8445,10472
2021/09/19,12:30:00,238.85,2040,8599,10639
2021/09/19,13:00:00,377.65,2058,8769,10827
2021/09/19,13:30:00,375.47,2037,8996,11033
2021/09/19,14:00:00,375.47,2012,9165,11177
2021/09/19,14:30:00,377.65,1946,9350,11296
2021/09/19,15:00:00,333.9,1823,9490,11313
2021/09/19,15:30:00,333.71,1714,9639,11353
2021/09/19,16:00:00,386.16,1546,9730,11276
2021/09/19,16:30:00,386.16,1302,9847,11149
2021/09/19,17:00:00,386.16,986,9987,10973
2021/09/19,17:30:00,384.1,721,10155,10876
2021/09/19,18:00:00,384.1,359,10178,10537
2021/09/19,18:30:00,384.1,124,10147,10271
2021/09/19,19:00:00,384.1,125,10320,10445
2021/09/19,19:30:00,382.08,133,10324,10457
2021/09/19,20:00:00,384.1,134,10226,10360
2021/09/19,20:30:00,386.16,133,10066,10199
2021/09/19,21:00:00,384.1,135,9930,10065
2021/09/19,21:30:00,338.2,133,9786,9919
2021/09/19,22:00:00,337.22,131,9575,9706
2021/09/19,22:30:00,338.19,130,9399,9529
2021/09/19,23:00:00,325.55,126,9102,9228
2021/09/19,23:30:00,325.54,128,8806,8934
2021/09/20,00:00:00,323.98,128,8491,8619
2021/09/20,00:30:00,374.46,128,8256,8384
2021/09/20,01:00:00,374.46,127,8002,8129
2021/09/20,01:30:00,240.26,118,7787,7905
2021/09/20,02:00:00,240.69,82,7633,7715
2021/09/20,02:30:00,238.48,7,7541,7548
2021/09/20,03:00:00,240.47,5,7403,7408
2021/09/20,03:30:00,240.47,4,7320,7324
2021/09/20,04:00:00,239.84,4,7238,7242
2021/09/20,04:30:00,239.63,4,7223,7227
2021/09/20,05:00:00,240.26,4,7239,7243
2021/09/20,05:30:00,239.63,4,7307,7311
2021/09/20,06:00:00,240.47,3,7336,7339
2021/09/20,06:30:00,240.26,3,7321,7324
2021/09/20,07:00:00,240.47,11,7397,7408
2021/09/20,07:30:00,240.05,225,7525,7750
2021/09/20,08:00:00,236.8,559,7725,8284
2021/09/20,08:30:00,239.43,898,7815,8713
2021/09/20,09:00:00,238.66,1261,8003,9264
2021/09/20,09:30:00,239.84,1518,8165,9683
2021/09/20,10:00:00,371.87,1643,8318,9961
2021/09/20,10:30:00,379.72,1768,8475,10243
2021/09/20,11:00:00,377.04,1905,8577,10482
2021/09/20,11:30:00,374.52,1962,8713,10675
2021/09/20,12:00:00,374.52,2002,8853,10855
2021/09/20,12:30:00,383.4,2034,9005,11039
2021/09/20,13:00:00,383.59,2031,9116,11147
2021/09/20,13:30:00,383.59,2015,9289,11304
2021/09/20,14:00:00,386.15,1972,9429,11401
2021/09/20,14:30:00,383.59,1908,9594,11502
2021/09/20,15:00:00,383.59,1815,9450,11265
2021/09/20,15:30:00,383.72,1633,9562,11195
2021/09/20,16:00:00,386.15,1498,9651,11149
2021/09/20,16:30:00,383.72,1311,9813,11124
2021/09/20,17:00:00,384.04,933,10060,10993
2021/09/20,17:30:00,384.1,653,10278,10931
2021/09/20,18:00:00,1820.55,413,10388,10801
2021/09/20,18:30:00,1811.62,145,10165,10310
2021/09/20,19:00:00,386.16,149,10125,10274
2021/09/20,19:30:00,384.1,128,9899,10027
2021/09/20,20:00:00,386.16,127,9563,9690
2021/09/20,20:30:00,384.1,127,9355,9482
2021/09/20,21:00:00,384.1,126,9208,9334
2021/09/20,21:30:00,386.22,126,9087,9213
2021/09/20,22:00:00,384.1,68,9040,9108
2021/09/20,22:30:00,382.08,10,9020,9030
2021/09/20,23:00:00,379.82,5,8903,8908
2021/09/20,23:30:00,379.82,4,8773,8777
2021/09/21,00:00:00,380.45,5,8531,8536
2021/09/21,00:30:00,375.09,4,8336,8340
2021/09/21,01:00:00,375.09,4,8119,8123
2021/09/21,01:30:00,239.84,4,7908,7912
2021/09/21,02:00:00,239.84,6,7751,7757
2021/09/21,02:30:00,239.63,6,7612,7618
2021/09/21,03:00:00,239.43,6,7611,7617
2021/09/21,03:30:00,240.05,4,7541,7545
2021/09/21,04:00:00,239.04,3,7615,7618
2021/09/21,04:30:00,239.63,4,7513,7517
2021/09/21,05:00:00,239.63,3,7545,7548
2021/09/21,05:30:00,239.63,3,7551,7554
2021/09/21,06:00:00,239.84,3,7514,7517
2021/09/21,06:30:00,239.84,2,7426,7428
2021/09/21,07:00:00,240.05,5,7356,7361
2021/09/21,07:30:00,239.84,198,7319,7517
2021/09/21,08:00:00,239.63,411,7276,7687
2021/09/21,08:30:00,239.84,790,7279,8069
2021/09/21,09:00:00,239.63,1139,7186,8325
2021/09/21,09:30:00,239.63,1364,7195,8559
2021/09/21,10:00:00,239.63,1679,7241,8920
2021/09/21,10:30:00,239.84,1800,7348,9148
2021/09/21,11:00:00,239.63,1888,7475,9363
2021/09/21,11:30:00,239.84,1975,7656,9631
2021/09/21,12:00:00,239.63,2018,7771,9789
2021/09/21,12:30:00,239.43,2029,7949,9978
2021/09/21,13:00:00,239.84,2032,8112,10144
2021/09/21,13:30:00,375.62,2013,8261,10274
2021/09/21,14:00:00,380.51,1979,8259,10238
2021/09/21,14:30:00,375.62,1906,8259,10165
2021/09/21,15:00:00,375.62,1777,8468,10245
2021/09/21,15:30:00,375.93,1651,8688,10339
2021/09/21,16:00:00,375.93,1491,8897,10388
2021/09/21,16:30:00,381.36,1251,9116,10367
2021/09/21,17:00:00,381.98,944,9351,10295
2021/09/21,17:30:00,382.08,666,9535,10201
2021/09/21,18:00:00,382.08,361,9691,10052
2021/09/21,18:30:00,384.1,146,9695,9841
2021/09/21,19:00:00,382.2,150,9938,10088
2021/09/21,19:30:00,382.08,153,9999,10152
2021/09/21,20:00:00,382.08,152,10083,10235
2021/09/21,20:30:00,382.2,151,10058,10209
2021/09/21,21:00:00,382.08,93,10111,10204
2021/09/21,21:30:00,380.12,38,10089,10127
2021/09/21,22:00:00,382.2,37,9895,9932
2021/09/21,22:30:00,382.08,36,9688,9724
2021/09/21,23:00:00,386.14,37,9409,9446
2021/09/21,23:30:00,380.98,37,9101,9138
2021/09/22,00:00:00,380.93,38,8793,8831
2021/09/22,00:30:00,239.84,37,8519,8556
2021/09/22,01:00:00,240.26,38,8279,8317
2021/09/22,01:30:00,239.04,37,8066,8103
2021/09/22,02:00:00,240.05,35,7848,7883
2021/09/22,02:30:00,239.84,34,7671,7705
2021/09/22,03:00:00,240.47,35,7713,7748
2021/09/22,03:30:00,240.47,36,7658,7694
2021/09/22,04:00:00,239.63,37,7740,7777
2021/09/22,04:30:00,239.43,38,7732,7770
2021/09/22,05:00:00,240.26,40,7716,7756
2021/09/22,05:30:00,238.66,37,7843,7880
2021/09/22,06:00:00,240.05,35,7881,7916
2021/09/22,06:30:00,239.43,28,7875,7903
2021/09/22,07:00:00,239.84,20,8101,8121
2021/09/22,07:30:00,239.43,189,8318,8507
2021/09/22,08:00:00,240.26,389,8477,8866
2021/09/22,08:30:00,239.43,676,8632,9308
2021/09/22,09:00:00,239.63,1148,8563,9711
2021/09/22,09:30:00,239.63,1438,8630,10068
2021/09/22,10:00:00,239.63,1613,8635,10248
2021/09/22,10:30:00,239.63,1811,8705,10516
2021/09/22,11:00:00,382.35,1897,8787,10684
2021/09/22,11:30:00,377.88,1987,8860,10847
2021/09/22,12:00:00,372.76,2026,8856,10882
2021/09/22,12:30:00,321.74,2035,8840,10875
2021/09/22,13:00:00,325.06,2063,8960,11023
2021/09/22,13:30:00,325.06,2026,9127,11153
2021/09/22,14:00:00,381.1,1969,9224,11193
2021/09/22,14:30:00,381.1,1908,9398,11306
2021/09/22,15:00:00,381.1,1809,9516,11325
2021/09/22,15:30:00,381.36,1623,9686,11309
2021/09/22,16:00:00,386.13,1465,9782,11247
2021/09/22,16:30:00,386.13,1264,9972,11236
2021/09/22,17:00:00,386.14,926,10040,10966
2021/09/22,17:30:00,380.07,641,10167,10808
2021/09/22,18:00:00,380.07,412,10140,10552
2021/09/22,18:30:00,380.07,152,10111,10263
2021/09/22,19:00:00,386.14,158,10326,10484
2021/09/22,19:30:00,336.32,161,10321,10482
2021/09/22,20:00:00,336.8,162,10268,10430
2021/09/22,20:30:00,386.14,163,10218,10381
2021/09/22,21:00:00,382.08,161,10098,10259
2021/09/22,21:30:00,384.1,162,9885,10047
2021/09/22,22:00:00,380.12,154,9677,9831
2021/09/22,22:30:00,376.97,100,9543,9643
2021/09/22,23:00:00,380.61,72,9287,9359
2021/09/22,23:30:00,375.6,34,8983,9017
2021/09/23,00:00:00,240.05,35,8725,8760
2021/09/23,00:30:00,238.48,34,8407,8441
2021/09/23,01:00:00,239.84,36,8179,8215
2021/09/23,01:30:00,240.26,34,8017,8051
2021/09/23,02:00:00,239.43,35,7966,8001
2021/09/23,02:30:00,239.84,36,7972,8008
2021/09/23,03:00:00,239.63,37,7865,7902
2021/09/23,03:30:00,239.43,34,7779,7813
2021/09/23,04:00:00,239.84,36,7771,7807
2021/09/23,04:30:00,239.63,36,7750,7786
2021/09/23,05:00:00,239.63,36,7748,7784
2021/09/23,05:30:00,240.05,34,7852,7886
2021/09/23,06:00:00,239.63,34,7912,7946
2021/09/23,06:30:00,239.43,24,7911,7935
2021/09/23,07:00:00,239.43,22,8035,8057
2021/09/23,07:30:00,240.05,238,8238,8476
2021/09/23,08:00:00,238.85,562,8276,8838
2021/09/23,08:30:00,239.84,971,8352,9323
2021/09/23,09:00:00,239.63,1267,8358,9625
2021/09/23,09:30:00,362.31,1279,8664,9943
2021/09/23,10:00:00,364.91,1441,8572,10013
2021/09/23,10:30:00,362.31,1532,8529,10061
2021/09/23,11:00:00,362.31,1658,8518,10176
2021/09/23,11:30:00,367.58,1809,8494,10303
2021/09/23,12:00:00,290.16,1879,8493,10372
2021/09/23,12:30:00,290.16,1811,8588,10399
2021/09/23,13:00:00,291.14,1826,8465,10291
2021/09/23,13:30:00,285.85,1787,8592,10379
2021/09/23,14:00:00,316.77,1730,8636,10366
2021/09/23,14:30:00,315.28,1806,8524,10330
2021/09/23,15:00:00,319.32,1696,8560,10256
2021/09/23,15:30:00,321.75,1606,8626,10232
2021/09/23,16:00:00,329.26,1417,8755,10172
2021/09/23,16:30:00,330.67,1162,8897,10059
2021/09/23,17:00:00,335.27,918,9038,9956
2021/09/23,17:30:00,335.12,599,9196,9795
2021/09/23,18:00:00,336.23,339,9301,9640
2021/09/23,18:30:00,336.19,147,9313,9460
2021/09/23,19:00:00,335.07,151,9523,9674
2021/09/23,19:30:00,335.03,147,9489,9636
2021/09/23,20:00:00,376.49,77,9492,9569
2021/09/23,20:30:00,380.05,40,9400,9440
2021/09/23,21:00:00,380.05,43,9288,9331
2021/09/23,21:30:00,380.05,41,9150,9191
2021/09/23,22:00:00,381.83,45,8939,8984
2021/09/23,22:30:00,381.83,45,8827,8872
2021/09/23,23:00:00,367.3,45,8634,8679
2021/09/23,23:30:00,363.97,48,8455,8503
2021/09/24,00:00:00,311.01,48,8227,8275
2021/09/24,00:30:00,410.45,43,8008,8051
2021/09/24,01:00:00,407.2,47,7817,7864
2021/09/24,01:30:00,404.04,44,7640,7684
2021/09/24,02:00:00,404.04,43,7459,7502
2021/09/24,02:30:00,407.2,45,7451,7496
2021/09/24,03:00:00,239.63,42,7517,7559
2021/09/24,03:30:00,239.63,41,7411,7452
2021/09/24,04:00:00,240.05,39,7318,7357
2021/09/24,04:30:00,239.63,36,7239,7275
2021/09/24,05:00:00,239.63,32,7169,7201
2021/09/24,05:30:00,240.05,34,7234,7268
2021/09/24,06:00:00,239.43,35,7226,7261
2021/09/24,06:30:00,239.63,34,7159,7193
2021/09/24,07:00:00,239.84,35,7163,7198
2021/09/24,07:30:00,239.63,227,7228,7455
2021/09/24,08:00:00,239.43,372,7304,7676
2021/09/24,08:30:00,239.84,598,7337,7935
2021/09/24,09:00:00,239.43,911,7371,8282
2021/09/24,09:30:00,239.84,971,7432,8403
2021/09/24,10:00:00,240.47,969,7406,8375
2021/09/24,10:30:00,239.24,971,7446,8417
2021/09/24,11:00:00,239.04,1026,7380,8406
2021/09/24,11:30:00,239.63,1218,7129,8347
2021/09/24,12:00:00,239.63,1316,7005,8321
2021/09/24,12:30:00,239.84,1520,6970,8490
2021/09/24,13:00:00,239.63,1362,7031,8393
2021/09/24,13:30:00,239.84,1367,7083,8450
2021/09/24,14:00:00,239.43,1213,7156,8369
2021/09/24,14:30:00,239.63,1162,7147,8309
2021/09/24,15:00:00,240.26,1204,7147,8351
2021/09/24,15:30:00,239.63,1236,7177,8413
2021/09/24,16:00:00,239.63,1201,7188,8389
2021/09/24,16:30:00,239.63,1083,7356,8439
2021/09/24,17:00:00,240.05,823,7651,8474
2021/09/24,17:30:00,239.63,584,7989,8573
2021/09/24,18:00:00,239.63,302,8283,8585
2021/09/24,18:30:00,239.63,36,8348,8384
2021/09/24,19:00:00,239.84,43,8530,8573
2021/09/24,19:30:00,239.63,44,8440,8484
2021/09/24,20:00:00,239.43,43,8291,8334
2021/09/24,20:30:00,239.84,37,8182,8219
2021/09/24,21:00:00,239.84,37,8047,8084
2021/09/24,21:30:00,239.84,36,7947,7983
2021/09/24,22:00:00,239.63,35,7785,7820
2021/09/24,22:30:00,239.63,36,7682,7718
2021/09/24,23:00:00,239.63,33,7543,7576
2021/09/24,23:30:00,239.43,35,7324,7359
2021/09/25,00:00:00,239.63,33,7151,7184
2021/09/25,00:30:00,239.43,32,6963,6995
2021/09/25,01:00:00,239.63,32,6816,6848
2021/09/25,01:30:00,240.26,32,6698,6730
2021/09/25,02:00:00,240.91,32,6582,6614
2021/09/25,02:30:00,238.85,33,6760,6793
2021/09/25,03:00:00,239.43,32,6694,6726
2021/09/25,03:30:00,240.05,32,6655,6687
2021/09/25,04:00:00,240.26,32,6640,6672
2021/09/25,04:30:00,240.69,32,6610,6642
2021/09/25,05:00:00,240.26,32,6633,6665
2021/09/25,05:30:00,240.47,31,6659,6690
2021/09/25,06:00:00,240.47,28,6635,6663
2021/09/25,06:30:00,240.47,20,6505,6525
2021/09/25,07:00:00,240.47,21,6419,6440
2021/09/25,07:30:00,240.47,237,6312,6549
2021/09/25,08:00:00,240.47,603,6063,6666
2021/09/25,08:30:00,240.47,1025,5761,6786
2021/09/25,09:00:00,240.47,1293,5633,6926
2021/09/25,09:30:00,240.47,1580,5515,7095
2021/09/25,10:00:00,239.63,1773,5415,7188
2021/09/25,10:30:00,239.84,1859,5429,7288
2021/09/25,11:00:00,239.84,1958,5471,7429
2021/09/25,11:30:00,239.63,2019,5492,7511
2021/09/25,12:00:00,239.63,2033,5530,7563
2021/09/25,12:30:00,239.43,2059,5565,7624
2021/09/25,13:00:00,239.84,2052,5647,7699
2021/09/25,13:30:00,239.43,2036,5749,7785
2021/09/25,14:00:00,239.63,2042,5824,7866
2021/09/25,14:30:00,239.04,1935,5985,7920
2021/09/25,15:00:00,239.84,1862,6117,7979
2021/09/25,15:30:00,239.63,1747,6295,8042
2021/09/25,16:00:00,240.69,1539,6537,8076
2021/09/25,16:30:00,239.43,1311,6773,8084
2021/09/25,17:00:00,239.63,1016,7062,8078
2021/09/25,17:30:00,323.16,645,7331,7976
2021/09/25,18:00:00,374.92,334,7598,7932
2021/09/25,18:30:00,378.57,139,7759,7898
2021/09/25,19:00:00,378.57,146,8002,8148
2021/09/25,19:30:00,239.04,149,8080,8229
2021/09/25,20:00:00,238.85,148,8107,8255
2021/09/25,20:30:00,237.6,148,8073,8221
2021/09/25,21:00:00,239.24,147,7999,8146
2021/09/25,21:30:00,239.24,146,7921,8067
2021/09/25,22:00:00,239.24,145,7811,7956
2021/09/25,22:30:00,239.04,145,7676,7821
2021/09/25,23:00:00,239.04,111,7576,7687
2021/09/25,23:30:00,238.3,32,7439,7471
2021/09/26,00:00:00,240.47,33,7215,7248
2021/09/26,00:30:00,239.04,33,7019,7052
2021/09/26,01:00:00,240.26,32,6815,6847
2021/09/26,01:30:00,240.05,33,6678,6711
2021/09/26,02:00:00,240.47,33,6539,6572
2021/09/26,02:30:00,239.63,32,6578,6610
2021/09/26,03:00:00,240.91,33,6475,6508
2021/09/26,03:30:00,239.84,32,6581,6613
2021/09/26,04:00:00,240.47,32,6532,6564
2021/09/26,04:30:00,239.43,33,6540,6573
2021/09/26,05:00:00,239.84,33,6597,6630
2021/09/26,05:30:00,239.63,31,6702,6733
2021/09/26,06:00:00,240.05,31,6837,6868
2021/09/26,06:30:00,241.14,22,6857,6879
2021/09/26,07:00:00,240.26,18,6999,7017
2021/09/26,07:30:00,239.63,290,7123,7413
2021/09/26,08:00:00,239.84,608,7067,7675
2021/09/26,08:30:00,240.26,971,7073,8044
2021/09/26,09:00:00,240.05,1365,7010,8375
2021/09/26,09:30:00,240.47,1562,7063,8625
2021/09/26,10:00:00,239.84,1698,7152,8850
2021/09/26,10:30:00,239.84,1849,7087,8936
2021/09/26,11:00:00,239.24,1940,7068,9008
2021/09/26,11:30:00,240.26,1994,7190,9184
2021/09/26,12:00:00,239.43,2034,7407,9441
2021/09/26,12:30:00,363.44,2049,7587,9636
2021/09/26,13:00:00,330.04,2038,7793,9831
2021/09/26,13:30:00,338.58,2007,8026,10033
2021/09/26,14:00:00,339.58,1954,8232,10186
2021/09/26,14:30:00,345.8,1890,8437,10327
2021/09/26,15:00:00,353.81,1791,8613,10404
2021/09/26,15:30:00,345.71,1630,8841,10471
2021/09/26,16:00:00,348.08,1482,9010,10492
2021/09/26,16:30:00,348.1,1264,9199,10463
2021/09/26,17:00:00,339.36,914,9440,10354
2021/09/26,17:30:00,339.29,621,9538,10159
2021/09/26,18:00:00,339.22,340,9635,9975
2021/09/26,18:30:00,347.87,128,9618,9746
2021/09/26,19:00:00,357.58,136,9771,9907
2021/09/26,19:30:00,344.91,139,9732,9871
2021/09/26,20:00:00,339.5,141,9644,9785
2021/09/26,20:30:00,342.53,140,9528,9668
2021/09/26,21:00:00,338.37,140,9415,9555
2021/09/26,21:30:00,337.42,139,9238,9377
2021/09/26,22:00:00,337.42,137,9047,9184
2021/09/26,22:30:00,337.42,107,8909,9016
2021/09/26,23:00:00,374.07,33,8772,8805
2021/09/26,23:30:00,378.4,34,8548,8582
2021/09/27,00:00:00,240.69,33,8301,8334
2021/09/27,00:30:00,240.69,33,8061,8094
2021/09/27,01:00:00,238.85,33,7875,7908
2021/09/27,01:30:00,237.77,33,7683,7716
2021/09/27,02:00:00,240.05,33,7503,7536
2021/09/27,02:30:00,240.26,33,7403,7436
2021/09/27,03:00:00,240.47,33,7276,7309
2021/09/27,03:30:00,240.47,33,7202,7235
2021/09/27,04:00:00,240.47,33,7128,7161
2021/09/27,04:30:00,240.26,33,7148,7181
2021/09/27,05:00:00,239.43,33,7302,7335
2021/09/27,05:30:00,240.26,33,7567,7600
2021/09/27,06:00:00,240.69,31,7649,7680
2021/09/27,06:30:00,240.91,22,7655,7677
2021/09/27,07:00:00,240.69,17,7732,7749
2021/09/27,07:30:00,240.05,162,7863,8025
2021/09/27,08:00:00,240.05,357,7952,8309
2021/09/27,08:30:00,240.26,571,8071,8642
2021/09/27,09:00:00,239.84,788,8164,8952
2021/09/27,09:30:00,240.26,883,8242,9125
2021/09/27,10:00:00,377.3,1036,8333,9369
2021/09/27,10:30:00,374.68,1143,8448,9591
2021/09/27,11:00:00,374.68,1441,8363,9804
2021/09/27,11:30:00,377.36,1457,8446,9903
2021/09/27,12:00:00,374.78,1628,8434,10062
2021/09/27,12:30:00,372.25,1573,8459,10032
2021/09/27,13:00:00,377.66,1653,8476,10129
2021/09/27,13:30:00,375.24,1575,8498,10073
2021/09/27,14:00:00,380.13,1586,8527,10113
2021/09/27,14:30:00,377.66,1513,8615,10128
2021/09/27,15:00:00,377.66,1474,8501,9975
2021/09/27,15:30:00,375.55,1328,8564,9892
2021/09/27,16:00:00,381.81,1126,8546,9672
2021/09/27,16:30:00,375.55,933,8687,9620
2021/09/27,17:00:00,378.19,753,8829,9582
2021/09/27,17:30:00,378.27,508,9025,9533
2021/09/27,18:00:00,376.21,242,9182,9424
2021/09/27,18:30:00,376.21,64,9158,9222
2021/09/27,19:00:00,349.54,18,9253,9271
2021/09/27,19:30:00,334.98,19,9094,9113
2021/09/27,20:00:00,405.67,19,8901,8920
2021/09/27,20:30:00,334.95,18,8788,8806
2021/09/27,21:00:00,334.82,18,8627,8645
2021/09/27,21:30:00,386.22,15,8537,8552
2021/09/27,22:00:00,386.22,12,8384,8396
2021/09/27,22:30:00,386.22,13,8265,8278
2021/09/27,23:00:00,325.52,8,8104,8112
2021/09/27,23:30:00,325.47,10,7904,7914
2021/09/28,00:00:00,240.26,10,7726,7736
2021/09/28,00:30:00,240.47,9,7532,7541
2021/09/28,01:00:00,240.69,9,7356,7365
2021/09/28,01:30:00,240.47,9,7218,7227
2021/09/28,02:00:00,239.84,9,7233,7242
2021/09/28,02:30:00,240.69,9,7137,7146
2021/09/28,03:00:00,240.26,7,7188,7195
2021/09/28,03:30:00,240.47,6,7120,7126
2021/09/28,04:00:00,240.05,6,7080,7086
2021/09/28,04:30:00,240.69,4,7055,7059
2021/09/28,05:00:00,239.84,3,7061,7064
2021/09/28,05:30:00,240.05,2,7107,7109
2021/09/28,06:00:00,240.26,2,7071,7073
2021/09/28,06:30:00,240.05,2,7039,7041
2021/09/28,07:00:00,240.05,141,6971,7112
2021/09/28,07:30:00,240.47,256,6880,7136
2021/09/28,08:00:00,240.47,466,6752,7218
2021/09/28,08:30:00,240.26,762,6710,7472
2021/09/28,09:00:00,240.69,1051,6665,7716
2021/09/28,09:30:00,240.26,1274,6624,7898
2021/09/28,10:00:00,240.47,1273,6769,8042
2021/09/28,10:30:00,240.47,1328,6814,8142
2021/09/28,11:00:00,240.05,1452,6618,8070
2021/09/28,11:30:00,239.84,1641,6723,8364
2021/09/28,12:00:00,239.84,1557,6752,8309
2021/09/28,12:30:00,239.84,1660,6755,8415
2021/09/28,13:00:00,239.63,1823,6722,8545
2021/09/28,13:30:00,239.63,1861,6617,8478
2021/09/28,14:00:00,240.05,1624,6703,8327
2021/09/28,14:30:00,240.05,1625,6868,8493
2021/09/28,15:00:00,240.05,1531,7040,8571
2021/09/28,15:30:00,239.84,1479,7107,8586
2021/09/28,16:00:00,239.63,1367,7285,8652
2021/09/28,16:30:00,239.63,1083,7500,8583
2021/09/28,17:00:00,239.43,822,7739,8561
2021/09/28,17:30:00,239.84,552,8021,8573
2021/09/28,18:00:00,239.43,316,8201,8517
2021/09/28,18:30:00,239.84,85,8336,8421
2021/09/28,19:00:00,329.53,40,8630,8670
2021/09/28,19:30:00,334.48,42,8748,8790
2021/09/28,20:00:00,326.53,43,8792,8835
2021/09/28,20:30:00,373.87,42,8760,8802
2021/09/28,21:00:00,239.63,42,8688,8730
2021/09/28,21:30:00,240.05,41,8667,8708
2021/09/28,22:00:00,239.43,40,8511,8551
2021/09/28,22:30:00,239.84,39,8384,8423
2021/09/28,23:00:00,240.05,32,8228,8260
2021/09/28,23:30:00,239.43,32,7988,8020
2021/09/29,00:00:00,239.63,32,7737,7769
2021/09/29,00:30:00,239.04,32,7510,7542
2021/09/29,01:00:00,239.04,32,7480,7512
2021/09/29,01:30:00,239.43,31,7448,7479
2021/09/29,02:00:00,240.47,32,7294,7326
2021/09/29,02:30:00,240.69,32,7170,7202
2021/09/29,03:00:00,238.66,31,7083,7114
2021/09/29,03:30:00,239.24,31,7006,7037
2021/09/29,04:00:00,239.84,31,6987,7018
2021/09/29,04:30:00,239.43,31,6959,6990
2021/09/29,05:00:00,239.04,30,7055,7085
2021/09/29,05:30:00,239.24,30,7179,7209
2021/09/29,06:00:00,239.43,29,7341,7370
2021/09/29,06:30:00,239.04,28,7469,7497
2021/09/29,07:00:00,239.24,13,7666,7679
2021/09/29,07:30:00,239.43,201,7893,8094
2021/09/29,08:00:00,239.63,521,7948,8469
2021/09/29,08:30:00,240.26,956,7827,8783
2021/09/29,09:00:00,238.85,1188,7895,9083
2021/09/29,09:30:00,239.04,1481,7943,9424
2021/09/29,10:00:00,239.63,1470,8081,9551
2021/09/29,10:30:00,239.24,1646,8047,9693
2021/09/29,11:00:00,240.05,1823,7979,9802
2021/09/29,11:30:00,239.24,1921,8043,9964
2021/09/29,12:00:00,239.24,1989,8066,10055
2021/09/29,12:30:00,239.43,2037,8052,10089
2021/09/29,13:00:00,239.63,2018,8130,10148
2021/09/29,13:30:00,327.86,2021,8322,10343
2021/09/29,14:00:00,327.55,1977,8427,10404
2021/09/29,14:30:00,329.6,1897,8585,10482
2021/09/29,15:00:00,339.86,1837,8726,10563
2021/09/29,15:30:00,343.02,1642,8806,10448
2021/09/29,16:00:00,345.41,1380,8990,10370
2021/09/29,16:30:00,340.06,1248,9051,10299
2021/09/29,17:00:00,339.87,897,9298,10195
2021/09/29,17:30:00,366.96,540,9403,9943
2021/09/29,18:00:00,341.7,349,9470,9819
2021/09/29,18:30:00,354.14,147,9540,9687
2021/09/29,19:00:00,354.14,151,9673,9824
2021/09/29,19:30:00,354.14,153,9586,9739
2021/09/29,20:00:00,345.06,160,9498,9658
2021/09/29,20:30:00,405.62,159,9377,9536
2021/09/29,21:00:00,407.15,163,9230,9393
2021/09/29,21:30:00,379.28,160,9050,9210
2021/09/29,22:00:00,239.24,155,8797,8952
2021/09/29,22:30:00,238.66,157,8607,8764
2021/09/29,23:00:00,239.24,149,8361,8510
2021/09/29,23:30:00,238.85,148,8086,8234
2021/09/30,00:00:00,238.48,101,7820,7921
2021/09/30,00:30:00,239.04,35,7626,7661
2021/09/30,01:00:00,239.04,37,7384,7421
2021/09/30,01:30:00,239.24,37,7214,7251
2021/09/30,02:00:00,238.48,35,7212,7247
2021/09/30,02:30:00,239.04,34,7213,7247
2021/09/30,03:00:00,238.85,33,7019,7052
2021/09/30,03:30:00,240.05,34,6940,6974
2021/09/30,04:00:00,240.05,32,6897,6929
2021/09/30,04:30:00,240.26,32,6922,6954
2021/09/30,05:00:00,240.05,32,6971,7003
2021/09/30,05:30:00,240.47,31,7109,7140
2021/09/30,06:00:00,240.05,30,7242,7272
2021/09/30,06:30:00,239.84,19,7562,7581
2021/09/30,07:00:00,239.84,14,7779,7793
2021/09/30,07:30:00,240.47,206,8082,8288
2021/09/30,08:00:00,240.05,405,8107,8512
2021/09/30,08:30:00,404.13,619,8323,8942
2021/09/30,09:00:00,410.57,1218,7960,9178
2021/09/30,09:30:00,374.24,1517,7888,9405
2021/09/30,10:00:00,240.26,1581,7908,9489
2021/09/30,10:30:00,240.26,1850,7870,9720
2021/09/30,11:00:00,240.47,1910,7858,9768
2021/09/30,11:30:00,240.47,1996,7835,9831
2021/09/30,12:00:00,240.26,2010,7935,9945
2021/09/30,12:30:00,240.26,2047,8021,10068
2021/09/30,13:00:00,240.26,2053,8130,10183
2021/09/30,13:30:00,330.58,2024,8318,10342
2021/09/30,14:00:00,331.03,1970,8351,10321
2021/09/30,14:30:00,368.84,1914,8570,10484
2021/09/30,15:00:00,354.41,1777,8710,10487
2021/09/30,15:30:00,354.41,1644,8744,10388
2021/09/30,16:00:00,354.4,1501,8812,10313
2021/09/30,16:30:00,358.46,1209,8966,10175
2021/09/30,17:00:00,354.48,869,9172,10041
2021/09/30,17:30:00,382.26,589,9322,9911
2021/09/30,18:00:00,386.14,343,9412,9755
2021/09/30,18:30:00,355.86,147,9477,9624
2021/09/30,19:00:00,355.37,157,9579,9736
2021/09/30,19:30:00,355.37,158,9519,9677
2021/09/30,20:00:00,364.32,155,9395,9550
2021/09/30,20:30:00,388.33,155,9242,9397
2021/09/30,21:00:00,324.94,148,9088,9236
2021/09/30,21:30:00,324.94,147,8907,9054
2021/09/30,22:00:00,375.91,145,8702,8847
2021/09/30,22:30:00,240.26,83,8570,8653
2021/09/30,23:00:00,240.47,67,8362,8429
2021/09/30,23:30:00,240.05,35,8109,8144
2021/10/01,00:00:00,240.26,36,7855,7891
2021/10/01,00:30:00,240.05,36,7607,7643
2021/10/01,01:00:00,237.77,35,7397,7432
2021/10/01,01:30:00,238.85,35,7381,7416
2021/10/01,02:00:00,240.91,36,7330,7366
2021/10/01,02:30:00,240.69,35,7208,7243
2021/10/01,03:00:00,240.47,34,7073,7107
2021/10/01,03:30:00,240.47,34,7011,7045
2021/10/01,04:00:00,240.47,34,6938,6972
2021/10/01,04:30:00,240.47,33,6934,6967
2021/10/01,05:00:00,240.26,32,6931,6963
2021/10/01,05:30:00,240.26,31,7011,7042
2021/10/01,06:00:00,239.84,30,7059,7089
2021/10/01,06:30:00,240.05,29,7033,7062
2021/10/01,07:00:00,240.05,24,7083,7107
2021/10/01,07:30:00,240.05,178,7171,7349
2021/10/01,08:00:00,245.5,481,7184,7665
2021/10/01,08:30:00,250.64,768,7235,8003
2021/10/01,09:00:00,250.99,982,7225,8207
2021/10/01,09:30:00,250.64,1302,7198,8500
2021/10/01,10:00:00,250.64,1502,7165,8667
2021/10/01,10:30:00,250.29,1673,7193,8866
2021/10/01,11:00:00,250.64,1875,7047,8922
2021/10/01,11:30:00,249.59,1951,7107,9058
2021/10/01,12:00:00,250.29,2013,7130,9143
2021/10/01,12:30:00,250.29,2035,7112,9147
2021/10/01,13:00:00,249.59,1999,7277,9276
2021/10/01,13:30:00,251.35,1990,7368,9358
2021/10/01,14:00:00,249.59,1931,7439,9370
2021/10/01,14:30:00,240.47,1825,7585,9410
2021/10/01,15:00:00,240.69,1694,7679,9373
2021/10/01,15:30:00,240.05,1560,7766,9326
2021/10/01,16:00:00,240.91,1358,7962,9320
2021/10/01,16:30:00,239.84,1125,8220,9345
2021/10/01,17:00:00,405.37,788,8535,9323
2021/10/01,17:30:00,408.17,428,8822,9250
2021/10/01,18:00:00,408.17,141,9002,9143
2021/10/01,18:30:00,410.91,144,9020,9164
2021/10/01,19:00:00,405.5,109,9121,9230
2021/10/01,19:30:00,408.17,68,9056,9124
2021/10/01,20:00:00,410.91,38,8914,8952
2021/10/01,20:30:00,408.17,38,8771,8809
2021/10/01,21:00:00,408.2,37,8640,8677
2021/10/01,21:30:00,327.57,38,8479,8517
2021/10/01,22:00:00,326.32,39,8319,8358
2021/10/01,22:30:00,239.24,37,8206,8243
2021/10/01,23:00:00,239.84,34,8053,8087
2021/10/01,23:30:00,240.26,34,7870,7904
2021/10/02,00:00:00,240.26,35,7682,7717
2021/10/02,00:30:00,240.26,37,7479,7516
2021/10/02,01:00:00,240.05,38,7298,7336
2021/10/02,01:30:00,239.04,37,7165,7202
2021/10/02,02:00:00,239.63,39,7048,7087
2021/10/02,02:30:00,240.26,37,6954,6991
2021/10/02,03:00:00,240.47,38,7035,7073
2021/10/02,03:30:00,240.47,38,6959,6997
2021/10/02,04:00:00,239.43,39,7059,7098
2021/10/02,04:30:00,240.05,37,7036,7073
2021/10/02,05:00:00,239.43,36,7007,7043
2021/10/02,05:30:00,240.47,36,7058,7094
2021/10/02,06:00:00,239.43,36,7073,7109
2021/10/02,06:30:00,239.63,30,6980,7010
2021/10/02,07:00:00,239.04,17,6880,6897
2021/10/02,07:30:00,240.05,141,6877,7018
2021/10/02,08:00:00,239.63,250,6844,7094
2021/10/02,08:30:00,239.63,432,6855,7287
2021/10/02,09:00:00,239.43,808,6816,7624
2021/10/02,09:30:00,239.43,912,6846,7758
2021/10/02,10:00:00,239.63,1031,6897,7928
2021/10/02,10:30:00,239.63,1077,7042,8119
2021/10/02,11:00:00,240.05,1157,7079,8236
2021/10/02,11:30:00,239.63,1164,7028,8192
2021/10/02,12:00:00,240.69,1435,7011,8446
2021/10/02,12:30:00,240.26,1443,7003,8446
2021/10/02,13:00:00,240.26,1519,6955,8474
2021/10/02,13:30:00,240.91,1708,6810,8518
2021/10/02,14:00:00,239.43,1551,6896,8447
2021/10/02,14:30:00,239.63,1639,6828,8467
2021/10/02,15:00:00,239.63,1460,6998,8458
2021/10/02,15:30:00,323.02,1340,7139,8479
2021/10/02,16:00:00,323.02,1229,7326,8555
2021/10/02,16:30:00,323.01,905,7599,8504
2021/10/02,17:00:00,375.76,741,7765,8506
2021/10/02,17:30:00,375.89,488,7979,8467
2021/10/02,18:00:00,326.93,212,8136,8348
2021/10/02,18:30:00,331.75,39,8466,8505
2021/10/02,19:00:00,384.03,43,8655,8698
2021/10/02,19:30:00,381.96,44,8709,8753
2021/10/02,20:00:00,335.04,42,8743,8785
2021/10/02,20:30:00,335.04,43,8676,8719
2021/10/02,21:00:00,334.4,42,8601,8643
2021/10/02,21:30:00,386.14,41,8583,8624
2021/10/02,22:00:00,329.96,41,8422,8463
2021/10/02,22:30:00,329.83,39,8229,8268
2021/10/02,23:00:00,312.32,36,8019,8055
2021/10/02,23:30:00,240.69,38,7731,7769
2021/10/03,00:00:00,240.26,38,7509,7547
2021/10/03,00:30:00,240.47,39,7259,7298
2021/10/03,01:00:00,240.26,37,7045,7082
2021/10/03,01:30:00,240.26,36,6863,6899
2021/10/03,02:00:00,240.26,36,7029,7065
2021/10/03,02:30:00,240.05,35,6935,6970
2021/10/03,03:00:00,240.26,35,6850,6885
2021/10/03,03:30:00,240.26,35,6766,6801
2021/10/03,04:00:00,240.47,35,6758,6793
2021/10/03,04:30:00,240.26,35,6796,6831
2021/10/03,05:00:00,240.05,34,6846,6880
2021/10/03,05:30:00,240.47,34,7012,7046
2021/10/03,06:00:00,240.69,33,7132,7165
2021/10/03,06:30:00,240.05,25,7309,7334
2021/10/03,07:00:00,240.91,16,7558,7574
2021/10/03,07:30:00,239.04,201,7688,7889
2021/10/03,08:00:00,310.44,489,7554,8043
2021/10/03,08:30:00,380.99,777,7706,8483
2021/10/03,09:00:00,321.08,985,7720,8705
2021/10/03,09:30:00,406.98,1252,7767,9019
2021/10/03,10:00:00,325.45,1348,7828,9176
2021/10/03,10:30:00,326.36,1318,7920,9238
2021/10/03,11:00:00,406.98,1240,8127,9367
2021/10/03,11:30:00,406.98,1373,7978,9351
2021/10/03,12:00:00,406.98,1452,7855,9307
2021/10/03,12:30:00,410.23,1457,7920,9377
2021/10/03,13:00:00,411.59,1534,7937,9471
2021/10/03,13:30:00,405.11,1518,8020,9538
2021/10/03,14:00:00,403.52,1665,8087,9752
2021/10/03,14:30:00,382.18,1683,8227,9910
2021/10/03,15:00:00,377.73,1577,8370,9947
2021/10/03,15:30:00,405.33,1396,8600,9996
2021/10/03,16:00:00,383.4,1218,8662,9880
2021/10/03,16:30:00,383.4,960,8818,9778
2021/10/03,17:00:00,383.4,695,9011,9706
2021/10/03,17:30:00,377.73,400,9104,9504
2021/10/03,18:00:00,383.4,258,9176,9434
2021/10/03,18:30:00,355.38,100,9339,9439
2021/10/03,19:00:00,344.84,101,9483,9584
2021/10/03,19:30:00,359.32,65,9435,9500
2021/10/03,20:00:00,353.96,18,9353,9371
2021/10/03,20:30:00,344.33,15,9245,9260
2021/10/03,21:00:00,335.92,12,9136,9148
2021/10/03,21:30:00,383.35,7,8947,8954
2021/10/03,22:00:00,383.32,7,8688,8695
2021/10/03,22:30:00,383.32,8,8489,8497
2021/10/03,23:00:00,315.16,2,8221,8223
2021/10/03,23:30:00,315.35,1,7935,7936
2021/10/04,00:00:00,306.93,1,7672,7673
2021/10/04,00:30:00,291.98,1,7401,7402
2021/10/04,01:00:00,291.98,1,7197,7198
2021/10/04,01:30:00,291.98,1,7041,7042
2021/10/04,02:00:00,289.97,1,7178,7179
2021/10/04,02:30:00,290.21,2,7045,7047
2021/10/04,03:00:00,289.97,3,6952,6955
2021/10/04,03:30:00,289.74,4,6881,6885
2021/10/04,04:00:00,289.97,3,6860,6863
2021/10/04,04:30:00,289.97,2,6865,6867
2021/10/04,05:00:00,289.97,1,6947,6948
2021/10/04,05:30:00,289.74,1,7080,7081
2021/10/04,06:00:00,290.7,1,7255,7256
2021/10/04,06:30:00,289.74,1,7405,7406
2021/10/04,07:00:00,290.45,2,7615,7617
2021/10/04,07:30:00,407.08,209,7828,8037
2021/10/04,08:00:00,410.33,468,7785,8253
2021/10/04,08:30:00,410.33,759,7803,8562
2021/10/04,09:00:00,410.33,1090,7796,8886
2021/10/04,09:30:00,411.69,1344,7786,9130
2021/10/04,10:00:00,411.69,1464,7778,9242
2021/10/04,10:30:00,411.69,1494,7834,9328
2021/10/04,11:00:00,411.69,1623,7685,9308
2021/10/04,11:30:00,411.69,1825,7595,9420
2021/10/04,12:00:00,411.69,1865,7511,9376
2021/10/04,12:30:00,411.69,1964,7503,9467
2021/10/04,13:00:00,411.69,2001,7462,9463
2021/10/04,13:30:00,405.24,1875,7653,9528
2021/10/04,14:00:00,405.24,1932,7781,9713
2021/10/04,14:30:00,405.33,1828,7944,9772
2021/10/04,15:00:00,405.33,1756,8118,9874
2021/10/04,15:30:00,384.13,1603,8210,9813
2021/10/04,16:00:00,386.16,1344,8381,9725
2021/10/04,16:30:00,384.13,1156,8554,9710
2021/10/04,17:00:00,384.13,840,8727,9567
2021/10/04,17:30:00,382.16,470,8924,9394
2021/10/04,18:00:00,349.78,287,9044,9331
2021/10/04,18:30:00,340.81,119,9228,9347
2021/10/04,19:00:00,340.81,120,9311,9431
2021/10/04,19:30:00,340.81,117,9295,9412
2021/10/04,20:00:00,351.77,116,9209,9325
2021/10/04,20:30:00,351.77,53,9142,9195
2021/10/04,21:00:00,350.59,5,8996,9001
2021/10/04,21:30:00,405.3,4,8847,8851
2021/10/04,22:00:00,331.03,5,8612,8617
2021/10/04,22:30:00,405.24,4,8385,8389
2021/10/04,23:00:00,392.09,3,8145,8148
2021/10/04,23:30:00,312.77,3,7838,7841
2021/10/05,00:00:00,374.2,3,7556,7559
2021/10/05,00:30:00,381.03,3,7333,7336
2021/10/05,01:00:00,310.67,3,7262,7265
2021/10/05,01:30:00,374.01,2,7077,7079
2021/10/05,02:00:00,291.2,2,6931,6933
2021/10/05,02:30:00,290.21,3,6965,6968
2021/10/05,03:00:00,290.21,2,6876,6878
2021/10/05,03:30:00,290.21,2,6839,6841
2021/10/05,04:00:00,290.45,2,6811,6813
2021/10/05,04:30:00,290.21,2,6846,6848
2021/10/05,05:00:00,290.45,2,6910,6912
2021/10/05,05:30:00,290.7,2,7053,7055
2021/10/05,06:00:00,290.45,2,7207,7209
2021/10/05,06:30:00,289.97,1,7438,7439
2021/10/05,07:00:00,290.21,2,7645,7647
2021/10/05,07:30:00,381.03,207,7851,8058
2021/10/05,08:00:00,374.02,456,7767,8223
2021/10/05,08:30:00,407.18,746,7878,8624
2021/10/05,09:00:00,376.6,1056,7796,8852
2021/10/05,09:30:00,407.18,1419,7715,9134
2021/10/05,10:00:00,411.8,1605,7623,9228
2021/10/05,10:30:00,404.04,1613,7510,9123
2021/10/05,11:00:00,400.96,1713,7508,9221
2021/10/05,11:30:00,404.04,1623,7414,9037
2021/10/05,12:00:00,404.04,1710,7384,9094
2021/10/05,12:30:00,400.96,1774,7397,9171
2021/10/05,13:00:00,401.54,1829,7574,9403
2021/10/05,13:30:00,405.31,1864,7614,9478
2021/10/05,14:00:00,405.31,1835,7744,9579
2021/10/05,14:30:00,411.8,1834,7884,9718
2021/10/05,15:00:00,408.01,1711,8065,9776
2021/10/05,15:30:00,405.4,1538,8109,9647
2021/10/05,16:00:00,405.4,1390,8239,9629
2021/10/05,16:30:00,408.01,1165,8407,9572
2021/10/05,17:00:00,408.01,787,8554,9341
2021/10/05,17:30:00,408.01,459,8756,9215
2021/10/05,18:00:00,408.04,287,8824,9111
2021/10/05,18:30:00,405.47,146,9010,9156
2021/10/05,19:00:00,373.17,152,9124,9276
2021/10/05,19:30:00,373.17,153,9069,9222
2021/10/05,20:00:00,410.69,149,8916,9065
2021/10/05,20:30:00,408.04,90,8856,8946
2021/10/05,21:00:00,405.47,41,8759,8800
2021/10/05,21:30:00,407.99,40,8558,8598
2021/10/05,22:00:00,405.31,40,8384,8424
2021/10/05,22:30:00,410.66,39,8198,8237
2021/10/05,23:00:00,404.29,35,7949,7984
2021/10/05,23:30:00,290.95,34,7613,7647
2021/10/06,00:00:00,291.2,33,7365,7398
2021/10/06,00:30:00,291.72,34,7121,7155
2021/10/06,01:00:00,291.2,33,7056,7089
2021/10/06,01:30:00,292.25,33,7016,7049
2021/10/06,02:00:00,289.97,33,6897,6930
2021/10/06,02:30:00,290.95,33,6800,6833
2021/10/06,03:00:00,291.46,32,6732,6764
2021/10/06,03:30:00,291.72,33,6683,6716
2021/10/06,04:00:00,290.95,32,6633,6665
2021/10/06,04:30:00,290.95,32,6653,6685
2021/10/06,05:00:00,291.72,33,6771,6804
2021/10/06,05:30:00,290.45,33,6906,6939
2021/10/06,06:00:00,289.74,32,7084,7116
2021/10/06,06:30:00,291.2,30,7294,7324
2021/10/06,07:00:00,291.2,27,7503,7530
2021/10/06,07:30:00,290.95,191,7663,7854
2021/10/06,08:00:00,291.72,370,7652,8022
2021/10/06,08:30:00,290.7,642,7665,8307
2021/10/06,09:00:00,290.95,943,7683,8626
2021/10/06,09:30:00,290.45,1171,7655,8826
2021/10/06,10:00:00,291.2,1242,7687,8929
2021/10/06,10:30:00,290.45,1422,7408,8830
2021/10/06,11:00:00,290.7,1703,7324,9027
2021/10/06,11:30:00,290.95,1947,7130,9077
2021/10/06,12:00:00,285.69,1996,7014,9010
2021/10/06,12:30:00,281.13,2048,7114,9162
2021/10/06,13:00:00,281.09,2041,7236,9277
2021/10/06,13:30:00,281.14,2008,7387,9395
2021/10/06,14:00:00,281.08,1948,7536,9484
2021/10/06,14:30:00,281.09,1882,7684,9566
2021/10/06,15:00:00,281.09,1777,7780,9557
2021/10/06,15:30:00,377.52,1604,7973,9577
2021/10/06,16:00:00,370.07,1444,8098,9542
2021/10/06,16:30:00,407.83,1232,8212,9444
2021/10/06,17:00:00,410.5,839,8446,9285
2021/10/06,17:30:00,407.83,517,8643,9160
2021/10/06,18:00:00,407.87,303,8751,9054
2021/10/06,18:30:00,380.25,152,8957,9109
2021/10/06,19:00:00,380.25,155,9013,9168
2021/10/06,19:30:00,376.6,158,8950,9108
2021/10/06,20:00:00,370.64,156,8804,8960
2021/10/06,20:30:00,411.61,151,8698,8849
2021/10/06,21:00:00,370.64,152,8539,8691
2021/10/06,21:30:00,386.14,149,8371,8520
2021/10/06,22:00:00,386.22,148,8135,8283
2021/10/06,22:30:00,386.22,95,7983,8078
2021/10/06,23:00:00,386.15,31,7792,7823
2021/10/06,23:30:00,281.73,31,7497,7528
2021/10/07,00:00:00,281.65,31,7254,7285
2021/10/07,00:30:00,281.75,31,7033,7064
2021/10/07,01:00:00,281.78,31,6806,6837
2021/10/07,01:30:00,280.96,31,6651,6682
2021/10/07,02:00:00,281.74,31,6538,6569
2021/10/07,02:30:00,285.69,32,6569,6601
2021/10/07,03:00:00,291.98,31,6503,6534
2021/10/07,03:30:00,290.21,31,6586,6617
2021/10/07,04:00:00,289.74,31,6565,6596
2021/10/07,04:30:00,289.74,31,6604,6635
2021/10/07,05:00:00,283.79,31,6644,6675
2021/10/07,05:30:00,281.79,30,6801,6831
2021/10/07,06:00:00,280.95,29,6939,6968
2021/10/07,06:30:00,281.06,22,7136,7158
2021/10/07,07:00:00,281.08,15,7334,7349
2021/10/07,07:30:00,312.26,253,7493,7746
2021/10/07,08:00:00,310.21,553,7358,7911
2021/10/07,08:30:00,411.42,943,7326,8269
2021/10/07,09:00:00,411.42,1375,7175,8550
2021/10/07,09:30:00,307.76,1569,7153,8722
2021/10/07,10:00:00,357.93,1707,7154,8861
2021/10/07,10:30:00,376.91,1850,7001,8851
2021/10/07,11:00:00,288.85,1941,7007,8948
2021/10/07,11:30:00,290.21,1992,7058,9050
2021/10/07,12:00:00,290.95,2019,6977,8996
2021/10/07,12:30:00,290.45,2025,7093,9118
2021/10/07,13:00:00,290.45,2020,7262,9282
2021/10/07,13:30:00,291.2,1992,7407,9399
2021/10/07,14:00:00,291.2,1926,7593,9519
2021/10/07,14:30:00,290.45,1856,7804,9660
2021/10/07,15:00:00,290.95,1736,7910,9646
2021/10/07,15:30:00,407.07,1554,8073,9627
2021/10/07,16:00:00,407.28,1385,8271,9656
2021/10/07,16:30:00,410.21,1114,8413,9527
2021/10/07,17:00:00,406.56,739,8579,9318
2021/10/07,17:30:00,384.13,454,8818,9272
2021/10/07,18:00:00,347.03,277,8953,9230
2021/10/07,18:30:00,359.03,143,9170,9313
2021/10/07,19:00:00,352.69,148,9173,9321
2021/10/07,19:30:00,358.84,148,9117,9265
2021/10/07,20:00:00,358.78,148,8952,9100
2021/10/07,20:30:00,411.42,147,8831,8978
2021/10/07,21:00:00,375.57,144,8647,8791
2021/10/07,21:30:00,379.01,81,8542,8623
2021/10/07,22:00:00,378.97,33,8393,8426
2021/10/07,22:30:00,378.97,32,8204,8236
2021/10/07,23:00:00,378.75,32,7994,8026
2021/10/07,23:30:00,320.04,32,7737,7769
2021/10/08,00:00:00,335.98,33,7511,7544
2021/10/08,00:30:00,334.98,32,7253,7285
2021/10/08,01:00:00,334.97,32,7082,7114
2021/10/08,01:30:00,334.97,32,6890,6922
2021/10/08,02:00:00,344.89,31,6872,6903
2021/10/08,02:30:00,344.74,31,6903,6934
2021/10/08,03:00:00,376.42,31,6808,6839
2021/10/08,03:30:00,359.31,32,6717,6749
2021/10/08,04:00:00,344.14,35,6700,6735
2021/10/08,04:30:00,343.99,34,6673,6707
2021/10/08,05:00:00,343.99,33,6704,6737
2021/10/08,05:30:00,378.58,36,6803,6839
2021/10/08,06:00:00,290.95,38,6821,6859
2021/10/08,06:30:00,290.7,29,6883,6912
2021/10/08,07:00:00,291.46,25,6857,6882
2021/10/08,07:30:00,290.7,213,6964,7177
2021/10/08,08:00:00,290.95,428,6931,7359
2021/10/08,08:30:00,291.2,729,6932,7661
2021/10/08,09:00:00,288.63,1046,6885,7931
2021/10/08,09:30:00,285.53,1208,6936,8144
2021/10/08,10:00:00,285.53,1384,6926,8310
2021/10/08,10:30:00,285.08,1607,6885,8492
2021/10/08,11:00:00,285.53,1828,6752,8580
2021/10/08,11:30:00,284.94,1898,6881,8779
2021/10/08,12:00:00,280.95,1973,6853,8826
2021/10/08,12:30:00,280.95,1982,6799,8781
2021/10/08,13:00:00,280.95,1981,6781,8762
2021/10/08,13:30:00,281.69,1947,6943,8890
2021/10/08,14:00:00,281.69,1879,7057,8936
2021/10/08,14:30:00,281.9,1792,7227,9019
2021/10/08,15:00:00,281.88,1652,7382,9034
2021/10/08,15:30:00,281.92,1455,7532,8987
2021/10/08,16:00:00,281.84,1310,7747,9057
2021/10/08,16:30:00,281.8,1045,7982,9027
2021/10/08,17:00:00,407.89,678,8317,8995
2021/10/08,17:30:00,407.89,417,8667,9084
2021/10/08,18:00:00,405.38,132,8760,8892
2021/10/08,18:30:00,332.69,148,8877,9025
2021/10/08,19:00:00,332.69,151,8861,9012
2021/10/08,19:30:00,405.41,146,8707,8853
2021/10/08,20:00:00,380.78,73,8603,8676
2021/10/08,20:30:00,341.13,34,8494,8528
2021/10/08,21:00:00,352.15,35,8306,8341
2021/10/08,21:30:00,350.8,35,8176,8211
2021/10/08,22:00:00,354.76,35,8029,8064
2021/10/08,22:30:00,386.22,34,7892,7926
2021/10/08,23:00:00,330.47,36,7745,7781
2021/10/08,23:30:00,328.45,37,7525,7562
2021/10/09,00:00:00,375.1,36,7341,7377
2021/10/09,00:30:00,281.86,35,7153,7188
2021/10/09,01:00:00,281.8,36,6979,7015
2021/10/09,01:30:00,281.87,37,7017,7054
2021/10/09,02:00:00,281.86,35,7006,7041
2021/10/09,02:30:00,281.08,36,6920,6956
2021/10/09,03:00:00,281.5,35,6859,6894
2021/10/09,03:30:00,281.63,34,6781,6815
2021/10/09,04:00:00,284.4,34,6730,6764
2021/10/09,04:30:00,291.72,34,6708,6742
2021/10/09,05:00:00,291.2,33,6716,6749
2021/10/09,05:30:00,289.74,33,6742,6775
2021/10/09,06:00:00,289.28,32,6757,6789
2021/10/09,06:30:00,289.28,31,6714,6745
2021/10/09,07:00:00,290.95,25,6588,6613
2021/10/09,07:30:00,291.46,178,6571,6749
2021/10/09,08:00:00,290.95,361,6512,6873
2021/10/09,08:30:00,291.2,646,6453,7099
2021/10/09,09:00:00,290.7,899,6395,7294
2021/10/09,09:30:00,291.72,1124,6341,7465
2021/10/09,10:00:00,291.2,1371,6389,7760
2021/10/09,10:30:00,291.72,1568,6185,7753
2021/10/09,11:00:00,290.7,1724,5984,7708
2021/10/09,11:30:00,290.45,1891,5985,7876
2021/10/09,12:00:00,291.46,1944,6104,8048
2021/10/09,12:30:00,290.45,1980,6219,8199
2021/10/09,13:00:00,289.28,1970,6303,8273
2021/10/09,13:30:00,291.46,1937,6422,8359
2021/10/09,14:00:00,290.7,1850,6566,8416
2021/10/09,14:30:00,291.46,1774,6737,8511
2021/10/09,15:00:00,291.72,1644,6875,8519
2021/10/09,15:30:00,290.95,1421,7089,8510
2021/10/09,16:00:00,290.45,1307,7316,8623
2021/10/09,16:30:00,290.95,1048,7545,8593
2021/10/09,17:00:00,408.28,679,7825,8504
2021/10/09,17:30:00,380.23,405,8037,8442
2021/10/09,18:00:00,348.93,75,8260,8335
2021/10/09,18:30:00,348.84,59,8560,8619
2021/10/09,19:00:00,374.78,42,8686,8728
2021/10/09,19:30:00,374.77,42,8761,8803
2021/10/09,20:00:00,374.76,41,8764,8805
2021/10/09,20:30:00,386.22,40,8707,8747
2021/10/09,21:00:00,337.66,40,8599,8639
2021/10/09,21:30:00,337.55,40,8529,8569
2021/10/09,22:00:00,331.92,41,8355,8396
2021/10/09,22:30:00,331.92,41,8192,8233
2021/10/09,23:00:00,324.57,36,7955,7991
2021/10/09,23:30:00,322.74,37,7686,7723
2021/10/10,00:00:00,379.03,36,7397,7433
2021/10/10,00:30:00,291.46,35,7188,7223
2021/10/10,01:00:00,289.28,35,6946,6981
2021/10/10,01:30:00,290.7,35,6753,6788
2021/10/10,02:00:00,291.98,39,6748,6787
2021/10/10,02:30:00,290.7,38,6810,6848
2021/10/10,03:00:00,290.95,35,6715,6750
2021/10/10,03:30:00,291.46,38,6632,6670
2021/10/10,04:00:00,290.95,37,6623,6660
2021/10/10,04:30:00,290.7,37,6634,6671
2021/10/10,05:00:00,290.95,37,6722,6759
2021/10/10,05:30:00,291.2,34,6904,6938
2021/10/10,06:00:00,291.2,33,7026,7059
2021/10/10,06:30:00,290.7,28,7259,7287
2021/10/10,07:00:00,290.7,12,7491,7503
2021/10/10,07:30:00,290.7,179,7726,7905
2021/10/10,08:00:00,291.2,427,7719,8146
2021/10/10,08:30:00,407.45,777,7787,8564
2021/10/10,09:00:00,410.71,1155,7676,8831
2021/10/10,09:30:00,404.28,1408,7631,9039
2021/10/10,10:00:00,404.28,1645,7607,9252
2021/10/10,10:30:00,401.19,1808,7504,9312
2021/10/10,11:00:00,404.31,1884,7525,9409
2021/10/10,11:30:00,404.31,1943,7459,9402
2021/10/10,12:00:00,404.31,1991,7520,9511
2021/10/10,12:30:00,404.31,2002,7644,9646
2021/10/10,13:00:00,404.31,1997,7807,9804
2021/10/10,13:30:00,404.31,1970,7997,9967
2021/10/10,14:00:00,401.59,1925,8194,10119
2021/10/10,14:30:00,404.56,1848,8408,10256
2021/10/10,15:00:00,401.59,1710,8486,10196
2021/10/10,15:30:00,404.72,1556,8639,10195
2021/10/10,16:00:00,410.58,1377,8747,10124
2021/10/10,16:30:00,342.06,1069,8919,9988
2021/10/10,17:00:00,337.47,762,9027,9789
2021/10/10,17:30:00,338.91,470,9175,9645
2021/10/10,18:00:00,340.66,301,9220,9521
2021/10/10,18:30:00,340.76,151,9437,9588
2021/10/10,19:00:00,340.76,152,9423,9575
2021/10/10,19:30:00,373.07,153,9350,9503
2021/10/10,20:00:00,355.82,151,9189,9340
2021/10/10,20:30:00,410.69,151,9023,9174
2021/10/10,21:00:00,291.46,147,8887,9034
2021/10/10,21:30:00,291.72,146,8691,8837
2021/10/10,22:00:00,291.2,115,8488,8603
2021/10/10,22:30:00,291.72,33,8323,8356
2021/10/10,23:00:00,291.72,33,8008,8041
2021/10/10,23:30:00,291.72,33,7718,7751
2021/10/11,00:00:00,291.98,33,7433,7466
2021/10/11,00:30:00,291.72,32,7138,7170
2021/10/11,01:00:00,291.46,32,6919,6951
2021/10/11,01:30:00,291.46,32,6764,6796
2021/10/11,02:00:00,292.25,32,6796,6828
2021/10/11,02:30:00,291.46,32,6828,6860
2021/10/11,03:00:00,291.72,31,6721,6752
2021/10/11,03:30:00,291.98,33,6649,6682
2021/10/11,04:00:00,291.98,33,6639,6672
2021/10/11,04:30:00,291.98,33,6651,6684
2021/10/11,05:00:00,291.46,32,6745,6777
2021/10/11,05:30:00,291.46,31,6900,6931
2021/10/11,06:00:00,291.2,29,7102,7131
2021/10/11,06:30:00,291.72,23,7293,7316
2021/10/11,07:00:00,291.72,15,7491,7506
2021/10/11,07:30:00,290.7,179,7620,7799
2021/10/11,08:00:00,291.2,395,7570,7965
2021/10/11,08:30:00,290.95,757,7603,8360
2021/10/11,09:00:00,286.51,1120,7487,8607
2021/10/11,09:30:00,289.51,1350,7434,8784
2021/10/11,10:00:00,290.45,1675,7389,9064
2021/10/11,10:30:00,291.72,1800,7266,9066
2021/10/11,11:00:00,291.2,1849,7299,9148
2021/10/11,11:30:00,291.46,1947,7241,9188
2021/10/11,12:00:00,291.2,1968,7312,9280
2021/10/11,12:30:00,291.98,1958,7422,9380
2021/10/11,13:00:00,288.85,1966,7562,9528
2021/10/11,13:30:00,290.95,1870,7742,9612
2021/10/11,14:00:00,289.74,1805,7921,9726
2021/10/11,14:30:00,291.46,1792,8107,9899
2021/10/11,15:00:00,290.21,1636,8291,9927
2021/10/11,15:30:00,291.46,1514,8432,9946
2021/10/11,16:00:00,289.51,1351,8474,9825
2021/10/11,16:30:00,290.95,1012,8670,9682
2021/10/11,17:00:00,290.45,721,8823,9544
2021/10/11,17:30:00,290.95,442,8982,9424
2021/10/11,18:00:00,289.97,131,9011,9142
2021/10/11,18:30:00,290.95,143,9232,9375
2021/10/11,19:00:00,289.74,145,9250,9395
2021/10/11,19:30:00,290.95,142,9167,9309
2021/10/11,20:00:00,290.21,142,9071,9213
2021/10/11,20:30:00,291.46,34,9032,9066
2021/10/11,21:00:00,290.21,34,8858,8892
2021/10/11,21:30:00,290.95,34,8736,8770
2021/10/11,22:00:00,289.51,35,8524,8559
2021/10/11,22:30:00,290.7,33,8299,8332
2021/10/11,23:00:00,289.97,33,8000,8033
2021/10/11,23:30:00,291.72,33,7711,7744
2021/10/12,00:00:00,290.45,33,7432,7465
2021/10/12,00:30:00,289.74,32,7240,7272
2021/10/12,01:00:00,289.74,32,7039,7071
2021/10/12,01:30:00,291.46,31,6854,6885
2021/10/12,02:00:00,291.2,32,6877,6909
2021/10/12,02:30:00,290.45,34,6952,6986
2021/10/12,03:00:00,290.95,32,6841,6873
2021/10/12,03:30:00,290.45,32,6823,6855
2021/10/12,04:00:00,289.74,32,6839,6871
2021/10/12,04:30:00,290.21,32,6872,6904
2021/10/12,05:00:00,290.45,32,6941,6973
2021/10/12,05:30:00,290.21,38,7113,7151
2021/10/12,06:00:00,290.45,43,7336,7379
2021/10/12,06:30:00,290.7,30,7510,7540
2021/10/12,07:00:00,291.46,33,7737,7770
2021/10/12,07:30:00,290.7,157,8061,8218
2021/10/12,08:00:00,291.2,288,8124,8412
2021/10/12,08:30:00,289.51,564,8179,8743
2021/10/12,09:00:00,290.95,622,8170,8792
2021/10/12,09:30:00,289.51,822,8158,8980
2021/10/12,10:00:00,291.46,947,8140,9087
2021/10/12,10:30:00,290.45,1018,8321,9339
2021/10/12,11:00:00,291.72,1305,8108,9413
2021/10/12,11:30:00,289.97,1677,7997,9674
2021/10/12,12:00:00,290.95,1425,7999,9424
2021/10/12,12:30:00,289.97,1339,8247,9586
2021/10/12,13:00:00,290.45,1153,8336,9489
2021/10/12,13:30:00,386.14,1208,8280,9488
2021/10/12,14:00:00,378.94,1232,8342,9574
2021/10/12,14:30:00,383.68,1247,8451,9698
2021/10/12,15:00:00,383.68,1316,8541,9857
2021/10/12,15:30:00,386.15,1082,8752,9834
2021/10/12,16:00:00,383.89,883,8850,9733
2021/10/12,16:30:00,383.92,641,8963,9604
2021/10/12,17:00:00,363.7,608,8993,9601
2021/10/12,17:30:00,364.97,370,9111,9481
2021/10/12,18:00:00,351.46,35,9293,9328
2021/10/12,18:30:00,349.09,34,9547,9581
2021/10/12,19:00:00,349.08,35,9567,9602
2021/10/12,19:30:00,345.14,34,9545,9579
2021/10/12,20:00:00,349.07,35,9399,9434
2021/10/12,20:30:00,349.06,36,9217,9253
2021/10/12,21:00:00,343.98,30,9032,9062
2021/10/12,21:30:00,338.25,41,8849,8890
2021/10/12,22:00:00,348.81,36,8628,8664
2021/10/12,22:30:00,386.22,33,8434,8467
2021/10/12,23:00:00,386.22,34,8148,8182
2021/10/12,23:30:00,291.72,33,7833,7866
2021/10/13,00:00:00,285.91,36,7565,7601
2021/10/13,00:30:00,286.22,37,7226,7263
2021/10/13,01:00:00,286.54,36,7050,7086
2021/10/13,01:30:00,285.91,34,6849,6883
2021/10/13,02:00:00,286.22,33,6876,6909
2021/10/13,02:30:00,286.54,32,6924,6956
2021/10/13,03:00:00,286.22,34,6871,6905
2021/10/13,03:30:00,286.22,32,6800,6832
2021/10/13,04:00:00,286.54,33,6802,6835
2021/10/13,04:30:00,288.01,33,6803,6836
2021/10/13,05:00:00,287.81,32,6933,6965
2021/10/13,05:30:00,288.21,32,7072,7104
2021/10/13,06:00:00,288.21,32,7240,7272
2021/10/13,06:30:00,287.61,28,7532,7560
2021/10/13,07:00:00,288.01,18,7753,7771
2021/10/13,07:30:00,288.01,129,7972,8101
2021/10/13,08:00:00,404,242,8010,8252
2021/10/13,08:30:00,404,412,8240,8652
2021/10/13,09:00:00,404,555,8247,8802
2021/10/13,09:30:00,404.03,694,8337,9031
2021/10/13,10:00:00,383.4,944,8247,9191
2021/10/13,10:30:00,386.14,1309,8077,9386
2021/10/13,11:00:00,386.22,1443,8101,9544
2021/10/13,11:30:00,290.21,1693,8041,9734
2021/10/13,12:00:00,290.45,1648,8004,9652
2021/10/13,12:30:00,379.1,1613,8024,9637
2021/10/13,13:00:00,379.08,1772,7944,9716
2021/10/13,13:30:00,376.45,1740,8115,9855
2021/10/13,14:00:00,374.53,1643,8210,9853
2021/10/13,14:30:00,401.31,1559,8429,9988
2021/10/13,15:00:00,404.29,1464,8578,10042
2021/10/13,15:30:00,404.45,1350,8692,10042
2021/10/13,16:00:00,386.22,1118,8757,9875
2021/10/13,16:30:00,383.92,816,8908,9724
2021/10/13,17:00:00,381.83,599,8968,9567
2021/10/13,17:30:00,382.01,349,9096,9445
2021/10/13,18:00:00,386.22,116,9131,9247
2021/10/13,18:30:00,386.22,114,9380,9494
2021/10/13,19:00:00,408.04,114,9392,9506
2021/10/13,19:30:00,408.04,111,9311,9422
2021/10/13,20:00:00,384.19,109,9169,9278
2021/10/13,20:30:00,386.19,39,9118,9157
2021/10/13,21:00:00,386.19,2,8977,8979
2021/10/13,21:30:00,386.22,2,8775,8777
2021/10/13,22:00:00,291.2,2,8603,8605
2021/10/13,22:30:00,386.22,2,8433,8435
2021/10/13,23:00:00,326.72,2,8155,8157
2021/10/13,23:30:00,386.22,1,7876,7877
2021/10/14,00:00:00,291.72,1,7585,7586
2021/10/14,00:30:00,291.72,2,7316,7318
2021/10/14,01:00:00,291.2,2,7222,7224
2021/10/14,01:30:00,291.2,1,7204,7205
2021/10/14,02:00:00,290.95,1,7121,7122
2021/10/14,02:30:00,291.46,1,7029,7030
2021/10/14,03:00:00,291.72,0,6948,6948
2021/10/14,03:30:00,290.45,0,6879,6879
2021/10/14,04:00:00,290.7,0,6843,6843
2021/10/14,04:30:00,290.21,0,6884,6884
2021/10/14,05:00:00,290.45,0,6939,6939
2021/10/14,05:30:00,290.21,0,7140,7140
2021/10/14,06:00:00,290.95,0,7276,7276
2021/10/14,06:30:00,290.45,0,7506,7506
2021/10/14,07:00:00,290.95,0,7629,7629
2021/10/14,07:30:00,290.45,112,7897,8009
2021/10/14,08:00:00,290.21,350,7895,8245
2021/10/14,08:30:00,290.45,622,7994,8616
2021/10/14,09:00:00,290.21,902,7945,8847
2021/10/14,09:30:00,290.7,1239,7854,9093
2021/10/14,10:00:00,291.2,1495,7814,9309
2021/10/14,10:30:00,290.21,1634,7871,9505
2021/10/14,11:00:00,290.21,1762,7698,9460
2021/10/14,11:30:00,290.21,1690,7723,9413
2021/10/14,12:00:00,290.21,1775,7784,9559
2021/10/14,12:30:00,290.45,1848,7831,9679
2021/10/14,13:00:00,290.45,1759,8011,9770
2021/10/14,13:30:00,290.21,1779,8059,9838
2021/10/14,14:00:00,290.95,1787,8154,9941
2021/10/14,14:30:00,290.7,1660,8332,9992
2021/10/14,15:00:00,290.7,1403,8542,9945
2021/10/14,15:30:00,290.21,1252,8691,9943
2021/10/14,16:00:00,290.95,1012,8729,9741
2021/10/14,16:30:00,290.7,662,8918,9580
2021/10/14,17:00:00,289.97,504,8950,9454
2021/10/14,17:30:00,290.21,361,8977,9338
2021/10/14,18:00:00,290.7,146,9040,9186
2021/10/14,18:30:00,290.45,116,9367,9483
2021/10/14,19:00:00,290.21,40,9400,9440
2021/10/14,19:30:00,290.45,40,9327,9367
2021/10/14,20:00:00,290.7,33,9175,9208
2021/10/14,20:30:00,290.21,32,9019,9051
2021/10/14,21:00:00,290.21,32,8888,8920
2021/10/14,21:30:00,289.28,32,8733,8765
2021/10/14,22:00:00,290.45,33,8552,8585
2021/10/14,22:30:00,290.21,33,8394,8427
2021/10/14,23:00:00,290.7,33,8132,8165
2021/10/14,23:30:00,290.7,33,7915,7948
2021/10/15,00:00:00,291.2,34,7647,7681
2021/10/15,00:30:00,291.46,35,7422,7457
2021/10/15,01:00:00,288.85,35,7357,7392
2021/10/15,01:30:00,291.46,34,7182,7216
2021/10/15,02:00:00,290.45,34,7178,7212
2021/10/15,02:30:00,291.72,34,7046,7080
2021/10/15,03:00:00,291.46,36,6933,6969
2021/10/15,03:30:00,291.72,36,6854,6890
2021/10/15,04:00:00,291.2,36,6844,6880
2021/10/15,04:30:00,291.72,34,6827,6861
2021/10/15,05:00:00,291.2,34,6887,6921
2021/10/15,05:30:00,291.46,32,7001,7033
2021/10/15,06:00:00,291.72,31,7024,7055
2021/10/15,06:30:00,291.46,25,7155,7180
2021/10/15,07:00:00,289.74,20,7101,7121
2021/10/15,07:30:00,289.74,141,7296,7437
2021/10/15,08:00:00,290.95,341,7236,7577
2021/10/15,08:30:00,290.95,655,7237,7892
2021/10/15,09:00:00,290.95,935,7179,8114
2021/10/15,09:30:00,289.74,1205,7191,8396
2021/10/15,10:00:00,289.28,1450,6999,8449
2021/10/15,10:30:00,290.95,1616,6948,8564
2021/10/15,11:00:00,290.7,1768,6957,8725
2021/10/15,11:30:00,291.2,1850,6825,8675
2021/10/15,12:00:00,290.45,1866,6885,8751
2021/10/15,12:30:00,290.7,1889,6940,8829
2021/10/15,13:00:00,290.95,1833,7000,8833
2021/10/15,13:30:00,290.45,1844,7067,8911
2021/10/15,14:00:00,289.28,1775,7157,8932
2021/10/15,14:30:00,290.7,1688,7215,8903
2021/10/15,15:00:00,290.7,1569,7280,8849
2021/10/15,15:30:00,291.46,1449,7407,8856
2021/10/15,16:00:00,290.45,1206,7611,8817
2021/10/15,16:30:00,290.21,924,7886,8810
2021/10/15,17:00:00,289.97,644,8242,8886
2021/10/15,17:30:00,410.27,347,8563,8910
2021/10/15,18:00:00,407.62,79,8621,8700
2021/10/15,18:30:00,405.01,37,8828,8865
2021/10/15,19:00:00,410.3,39,8771,8810
2021/10/15,19:30:00,410.3,39,8579,8618
2021/10/15,20:00:00,405.01,39,8412,8451
2021/10/15,20:30:00,404.82,35,8268,8303
2021/10/15,21:00:00,290.45,37,8132,8169
2021/10/15,21:30:00,290.7,38,7968,8006
2021/10/15,22:00:00,290.21,42,7829,7871
2021/10/15,22:30:00,290.45,43,7698,7741
2021/10/15,23:00:00,290.45,44,7532,7576
2021/10/15,23:30:00,290.45,44,7375,7419
2021/10/16,00:00:00,291.2,44,7188,7232
2021/10/16,00:30:00,289.74,44,7000,7044
2021/10/16,01:00:00,290.21,44,6813,6857
2021/10/16,01:30:00,289.97,43,6856,6899
2021/10/16,02:00:00,290.45,38,6866,6904
2021/10/16,02:30:00,290.21,37,6766,6803
2021/10/16,03:00:00,290.21,35,6685,6720
2021/10/16,03:30:00,290.21,34,6622,6656
2021/10/16,04:00:00,289.97,34,6583,6617
2021/10/16,04:30:00,290.45,32,6592,6624
2021/10/16,05:00:00,290.45,32,6611,6643
2021/10/16,05:30:00,290.21,31,6673,6704
2021/10/16,06:00:00,290.45,34,6695,6729
2021/10/16,06:30:00,291.2,22,6641,6663
2021/10/16,07:00:00,290.7,18,6574,6592
2021/10/16,07:30:00,290.95,144,6595,6739
2021/10/16,08:00:00,289.74,253,6534,6787
2021/10/16,08:30:00,290.7,481,6339,6820
2021/10/16,09:00:00,291.2,774,6254,7028
2021/10/16,09:30:00,290.95,937,6326,7263
2021/10/16,10:00:00,291.2,1145,6185,7330
2021/10/16,10:30:00,289.51,1352,6171,7523
2021/10/16,11:00:00,290.21,1314,6218,7532
2021/10/16,11:30:00,289.97,1454,6129,7583
2021/10/16,12:00:00,287.61,1778,5993,7771
2021/10/16,12:30:00,290.45,1600,6218,7818
2021/10/16,13:00:00,288.85,1396,6386,7782
2021/10/16,13:30:00,290.45,1294,6352,7646
2021/10/16,14:00:00,291.2,1330,6233,7563
2021/10/16,14:30:00,290.7,1204,6389,7593
2021/10/16,15:00:00,289.51,1377,6369,7746
2021/10/16,15:30:00,290.95,1271,6549,7820
2021/10/16,16:00:00,289.74,1142,6652,7794
2021/10/16,16:30:00,290.21,773,7139,7912
2021/10/16,17:00:00,289.74,659,7325,7984
2021/10/16,17:30:00,290.7,281,7599,7880
2021/10/16,18:00:00,290.21,76,7789,7865
2021/10/16,18:30:00,290.7,60,8154,8214
2021/10/16,19:00:00,290.7,37,8264,8301
2021/10/16,19:30:00,290.7,40,8331,8371
2021/10/16,20:00:00,290.7,41,8322,8363
2021/10/16,20:30:00,291.46,37,8248,8285
2021/10/16,21:00:00,290.95,39,8163,8202
2021/10/16,21:30:00,290.95,37,8105,8142
2021/10/16,22:00:00,291.2,36,7899,7935
2021/10/16,22:30:00,290.45,34,7721,7755
2021/10/16,23:00:00,290.45,32,7481,7513
2021/10/16,23:30:00,290.45,32,7222,7254
2021/10/17,00:00:00,289.74,32,7000,7032
2021/10/17,00:30:00,290.7,32,6752,6784
2021/10/17,01:00:00,289.51,32,6841,6873
2021/10/17,01:30:00,290.95,32,6650,6682
2021/10/17,02:00:00,289.97,32,6511,6543
2021/10/17,02:30:00,290.45,33,6422,6455
2021/10/17,03:00:00,290.45,34,6307,6341
2021/10/17,03:30:00,290.21,35,6310,6345
2021/10/17,04:00:00,290.45,37,6303,6340
2021/10/17,04:30:00,290.21,34,6333,6367
2021/10/17,05:00:00,290.7,35,6426,6461
2021/10/17,05:30:00,289.74,33,6633,6666
2021/10/17,06:00:00,290.21,33,6788,6821
2021/10/17,06:30:00,289.97,23,7098,7121
2021/10/17,07:00:00,289.74,21,7134,7155
2021/10/17,07:30:00,290.21,145,7389,7534
2021/10/17,08:00:00,290.45,371,7409,7780
2021/10/17,08:30:00,290.21,564,7508,8072
2021/10/17,09:00:00,289.51,853,7351,8204
2021/10/17,09:30:00,290.7,790,7656,8446
2021/10/17,10:00:00,290.21,1144,7497,8641
2021/10/17,10:30:00,290.7,1200,7473,8673
2021/10/17,11:00:00,290.21,1318,7358,8676
2021/10/17,11:30:00,290.45,1437,7360,8797
2021/10/17,12:00:00,290.95,1457,7329,8786
2021/10/17,12:30:00,290.21,1602,7312,8914
2021/10/17,13:00:00,291.46,1585,7329,8914
2021/10/17,13:30:00,290.21,1641,7364,9005
2021/10/17,14:00:00,290.21,1489,7500,8989
2021/10/17,14:30:00,290.45,1445,7691,9136
2021/10/17,15:00:00,288.63,1404,7741,9145
2021/10/17,15:30:00,290.7,1259,7830,9089
2021/10/17,16:00:00,290.45,1141,7902,9043
2021/10/17,16:30:00,410.04,981,8058,9039
2021/10/17,17:00:00,328.64,607,8195,8802
2021/10/17,17:30:00,335.6,371,8377,8748
2021/10/17,18:00:00,406.79,114,8501,8615
2021/10/17,18:30:00,336.59,116,8868,8984
2021/10/17,19:00:00,336.71,119,8842,8961
2021/10/17,19:30:00,410.13,118,8815,8933
2021/10/17,20:00:00,410.13,117,8697,8814
2021/10/17,20:30:00,333.91,116,8530,8646
2021/10/17,21:00:00,333.78,68,8457,8525
2021/10/17,21:30:00,381.98,44,8354,8398
2021/10/17,22:00:00,332.07,4,8121,8125
2021/10/17,22:30:00,381.88,3,7984,7987
2021/10/17,23:00:00,289.28,3,7712,7715
2021/10/17,23:30:00,290.45,3,7407,7410
2021/10/18,00:00:00,283.57,3,7136,7139
2021/10/18,00:30:00,291.98,3,6862,6865
2021/10/18,01:00:00,291.46,4,6789,6793
2021/10/18,01:30:00,291.46,5,6825,6830
2021/10/18,02:00:00,290.21,3,6726,6729
2021/10/18,02:30:00,291.72,3,6597,6600
2021/10/18,03:00:00,290.95,3,6477,6480
2021/10/18,03:30:00,291.72,3,6464,6467
2021/10/18,04:00:00,290.21,3,6453,6456
2021/10/18,04:30:00,291.46,2,6498,6500
2021/10/18,05:00:00,290.21,2,6607,6609
2021/10/18,05:30:00,291.72,0,6728,6728
2021/10/18,06:00:00,290.7,0,6931,6931
2021/10/18,06:30:00,291.72,0,7154,7154
2021/10/18,07:00:00,290.21,0,7217,7217
2021/10/18,07:30:00,289.51,123,7345,7468
2021/10/18,08:00:00,289.74,441,7263,7704
2021/10/18,08:30:00,290.7,735,7207,7942
2021/10/18,09:00:00,290.45,970,7128,8098
2021/10/18,09:30:00,290.45,1249,7018,8267
2021/10/18,10:00:00,290.45,1431,6916,8347
2021/10/18,10:30:00,290.21,1498,6983,8481
2021/10/18,11:00:00,290.21,1600,7036,8636
2021/10/18,11:30:00,289.97,1454,7081,8535
2021/10/18,12:00:00,290.95,1416,7158,8574
2021/10/18,12:30:00,290.45,1482,7206,8688
2021/10/18,13:00:00,290.45,1526,7265,8791
2021/10/18,13:30:00,290.7,1492,7232,8724
2021/10/18,14:00:00,290.45,1438,7308,8746
2021/10/18,14:30:00,290.21,1456,7375,8831
2021/10/18,15:00:00,289.97,1466,7390,8856
2021/10/18,15:30:00,289.97,1390,7429,8819
2021/10/18,16:00:00,289.74,1271,7473,8744
2021/10/18,16:30:00,289.97,965,7746,8711
2021/10/18,17:00:00,325.85,666,7977,8643
2021/10/18,17:30:00,378.53,358,8139,8497
2021/10/18,18:00:00,386.14,147,8362,8509
2021/10/18,18:30:00,408.11,158,8658,8816
2021/10/18,19:00:00,358.88,161,8682,8843
2021/10/18,19:30:00,326.64,158,8625,8783
2021/10/18,20:00:00,380.33,139,8516,8655
2021/10/18,20:30:00,289.51,132,8370,8502
2021/10/18,21:00:00,289.97,133,8209,8342
2021/10/18,21:30:00,290.45,125,8099,8224
2021/10/18,22:00:00,290.21,122,7898,8020
2021/10/18,22:30:00,289.97,9,7861,7870
2021/10/18,23:00:00,288.63,5,7544,7549
2021/10/18,23:30:00,291.2,7,7300,7307
2021/10/19,00:00:00,290.95,4,7014,7018
2021/10/19,00:30:00,289.97,3,6806,6809
2021/10/19,01:00:00,290.7,4,6589,6593
2021/10/19,01:30:00,289.97,3,6438,6441
2021/10/19,02:00:00,290.21,2,6275,6277
2021/10/19,02:30:00,289.97,2,6200,6202
2021/10/19,03:00:00,290.21,2,6136,6138
2021/10/19,03:30:00,289.97,4,6095,6099
2021/10/19,04:00:00,289.97,4,6107,6111
2021/10/19,04:30:00,290.7,2,6108,6110
2021/10/19,05:00:00,291.46,2,6208,6210
2021/10/19,05:30:00,289.74,1,6444,6445
2021/10/19,06:00:00,290.45,1,6586,6587
2021/10/19,06:30:00,289.97,1,6805,6806
2021/10/19,07:00:00,290.95,0,6937,6937
2021/10/19,07:30:00,289.74,153,7145,7298
2021/10/19,08:00:00,291.2,411,7057,7468
2021/10/19,08:30:00,290.45,800,7008,7808
2021/10/19,09:00:00,290.45,1101,6859,7960
2021/10/19,09:30:00,289.97,1399,6799,8198
2021/10/19,10:00:00,289.97,1534,6761,8295
2021/10/19,10:30:00,290.7,1663,6863,8526
2021/10/19,11:00:00,289.74,1561,6867,8428
2021/10/19,11:30:00,291.2,1537,6968,8505
2021/10/19,12:00:00,290.7,1647,6914,8561
2021/10/19,12:30:00,291.2,1645,6941,8586
2021/10/19,13:00:00,290.7,1734,6843,8577
2021/10/19,13:30:00,289.97,1612,7003,8615
2021/10/19,14:00:00,290.21,1572,7114,8686
2021/10/19,14:30:00,289.74,1581,7209,8790
2021/10/19,15:00:00,289.97,1306,7361,8667
2021/10/19,15:30:00,291.46,1290,7404,8694
2021/10/19,16:00:00,289.97,1028,7610,8638
2021/10/19,16:30:00,290.21,867,7785,8652
2021/10/19,17:00:00,290.95,696,7913,8609
2021/10/19,17:30:00,289.74,396,8152,8548
2021/10/19,18:00:00,290.7,121,8331,8452
2021/10/19,18:30:00,289.97,122,8659,8781
2021/10/19,19:00:00,290.45,126,8686,8812
2021/10/19,19:30:00,289.97,125,8644,8769
2021/10/19,20:00:00,290.21,116,8524,8640
2021/10/19,20:30:00,289.97,112,8520,8632
2021/10/19,21:00:00,289.74,58,8307,8365
2021/10/19,21:30:00,289.51,1,8359,8360
2021/10/19,22:00:00,290.45,1,8123,8124
2021/10/19,22:30:00,289.28,2,7906,7908
2021/10/19,23:00:00,289.97,1,7657,7658
2021/10/19,23:30:00,289.97,1,7396,7397
2021/10/20,00:00:00,289.74,2,7080,7082
2021/10/20,00:30:00,289.51,4,6979,6983
2021/10/20,01:00:00,288.01,3,6810,6813
2021/10/20,01:30:00,289.97,3,6644,6647
2021/10/20,02:00:00,289.97,1,6501,6502
2021/10/20,02:30:00,290.45,0,6407,6407
2021/10/20,03:00:00,289.97,1,6347,6348
2021/10/20,03:30:00,289.74,1,6273,6274
2021/10/20,04:00:00,290.45,0,6333,6333
2021/10/20,04:30:00,289.97,0,6367,6367
2021/10/20,05:00:00,288.85,0,6484,6484
2021/10/20,05:30:00,289.97,0,6654,6654
2021/10/20,06:00:00,289.97,0,6844,6844
2021/10/20,06:30:00,289.51,0,7125,7125
2021/10/20,07:00:00,290.21,0,7354,7354
2021/10/20,07:30:00,289.74,138,7541,7679
2021/10/20,08:00:00,291.72,320,7448,7768
2021/10/20,08:30:00,291.98,492,7489,7981
2021/10/20,09:00:00,291.46,864,7295,8159
2021/10/20,09:30:00,291.2,1111,7181,8292
2021/10/20,10:00:00,290.95,1085,7188,8273
2021/10/20,10:30:00,291.46,1195,7187,8382
2021/10/20,11:00:00,290.95,1221,7069,8290
2021/10/20,11:30:00,291.46,1260,7109,8369
2021/10/20,12:00:00,291.2,1283,7129,8412
2021/10/20,12:30:00,291.2,1414,7084,8498
2021/10/20,13:00:00,290.95,1422,7084,8506
2021/10/20,13:30:00,291.2,1411,7198,8609
2021/10/20,14:00:00,291.46,1335,7333,8668
2021/10/20,14:30:00,291.72,1269,7396,8665
2021/10/20,15:00:00,291.46,1015,7420,8435
2021/10/20,15:30:00,291.72,1031,7477,8508
2021/10/20,16:00:00,290.7,942,7440,8382
2021/10/20,16:30:00,291.46,836,7658,8494
2021/10/20,17:00:00,290.7,548,7879,8427
2021/10/20,17:30:00,291.46,339,8076,8415
2021/10/20,18:00:00,384.11,157,8256,8413
2021/10/20,18:30:00,386.22,153,8635,8788
2021/10/20,19:00:00,384.11,101,8678,8779
2021/10/20,19:30:00,384.11,39,8635,8674
2021/10/20,20:00:00,382.11,36,8559,8595
2021/10/20,20:30:00,291.72,21,8370,8391
2021/10/20,21:00:00,291.72,5,8195,8200
2021/10/20,21:30:00,291.72,4,8054,8058
2021/10/20,22:00:00,290.95,4,7763,7767
2021/10/20,22:30:00,291.2,4,7609,7613
2021/10/20,23:00:00,291.46,4,7376,7380
2021/10/20,23:30:00,291.2,2,7064,7066
2021/10/21,00:00:00,291.2,2,6812,6814
2021/10/21,00:30:00,291.46,1,6584,6585
2021/10/21,01:00:00,289.97,1,6487,6488
2021/10/21,01:30:00,289.51,1,6496,6497
2021/10/21,02:00:00,290.7,1,6343,6344
2021/10/21,02:30:00,290.7,1,6254,6255
2021/10/21,03:00:00,291.46,1,6164,6165
2021/10/21,03:30:00,291.46,1,6130,6131
2021/10/21,04:00:00,291.46,1,6151,6152
2021/10/21,04:30:00,291.72,1,6203,6204
2021/10/21,05:00:00,291.2,1,6305,6306
2021/10/21,05:30:00,291.2,1,6481,6482
2021/10/21,06:00:00,291.2,1,6707,6708
2021/10/21,06:30:00,291.2,1,7000,7001
2021/10/21,07:00:00,290.7,1,7152,7153
2021/10/21,07:30:00,290.21,119,7474,7593
2021/10/21,08:00:00,289.97,362,7229,7591
2021/10/21,08:30:00,289.74,775,7137,7912
2021/10/21,09:00:00,290.95,1066,6941,8007
2021/10/21,09:30:00,289.97,1300,6893,8193
2021/10/21,10:00:00,290.21,1556,6576,8132
2021/10/21,10:30:00,289.97,1651,6580,8231
2021/10/21,11:00:00,289.97,1778,6535,8313
2021/10/21,11:30:00,289.51,1799,6598,8397
2021/10/21,12:00:00,290.21,1823,6625,8448
2021/10/21,12:30:00,290.45,1834,6613,8447
2021/10/21,13:00:00,290.21,1844,6739,8583
2021/10/21,13:30:00,290.21,1770,6897,8667
2021/10/21,14:00:00,289.74,1649,7039,8688
2021/10/21,14:30:00,289.97,1636,7103,8739
2021/10/21,15:00:00,290.21,1520,7175,8695
2021/10/21,15:30:00,290.21,1390,7351,8741
2021/10/21,16:00:00,289.97,1206,7501,8707
2021/10/21,16:30:00,290.45,872,7721,8593
2021/10/21,17:00:00,291.46,545,7941,8486
2021/10/21,17:30:00,290.45,320,8180,8500
2021/10/21,18:00:00,289.97,144,8312,8456
2021/10/21,18:30:00,290.45,147,8662,8809
2021/10/21,19:00:00,289.97,145,8631,8776
2021/10/21,19:30:00,289.97,143,8540,8683
2021/10/21,20:00:00,290.21,132,8443,8575
2021/10/21,20:30:00,289.74,74,8355,8429
2021/10/21,21:00:00,289.74,4,8280,8284
2021/10/21,21:30:00,289.74,4,8132,8136
2021/10/21,22:00:00,289.28,3,7880,7883
2021/10/21,22:30:00,289.97,3,7723,7726
2021/10/21,23:00:00,290.45,2,7470,7472
2021/10/21,23:30:00,289.97,2,7230,7232
2021/10/22,00:00:00,289.74,2,6956,6958
2021/10/22,00:30:00,289.97,1,6724,6725
2021/10/22,01:00:00,289.97,1,6550,6551
2021/10/22,01:30:00,289.97,1,6364,6365
2021/10/22,02:00:00,286.86,1,6200,6201
2021/10/22,02:30:00,286.34,1,6243,6244
2021/10/22,03:00:00,290.21,1,6182,6183
2021/10/22,03:30:00,290.7,1,6103,6104
2021/10/22,04:00:00,290.45,2,6085,6087
2021/10/22,04:30:00,290.21,2,6106,6108
2021/10/22,05:00:00,290.21,2,5997,5999
2021/10/22,05:30:00,289.74,1,6136,6137
2021/10/22,06:00:00,289.51,2,6240,6242
2021/10/22,06:30:00,289.06,1,6391,6392
2021/10/22,07:00:00,290.21,2,6521,6523
2021/10/22,07:30:00,290.7,128,6621,6749
2021/10/22,08:00:00,290.21,364,6532,6896
2021/10/22,08:30:00,290.7,628,6444,7072
2021/10/22,09:00:00,290.7,1024,6350,7374
2021/10/22,09:30:00,289.51,1347,6322,7669
2021/10/22,10:00:00,291.72,1533,6199,7732
2021/10/22,10:30:00,290.45,1663,6260,7923
2021/10/22,11:00:00,291.46,1688,6211,7899
2021/10/22,11:30:00,291.2,1704,6251,7955
2021/10/22,12:00:00,291.72,1787,6183,7970
2021/10/22,12:30:00,290.95,1594,6484,8078
2021/10/22,13:00:00,291.2,1672,6360,8032
2021/10/22,13:30:00,291.72,1495,6337,7832
2021/10/22,14:00:00,291.72,1541,6312,7853
2021/10/22,14:30:00,289.97,1420,6307,7727
2021/10/22,15:00:00,289.74,1277,6388,7665
2021/10/22,15:30:00,290.45,1172,6554,7726
2021/10/22,16:00:00,289.74,1004,6719,7723
2021/10/22,16:30:00,289.51,796,7106,7902
2021/10/22,17:00:00,289.74,500,7453,7953
2021/10/22,17:30:00,289.74,214,7729,7943
2021/10/22,18:00:00,290.7,43,7867,7910
2021/10/22,18:30:00,289.74,9,8152,8161
2021/10/22,19:00:00,290.45,13,8070,8083
2021/10/22,19:30:00,289.97,10,7884,7894
2021/10/22,20:00:00,289.28,9,7706,7715
2021/10/22,20:30:00,289.51,6,7604,7610
2021/10/22,21:00:00,289.97,5,7456,7461
2021/10/22,21:30:00,289.74,6,7331,7337
2021/10/22,22:00:00,289.74,5,7219,7224
2021/10/22,22:30:00,289.97,5,7104,7109
2021/10/22,23:00:00,290.21,5,6928,6933
2021/10/22,23:30:00,289.74,6,6756,6762
2021/10/23,00:00:00,289.74,6,6538,6544
2021/10/23,00:30:00,289.74,6,6392,6398
2021/10/23,01:00:00,289.97,5,6258,6263
2021/10/23,01:30:00,289.97,4,6123,6127
2021/10/23,02:00:00,289.97,4,6053,6057
2021/10/23,02:30:00,289.74,3,5965,5968
2021/10/23,03:00:00,289.28,3,6055,6058
2021/10/23,03:30:00,289.51,3,6019,6022
2021/10/23,04:00:00,289.74,3,5983,5986
2021/10/23,04:30:00,289.28,3,5989,5992
2021/10/23,05:00:00,289.97,3,6002,6005
2021/10/23,05:30:00,289.74,3,6068,6071
2021/10/23,06:00:00,289.51,3,6111,6114
2021/10/23,06:30:00,289.51,2,6139,6141
2021/10/23,07:00:00,289.51,2,6007,6009
2021/10/23,07:30:00,289.28,111,5936,6047
2021/10/23,08:00:00,289.97,321,5950,6271
2021/10/23,08:30:00,291.72,604,5882,6486
2021/10/23,09:00:00,290.7,959,5682,6641
2021/10/23,09:30:00,291.46,1199,5576,6775
2021/10/23,10:00:00,291.2,1388,5580,6968
2021/10/23,10:30:00,291.72,1449,5602,7051
2021/10/23,11:00:00,291.46,1343,5638,6981
2021/10/23,11:30:00,291.72,1613,5610,7223
2021/10/23,12:00:00,291.72,1608,5487,7095
2021/10/23,12:30:00,290.45,1662,5518,7180
2021/10/23,13:00:00,290.45,1460,5671,7131
2021/10/23,13:30:00,289.06,1536,5529,7065
2021/10/23,14:00:00,291.2,1450,5389,6839
2021/10/23,14:30:00,289.74,1477,5439,6916
2021/10/23,15:00:00,290.21,1339,5580,6919
2021/10/23,15:30:00,290.45,1263,5785,7048
2021/10/23,16:00:00,289.74,991,6021,7012
2021/10/23,16:30:00,289.51,835,6393,7228
2021/10/23,17:00:00,289.51,551,6664,7215
2021/10/23,17:30:00,289.51,316,6956,7272
2021/10/23,18:00:00,289.51,75,7299,7374
2021/10/23,18:30:00,289.51,48,7685,7733
2021/10/23,19:00:00,289.97,17,7811,7828
2021/10/23,19:30:00,289.74,16,7899,7915
2021/10/23,20:00:00,289.28,15,7861,7876
2021/10/23,20:30:00,289.97,14,7789,7803
2021/10/23,21:00:00,289.51,14,7660,7674
2021/10/23,21:30:00,289.74,13,7622,7635
2021/10/23,22:00:00,289.97,12,7458,7470
2021/10/23,22:30:00,289.74,6,7322,7328
2021/10/23,23:00:00,289.74,5,7097,7102
2021/10/23,23:30:00,289.51,4,6858,6862
2021/10/24,00:00:00,290.21,3,6605,6608
2021/10/24,00:30:00,289.97,2,6370,6372
2021/10/24,01:00:00,289.97,2,6200,6202
2021/10/24,01:30:00,289.74,2,6020,6022
2021/10/24,02:00:00,289.97,2,5902,5904
2021/10/24,02:30:00,289.97,2,5821,5823
2021/10/24,03:00:00,289.28,2,5905,5907
2021/10/24,03:30:00,289.51,2,5836,5838
2021/10/24,04:00:00,289.97,2,5842,5844
2021/10/24,04:30:00,289.28,2,5909,5911
2021/10/24,05:00:00,289.74,2,6021,6023
2021/10/24,05:30:00,291.46,1,6087,6088
2021/10/24,06:00:00,288.85,1,6264,6265
2021/10/24,06:30:00,289.28,1,6573,6574
2021/10/24,07:00:00,289.28,1,6746,6747
2021/10/24,07:30:00,289.51,143,7001,7144
2021/10/24,08:00:00,289.28,396,6874,7270
2021/10/24,08:30:00,289.51,666,6810,7476
2021/10/24,09:00:00,288.85,921,6755,7676
2021/10/24,09:30:00,289.28,1319,6738,8057
2021/10/24,10:00:00,288.42,1521,6757,8278
2021/10/24,10:30:00,289.51,1684,6755,8439
2021/10/24,11:00:00,289.28,1730,6671,8401
2021/10/24,11:30:00,289.06,1832,6670,8502
2021/10/24,12:00:00,288.85,1882,6656,8538
2021/10/24,12:30:00,289.06,1898,6709,8607
2021/10/24,13:00:00,288.42,1903,6797,8700
2021/10/24,13:30:00,289.06,1851,6858,8709
2021/10/24,14:00:00,290.7,1784,6857,8641
2021/10/24,14:30:00,288.85,1744,7026,8770
2021/10/24,15:00:00,289.06,1605,6993,8598
2021/10/24,15:30:00,288.63,1443,7160,8603
2021/10/24,16:00:00,288.85,1207,7308,8515
2021/10/24,16:30:00,288.63,848,7632,8480
2021/10/24,17:00:00,284.72,571,7842,8413
2021/10/24,17:30:00,284.53,301,8050,8351
2021/10/24,18:00:00,284.72,116,8282,8398
2021/10/24,18:30:00,284.72,122,8606,8728
2021/10/24,19:00:00,284.72,121,8582,8703
2021/10/24,19:30:00,284.72,51,8552,8603
2021/10/24,20:00:00,284.72,24,8472,8496
2021/10/24,20:30:00,290.95,4,8333,8337
2021/10/24,21:00:00,289.51,4,8197,8201
2021/10/24,21:30:00,288.21,5,8082,8087
2021/10/24,22:00:00,288.85,5,7831,7836
2021/10/24,22:30:00,289.51,5,7631,7636
2021/10/24,23:00:00,288.85,5,7409,7414
2021/10/24,23:30:00,288.63,4,7103,7107
2021/10/25,00:00,288.85,2,6803,6805
2021/10/25,00:30,288.85,2,6565,6567
2021/10/25,01:00,289.74,1,6361,6362
2021/10/25,01:30,289.51,1,6210,6211
2021/10/25,02:00,286.51,1,6190,6191
2021/10/25,02:30,288.21,1,6173,6174
2021/10/25,03:00,288.42,2,6064,6066
2021/10/25,03:30,288.63,3,6007,6010
2021/10/25,04:00,290.21,3,6048,6051
2021/10/25,04:30,288.21,3,6281,6284
2021/10/25,05:00,288.63,3,6362,6365
2021/10/25,05:30,288.01,2,6603,6605
2021/10/25,06:00,289.06,2,6781,6783
2021/10/25,06:30,289.06,2,7048,7050
2021/10/25,07:00,288.63,2,7275,7277
2021/10/25,07:30,288.21,109,7378,7487
2021/10/25,08:00,288.01,353,7198,7551
2021/10/25,08:30,288.01,602,7189,7791
2021/10/25,09:00,288.42,879,7040,7919
2021/10/25,09:30,288.42,1192,6926,8118
2021/10/25,10:00,288.21,1376,6822,8198
2021/10/25,10:30,292.25,1649,6633,8282
2021/10/25,11:00,291.72,1784,6556,8340
2021/10/25,11:30,288.21,1845,6523,8368
2021/10/25,12:00,288.42,1888,6527,8415
2021/10/25,12:30,288.01,1902,6605,8507
2021/10/25,13:00,288.01,1899,6541,8440
2021/10/25,13:30,288.63,1840,6676,8516
2021/10/25,14:00,288.85,1786,6758,8544
2021/10/25,14:30,288.42,1705,6895,8600
2021/10/25,15:00,288.63,1555,7022,8577
2021/10/25,15:30,288.63,1414,7202,8616
2021/10/25,16:00,288.42,1184,7397,8581
2021/10/25,16:30,288.85,826,7671,8497
2021/10/25,17:00,288.01,540,7925,8465
2021/10/25,17:30,288.21,293,8105,8398
2021/10/25,18:00,288.21,105,8371,8476
2021/10/25,18:30,288.01,114,8627,8741
2021/10/25,19:00,288.63,69,8664,8733
2021/10/25,19:30,288.21,3,8625,8628
2021/10/25,20:00,288.21,1,8512,8513
2021/10/25,20:30,288.21,3,8358,8361
2021/10/25,21:00,288.63,3,8203,8206
2021/10/25,21:30,287.61,4,8043,8047
2021/10/25,22:00,288.42,4,7784,7788
2021/10/25,22:30,289.97,3,7600,7603
2021/10/25,23:00,288.21,2,7429,7431
2021/10/25,23:30,288.01,3,7119,7122
2021/10/26,00:00,288.63,2,6833,6835
2021/10/26,00:30,288.42,2,6559,6561
2021/10/26,01:00,286.51,1,6356,6357
2021/10/26,01:30,287.23,0,6329,6329
2021/10/26,02:00,288.01,0,6223,6223
2021/10/26,02:30,288.63,2,6265,6267
2021/10/26,03:00,288.21,3,6179,6182
2021/10/26,03:30,288.63,1,6140,6141
2021/10/26,04:00,289.06,2,6149,6151
2021/10/26,04:30,288.21,1,6231,6232
2021/10/26,05:00,288.42,1,6349,6350
2021/10/26,05:30,287.61,1,6569,6570
2021/10/26,06:00,287.81,1,6748,6749
2021/10/26,06:30,288.01,1,7039,7040
2021/10/26,07:00,288.42,1,7175,7176
2021/10/26,07:30,290.7,124,7241,7365
2021/10/26,08:00,290.7,376,7096,7472
2021/10/26,08:30,291.2,624,7082,7706
2021/10/26,09:00,291.2,879,6971,7850
2021/10/26,09:30,291.2,1284,6749,8033
2021/10/26,10:00,290.7,1505,6600,8105
2021/10/26,10:30,291.72,1657,6531,8188
2021/10/26,11:00,291.2,1775,6485,8260
2021/10/26,11:30,291.2,1845,6474,8319
2021/10/26,12:00,290.95,1850,6505,8355
2021/10/26,12:30,291.2,1879,6550,8429
2021/10/26,13:00,291.72,1877,6639,8516
2021/10/26,13:30,290.21,1814,6637,8451
2021/10/26,14:00,290.45,1764,6744,8508
2021/10/26,14:30,290.45,1671,6915,8586
2021/10/26,15:00,290.45,1538,7062,8600
2021/10/26,15:30,290.21,1383,7252,8635
2021/10/26,16:00,290.21,1165,7403,8568
2021/10/26,16:30,290.45,791,7685,8476
2021/10/26,17:00,289.97,500,7933,8433
2021/10/26,17:30,290.45,250,8117,8367
2021/10/26,18:00,290.45,115,8379,8494
2021/10/26,18:30,290.21,116,8614,8730
2021/10/26,19:00,290.45,113,8589,8702
2021/10/26,19:30,290.21,25,8604,8629
2021/10/26,20:00,290.45,5,8496,8501
2021/10/26,20:30,289.97,5,8367,8372
2021/10/26,21:00,290.7,5,8239,8244
2021/10/26,21:30,290.45,4,8108,8112
2021/10/26,22:00,289.51,4,7863,7867
2021/10/26,22:30,290.21,2,7688,7690
2021/10/26,23:00,290.21,2,7399,7401
2021/10/26,23:30,289.74,1,7066,7067
2021/10/27,00:00,290.21,1,6817,6818
2021/10/27,00:30,288.21,1,6564,6565
2021/10/27,01:00,288.01,1,6438,6439
2021/10/27,01:30,290.21,0,6324,6324
2021/10/27,02:00,288.85,1,6213,6214
2021/10/27,02:30,290.21,1,6120,6121
2021/10/27,03:00,290.7,1,6045,6046
2021/10/27,03:30,290.45,0,6056,6056
2021/10/27,04:00,290.45,1,6058,6059
2021/10/27,04:30,290.7,1,6250,6251
2021/10/27,05:00,290.95,1,6328,6329
2021/10/27,05:30,291.2,1,6592,6593
2021/10/27,06:00,291.2,1,6722,6723
2021/10/27,06:30,291.2,1,7034,7035
2021/10/27,07:00,291.98,1,7114,7115
2021/10/27,07:30,289.28,130,7117,7247
2021/10/27,08:00,289.28,314,6982,7296
2021/10/27,08:30,289.74,639,6911,7550
2021/10/27,09:00,288.85,934,6836,7770
2021/10/27,09:30,291.46,1300,6636,7936
2021/10/27,10:00,291.2,1521,6546,8067
2021/10/27,10:30,290.7,1650,6442,8092
2021/10/27,11:00,290.95,1775,6402,8177
2021/10/27,11:30,290.45,1832,6398,8230
2021/10/27,12:00,290.7,1856,6474,8330
2021/10/27,12:30,290.7,1878,6492,8370
2021/10/27,13:00,289.97,1862,6470,8332
2021/10/27,13:30,290.21,1828,6588,8416
2021/10/27,14:00,289.97,1743,6738,8481
2021/10/27,14:30,289.97,1654,6906,8560
2021/10/27,15:00,289.74,1511,7057,8568
2021/10/27,15:30,290.7,1288,7249,8537
2021/10/27,16:00,289.74,1085,7440,8525
2021/10/27,16:30,289.51,772,7739,8511
2021/10/27,17:00,289.97,419,7935,8354
2021/10/27,17:30,289.28,277,8128,8405
2021/10/27,18:00,289.74,119,8407,8526
2021/10/27,18:30,289.97,119,8683,8802
2021/10/27,19:00,289.51,118,8639,8757
2021/10/27,19:30,289.51,114,8558,8672
2021/10/27,20:00,289.28,45,8508,8553
2021/10/27,20:30,289.74,2,8390,8392
2021/10/27,21:00,289.74,1,8184,8185
2021/10/27,21:30,289.74,0,8007,8007
2021/10/27,22:00,289.51,1,7804,7805
2021/10/27,22:30,289.51,1,7632,7633
2021/10/27,23:00,289.51,0,7377,7377
2021/10/27,23:30,289.28,0,7052,7052
2021/10/28,00:00,290.21,0,6783,6783
2021/10/28,00:30,291.2,0,6553,6553
2021/10/28,01:00,290.95,0,6307,6307
2021/10/28,01:30,291.2,0,6123,6123
2021/10/28,02:00,291.2,0,6022,6022
2021/10/28,02:30,290.45,0,5923,5923
2021/10/28,03:00,290.95,0,5851,5851
2021/10/28,03:30,291.2,0,5847,5847
2021/10/28,04:00,291.2,0,5852,5852
2021/10/28,04:30,291.72,0,6007,6007
2021/10/28,05:00,290.95,0,6129,6129
2021/10/28,05:30,290.95,0,6330,6330
2021/10/28,06:00,291.2,0,6512,6512
2021/10/28,06:30,290.95,0,6797,6797
2021/10/28,07:00,290.95,2,6954,6956
2021/10/28,07:30,290.95,101,7176,7277
2021/10/28,08:00,290.95,233,7085,7318
2021/10/28,08:30,291.2,583,6991,7574
2021/10/28,09:00,291.2,878,6826,7704
2021/10/28,09:30,290.7,1119,6868,7987
2021/10/28,10:00,290.95,1406,6708,8114
2021/10/28,10:30,290.45,1537,6720,8257
2021/10/28,11:00,291.46,1617,6774,8391
2021/10/28,11:30,291.2,1750,6866,8616
2021/10/28,12:00,291.2,1756,6883,8639
2021/10/28,12:30,291.46,1747,6950,8697
2021/10/28,13:00,290.7,1721,7074,8795
2021/10/28,13:30,290.95,1711,7240,8951
2021/10/28,14:00,290.95,1519,7440,8959
2021/10/28,14:30,291.2,1099,7510,8609
2021/10/28,15:00,290.7,798,7728,8526
2021/10/28,15:30,291.2,979,7726,8705
2021/10/28,16:00,291.2,693,7877,8570
2021/10/28,16:30,290.7,624,7991,8615
2021/10/28,17:00,290.7,368,8131,8499
2021/10/28,17:30,290.95,82,8263,8345
2021/10/28,18:00,290.95,0,8605,8605
2021/10/28,18:30,291.46,0,8809,8809
2021/10/28,19:00,290.21,0,8737,8737
2021/10/28,19:30,290.21,0,8618,8618
2021/10/28,20:00,290.21,1,8485,8486
2021/10/28,20:30,290.45,1,8301,8302
2021/10/28,21:00,290.21,1,8155,8156
2021/10/28,21:30,290.21,1,7963,7964
2021/10/28,22:00,290.21,1,7767,7768
2021/10/28,22:30,289.97,1,7600,7601
2021/10/28,23:00,290.45,1,7355,7356
2021/10/28,23:30,290.45,1,7125,7126
2021/10/29,00:00,290.7,3,6836,6839
2021/10/29,00:30,290.45,4,6630,6634
2021/10/29,01:00,290.45,4,6435,6439
2021/10/29,01:30,291.2,2,6298,6300
2021/10/29,02:00,290.7,2,6155,6157
2021/10/29,02:30,289.06,2,6018,6020
2021/10/29,03:00,291.46,2,5961,5963
2021/10/29,03:30,290.7,2,5938,5940
2021/10/29,04:00,290.21,3,5927,5930
2021/10/29,04:30,290.95,3,5941,5944
2021/10/29,05:00,289.97,2,6128,6130
2021/10/29,05:30,290.95,3,6251,6254
2021/10/29,06:00,290.7,5,6353,6358
2021/10/29,06:30,290.45,2,6516,6518
2021/10/29,07:00,290.21,2,6536,6538
2021/10/29,07:30,290.45,116,6721,6837
2021/10/29,08:00,290.7,229,6687,6916
2021/10/29,08:30,290.7,411,6668,7079
2021/10/29,09:00,291.2,715,6645,7360
2021/10/29,09:30,290.45,865,6616,7481
2021/10/29,10:00,291.46,1055,6640,7695
2021/10/29,10:30,290.95,1293,6591,7884
2021/10/29,11:00,290.95,1481,6632,8113
2021/10/29,11:30,290.7,1645,6542,8187
2021/10/29,12:00,291.46,1775,6552,8327
2021/10/29,12:30,290.95,1705,6589,8294
2021/10/29,13:00,290.45,1738,6649,8387
2021/10/29,13:30,290.45,1721,6714,8435
2021/10/29,14:00,290.7,1576,6801,8377
2021/10/29,14:30,291.2,1477,6913,8390
2021/10/29,15:00,291.2,1350,6952,8302
2021/10/29,15:30,290.7,1209,7168,8377
2021/10/29,16:00,291.98,952,7266,8218
2021/10/29,16:30,290.45,641,7440,8081
2021/10/29,17:00,291.2,393,7754,8147
2021/10/29,17:30,289.97,49,8030,8079
2021/10/29,18:00,291.72,1,8171,8172
2021/10/29,18:30,290.21,1,8287,8288
2021/10/29,19:00,289.97,1,8167,8168
2021/10/29,19:30,289.97,1,8024,8025
2021/10/29,20:00,289.97,1,7812,7813
2021/10/29,20:30,290.21,1,7745,7746
2021/10/29,21:00,289.97,1,7647,7648
2021/10/29,21:30,289.74,1,7526,7527
2021/10/29,22:00,290.45,1,7359,7360
2021/10/29,22:30,290.21,1,7255,7256
2021/10/29,23:00,289.97,3,7106,7109
2021/10/29,23:30,290.21,2,6944,6946
2021/10/30,00:00,289.97,2,6778,6780
2021/10/30,00:30,289.51,2,6583,6585
2021/10/30,01:00,290.21,2,6431,6433
2021/10/30,01:30,290.7,3,6302,6305
2021/10/30,02:00,290.95,2,6181,6183
2021/10/30,02:30,290.95,1,6246,6247
2021/10/30,03:00,291.46,1,6197,6198
2021/10/30,03:30,291.2,1,6155,6156
2021/10/30,04:00,291.2,1,6106,6107
2021/10/30,04:30,291.72,2,6138,6140
2021/10/30,05:00,291.72,2,6168,6170
2021/10/30,05:30,290.7,2,6239,6241
2021/10/30,06:00,291.46,1,6409,6410
2021/10/30,06:30,291.46,1,6456,6457
2021/10/30,07:00,291.72,2,6258,6260
2021/10/30,07:30,290.7,151,6270,6421
2021/10/30,08:00,291.2,156,6308,6464
2021/10/30,08:30,290.95,306,6259,6565
2021/10/30,09:00,290.7,552,6233,6785
2021/10/30,09:30,288.42,751,6147,6898
2021/10/30,10:00,290.7,991,6001,6992
2021/10/30,10:30,291.2,1315,5939,7254
2021/10/30,11:00,291.2,1423,5846,7269
2021/10/30,11:30,290.7,1418,5844,7262
2021/10/30,12:00,290.45,1255,6040,7295
2021/10/30,12:30,290.45,1008,6348,7356
2021/10/30,13:00,291.2,1084,6261,7345
2021/10/30,13:30,288.01,1086,6286,7372
2021/10/30,14:00,289.28,1150,6216,7366
2021/10/30,14:30,289.51,1129,6316,7445
2021/10/30,15:00,289.97,1076,6279,7355
2021/10/30,15:30,289.74,819,6394,7213
2021/10/30,16:00,289.74,796,6567,7363
2021/10/30,16:30,289.51,503,6873,7376
2021/10/30,17:00,289.28,296,7111,7407
2021/10/30,17:30,289.51,179,7333,7512
2021/10/30,18:00,289.28,5,7664,7669
2021/10/30,18:30,289.51,3,7894,7897
2021/10/30,19:00,289.74,3,8017,8020
2021/10/30,19:30,289.28,2,8074,8076
2021/10/30,20:00,289.51,2,8038,8040
2021/10/30,20:30,289.74,1,7944,7945
2021/10/30,21:00,289.74,1,7883,7884
2021/10/30,21:30,289.74,1,7797,7798
2021/10/30,22:00,289.74,1,7628,7629
2021/10/30,22:30,289.51,1,7450,7451
2021/10/30,23:00,289.74,1,7227,7228
2021/10/30,23:30,289.51,1,6999,7000
2021/10/31,00:00,290.21,1,6801,6802
2021/10/31,00:30,289.97,1,6549,6550
2021/10/31,01:00,289.74,1,6054,6055
2021/10/31,01:30,289.74,1,5951,5952
2021/10/31,02:00,289.74,1,5862,5863
2021/10/31,02:30,289.74,1,5796,5797
2021/10/31,03:00,289.97,1,5810,5811
2021/10/31,03:30,289.97,1,5792,5793
2021/10/31,04:00,289.74,1,5864,5865
2021/10/31,04:30,289.74,0,5963,5963
2021/10/31,05:00,289.97,0,6075,6075
2021/10/31,05:30,289.97,0,6262,6262
2021/10/31,06:00,290.21,0,6321,6321
2021/10/31,06:30,380.79,0,6809,6809
2021/10/31,07:00,380.79,175,7032,7207
2021/10/31,07:30,373.78,201,7316,7517
2021/10/31,08:00,376.36,224,7419,7643
2021/10/31,08:30,378.99,291,7603,7894
2021/10/31,09:00,373.78,341,7728,8069
2021/10/31,09:30,289.28,446,7838,8284
2021/10/31,10:00,289.28,422,7971,8393
2021/10/31,10:30,289.28,548,7960,8508
2021/10/31,11:00,289.28,680,7950,8630
2021/10/31,11:30,289.28,650,7976,8626
2021/10/31,12:00,289.28,571,8040,8611
2021/10/31,12:30,289.28,477,8078,8555
2021/10/31,13:00,289.51,475,8137,8612
2021/10/31,13:30,289.28,641,8087,8728
2021/10/31,14:00,289.28,903,8041,8944
2021/10/31,14:30,290.7,820,8336,9156
2021/10/31,15:00,290.45,530,8341,8871
2021/10/31,15:30,290.7,423,8453,8876
2021/10/31,16:00,290.7,294,8463,8757
2021/10/31,16:30,290.45,124,8642,8766
2021/10/31,17:00,373.09,2,8987,8989
2021/10/31,17:30,375.34,2,9180,9182
2021/10/31,18:00,375.49,1,9189,9190
2021/10/31,18:30,377.44,1,9133,9134
2021/10/31,19:00,380.79,2,9034,9036
2021/10/31,19:30,375.49,3,8897,8900
2021/10/31,20:00,285.01,5,8767,8772
2021/10/31,20:30,284.72,4,8563,8567
2021/10/31,21:00,284.43,5,8365,8370
2021/10/31,21:30,293.37,7,8230,8237
2021/10/31,22:00,291.72,7,7913,7920
2021/10/31,22:30,292.25,4,7735,7739
2021/10/31,23:00,289.97,8,7428,7436
2021/10/31,23:30,289.74,7,7160,7167
2021/11/01,00:00,336.39,7,6868,6875
2021/11/01,00:30,336.13,7,6624,6631
2021/11/01,01:00,340.69,7,6417,6424
2021/11/01,01:30,340.99,7,6396,6403
2021/11/01,02:00,340.99,6,6456,6462
2021/11/01,02:30,340.4,5,6409,6414
2021/11/01,03:00,340.4,8,6356,6364
2021/11/01,03:30,340.99,11,6314,6325
2021/11/01,04:00,339.83,8,6388,6396
2021/11/01,04:30,341.9,11,6399,6410
2021/11/01,05:00,341.29,9,6497,6506
2021/11/01,05:30,341.29,5,6673,6678
2021/11/01,06:00,341.59,10,6676,6686
2021/11/01,06:30,341.59,8,6987,6995
2021/11/01,07:00,341.59,227,7231,7458
2021/11/01,07:30,340.99,361,7497,7858
2021/11/01,08:00,340.4,535,7512,8047
2021/11/01,08:30,342.22,819,7567,8386
2021/11/01,09:00,341.59,1159,7443,8602
2021/11/01,09:30,341.29,1309,7448,8757
2021/11/01,10:00,341.29,1434,7253,8687
2021/11/01,10:30,341.29,1548,7323,8871
2021/11/01,11:00,340.99,1726,7271,8997
2021/11/01,11:30,339.28,1719,7275,8994
2021/11/01,12:00,339.83,1857,7275,9132
2021/11/01,12:30,339.28,1836,7384,9220
2021/11/01,13:00,339.28,1715,7502,9217
2021/11/01,13:30,339.28,1577,7628,9205
2021/11/01,14:00,339.01,1440,7682,9122
2021/11/01,14:30,339.83,1156,7949,9105
2021/11/01,15:00,339.55,988,8072,9060
2021/11/01,15:30,339.28,753,8298,9051
2021/11/01,16:00,378.97,323,8496,8819
2021/11/01,16:30,376.81,212,8679,8891
2021/11/01,17:00,374.81,116,8975,9091
2021/11/01,17:30,377.03,119,9150,9269
2021/11/01,18:00,375.18,123,9116,9239
2021/11/01,18:30,377.13,123,9078,9201
2021/11/01,19:00,375.18,122,8941,9063
2021/11/01,19:30,375.18,121,8820,8941
2021/11/01,20:00,339.83,116,8695,8811
2021/11/01,20:30,339.55,120,8521,8641
2021/11/01,21:00,339.55,43,8404,8447
2021/11/01,21:30,340.11,1,8177,8178
2021/11/01,22:00,339.01,1,7911,7912
2021/11/01,22:30,340.4,1,7729,7730
2021/11/01,23:00,339.55,1,7462,7463
2021/11/01,23:30,357.3,1,7135,7136
2021/11/02,00:00,338.23,1,6812,6813
2021/11/02,00:30,340.4,1,6617,6618
2021/11/02,01:00,336.56,1,6358,6359
2021/11/02,01:30,337.73,1,6366,6367
2021/11/02,02:00,340.11,1,6269,6270
2021/11/02,02:30,337.73,1,6340,6341
2021/11/02,03:00,339.28,1,6281,6282
2021/11/02,03:30,341.29,1,6263,6264
2021/11/02,04:00,340.4,1,6276,6277
2021/11/02,04:30,340.99,1,6393,6394
2021/11/02,05:00,340.69,1,6496,6497
2021/11/02,05:30,340.99,1,6674,6675
2021/11/02,06:00,341.9,0,6700,6700
2021/11/02,06:30,340.69,101,6897,6998
2021/11/02,07:00,340.4,313,7013,7326
2021/11/02,07:30,341.29,480,7214,7694
2021/11/02,08:00,338.74,629,7288,7917
2021/11/02,08:30,340.4,965,7304,8269
2021/11/02,09:00,339.55,1013,7431,8444
2021/11/02,09:30,340.11,1197,7420,8617
2021/11/02,10:00,339.55,1332,7254,8586
2021/11/02,10:30,341.29,1378,7080,8458
2021/11/02,11:00,340.99,1347,7242,8589
2021/11/02,11:30,340.99,1288,7220,8508
2021/11/02,12:00,339.55,1474,7054,8528
2021/11/02,12:30,340.11,1480,7020,8500
2021/11/02,13:00,340.11,1466,7158,8624
2021/11/02,13:30,339.83,1383,7225,8608
2021/11/02,14:00,339.83,1315,7312,8627
2021/11/02,14:30,340.11,1280,7400,8680
2021/11/02,15:00,339.83,1172,7568,8740
2021/11/02,15:30,340.99,828,7804,8632
2021/11/02,16:00,340.4,437,8055,8492
2021/11/02,16:30,340.11,216,8268,8484
2021/11/02,17:00,384.69,121,8544,8665
2021/11/02,17:30,384.69,133,8718,8851
2021/11/02,18:00,340.11,127,8743,8870
2021/11/02,18:30,340.4,119,8713,8832
2021/11/02,19:00,340.11,118,8592,8710
2021/11/02,19:30,340.4,116,8499,8615
2021/11/02,20:00,370.36,114,8363,8477
2021/11/02,20:30,373.5,90,8236,8326
2021/11/02,21:00,376.9,35,8098,8133
2021/11/02,21:30,380.55,1,7922,7923
2021/11/02,22:00,370.42,3,7655,7658
2021/11/02,22:30,362.04,2,7523,7525
2021/11/02,23:00,374.06,2,7261,7263
2021/11/02,23:30,340.4,2,6896,6898
2021/11/03,00:00,340.69,2,6627,6629
2021/11/03,00:30,341.59,2,6398,6400
2021/11/03,01:00,340.11,2,6214,6216
2021/11/03,01:30,341.59,2,6116,6118
2021/11/03,02:00,340.69,2,6106,6108
2021/11/03,02:30,340.11,2,6192,6194
2021/11/03,03:00,340.4,2,6153,6155
2021/11/03,03:30,340.11,2,6145,6147
2021/11/03,04:00,340.4,2,6139,6141
2021/11/03,04:30,341.29,2,6227,6229
2021/11/03,05:00,340.4,2,6376,6378
2021/11/03,05:30,340.99,2,6555,6557
2021/11/03,06:00,341.9,2,6553,6555
2021/11/03,06:30,340.11,108,6786,6894
2021/11/03,07:00,341.9,309,6833,7142
2021/11/03,07:30,341.59,590,6842,7432
2021/11/03,08:00,339.83,1031,6606,7637
2021/11/03,08:30,338.74,1380,6537,7917
2021/11/03,09:00,339.55,1589,6470,8059
2021/11/03,09:30,339.01,1726,6529,8255
2021/11/03,10:00,339.01,1853,6289,8142
2021/11/03,10:30,338.48,1813,6323,8136
2021/11/03,11:00,339.83,1877,6337,8214
2021/11/03,11:30,339.01,1900,6402,8302
2021/11/03,12:00,341.29,1815,6401,8216
2021/11/03,12:30,339.01,1809,6498,8307
2021/11/03,13:00,338.74,1802,6603,8405
2021/11/03,13:30,339.01,1677,6768,8445
2021/11/03,14:00,339.01,1570,6921,8491
2021/11/03,14:30,338.74,1460,7138,8598
2021/11/03,15:00,339.01,1253,7371,8624
2021/11/03,15:30,339.55,843,7692,8535
2021/11/03,16:00,339.01,486,7950,8436
2021/11/03,16:30,340.69,255,8209,8464
2021/11/03,17:00,340.69,104,8526,8630
2021/11/03,17:30,340.4,114,8708,8822
2021/11/03,18:00,341.29,115,8696,8811
2021/11/03,18:30,340.69,117,8645,8762
2021/11/03,19:00,340.4,118,8547,8665
2021/11/03,19:30,340.4,117,8464,8581
2021/11/03,20:00,339.55,114,8334,8448
2021/11/03,20:30,340.4,75,8234,8309
2021/11/03,21:00,340.69,2,8109,8111
2021/11/03,21:30,341.29,1,7909,7910
2021/11/03,22:00,340.11,0,7650,7650
2021/11/03,22:30,341.29,0,7483,7483
2021/11/03,23:00,340.99,0,7227,7227
2021/11/03,23:30,341.9,0,6940,6940
2021/11/04,00:00,340.99,0,6681,6681
2021/11/04,00:30,337.98,0,6443,6443
2021/11/04,01:00,333.38,0,6530,6530
2021/11/04,01:30,337.98,0,6393,6393
2021/11/04,02:00,336.79,0,6240,6240
2021/11/04,02:30,338.23,0,6167,6167
2021/11/04,03:00,337.49,0,6125,6125
2021/11/04,03:30,339.83,0,6105,6105
2021/11/04,04:00,339.01,0,6148,6148
2021/11/04,04:30,339.55,0,6252,6252
2021/11/04,05:00,339.01,0,6387,6387
2021/11/04,05:30,339.55,0,6565,6565
2021/11/04,06:00,340.4,1,6559,6560
2021/11/04,06:30,339.83,14,6715,6729
2021/11/04,07:00,339.83,314,6787,7101
2021/11/04,07:30,339.28,597,6806,7403
2021/11/04,08:00,340.99,1043,6622,7665
2021/11/04,08:30,338.23,1429,6462,7891
2021/11/04,09:00,339.83,1656,6227,7883
2021/11/04,09:30,338.74,1842,6118,7960
2021/11/04,10:00,339.83,1932,6143,8075
2021/11/04,10:30,338.48,1967,6184,8151
2021/11/04,11:00,339.55,2018,6227,8245
2021/11/04,11:30,339.55,2021,6254,8275
2021/11/04,12:00,339.55,2024,6316,8340
2021/11/04,12:30,340.4,1977,6410,8387
2021/11/04,13:00,339.55,1914,6559,8473
2021/11/04,13:30,339.83,1831,6747,8578
2021/11/04,14:00,339.55,1658,6949,8607
2021/11/04,14:30,339.28,1476,7153,8629
2021/11/04,15:00,339.83,1250,7423,8673
2021/11/04,15:30,339.83,837,7765,8602
2021/11/04,16:00,339.83,461,7970,8431
2021/11/04,16:30,347.85,241,8204,8445
2021/11/04,17:00,350.02,102,8498,8600
2021/11/04,17:30,349.78,110,8685,8795
2021/11/04,18:00,350.65,114,8685,8799
2021/11/04,18:30,353.43,115,8627,8742
2021/11/04,19:00,356.33,115,8499,8614
2021/11/04,19:30,339.28,114,8385,8499
2021/11/04,20:00,340.11,114,8258,8372
2021/11/04,20:30,339.55,17,8206,8223
2021/11/04,21:00,339.55,1,8022,8023
2021/11/04,21:30,337.49,1,7784,7785
2021/11/04,22:00,341.59,1,7574,7575
2021/11/04,22:30,341.59,1,7491,7492
2021/11/04,23:00,341.59,1,7245,7246
2021/11/04,23:30,341.9,1,6943,6944
2021/11/05,00:00,339.28,2,6713,6715
2021/11/05,00:30,339.83,1,6486,6487
2021/11/05,01:00,341.9,2,6448,6450
2021/11/05,01:30,341.29,3,6288,6291
2021/11/05,02:00,341.29,3,6141,6144
2021/11/05,02:30,341.9,2,6042,6044
2021/11/05,03:00,341.59,1,5966,5967
2021/11/05,03:30,340.99,1,5949,5950
2021/11/05,04:00,341.29,1,5969,5970
2021/11/05,04:30,341.59,1,6030,6031
2021/11/05,05:00,340.99,1,6096,6097
2021/11/05,05:30,341.9,1,6168,6169
2021/11/05,06:00,341.29,1,6028,6029
2021/11/05,06:30,338.23,6,6166,6172
2021/11/05,07:00,339.83,284,6174,6458
2021/11/05,07:30,341.9,578,6128,6706
2021/11/05,08:00,341.9,851,5995,6846
2021/11/05,08:30,341.59,1266,5866,7132
2021/11/05,09:00,341.29,1565,5807,7372
2021/11/05,09:30,340.99,1751,5784,7535
2021/11/05,10:00,341.9,1881,5690,7571
2021/11/05,10:30,341.29,1955,5745,7700
2021/11/05,11:00,341.29,1991,5839,7830
2021/11/05,11:30,341.59,2004,5881,7885
2021/11/05,12:00,341.9,1996,5846,7842
2021/11/05,12:30,341.9,1961,5992,7953
2021/11/05,13:00,341.59,1892,6067,7959
2021/11/05,13:30,340.11,1775,6021,7796
2021/11/05,14:00,339.55,1656,6235,7891
2021/11/05,14:30,340.69,1476,6419,7895
2021/11/05,15:00,341.29,1169,6698,7867
2021/11/05,15:30,340.99,855,7068,7923
2021/11/05,16:00,340.4,482,7500,7982
2021/11/05,16:30,340.11,137,7694,7831
2021/11/05,17:00,340.99,0,7910,7910
2021/11/05,17:30,340.69,0,8036,8036
2021/11/05,18:00,340.69,0,7992,7992
2021/11/05,18:30,341.59,0,7888,7888
2021/11/05,19:00,341.29,0,7708,7708
2021/11/05,19:30,341.29,0,7502,7502
2021/11/05,20:00,341.29,1,7372,7373
2021/11/05,20:30,341.29,1,7358,7359
2021/11/05,21:00,341.59,3,7185,7188
2021/11/05,21:30,341.29,5,7062,7067
2021/11/05,22:00,341.59,5,6926,6931
2021/11/05,22:30,341.59,6,6787,6793
2021/11/05,23:00,341.9,6,6622,6628
2021/11/05,23:30,341.29,5,6459,6464
2021/11/06,00:00,341.9,6,6264,6270
2021/11/06,00:30,341.9,6,6123,6129
2021/11/06,01:00,341.29,5,6016,6021
2021/11/06,01:30,341.29,4,5880,5884
2021/11/06,02:00,341.29,3,5798,5801
2021/11/06,02:30,340.69,3,5748,5751
2021/11/06,03:00,339.83,3,5698,5701
2021/11/06,03:30,339.01,3,5678,5681
2021/11/06,04:00,336.56,3,5812,5815
2021/11/06,04:30,338.74,4,5858,5862
2021/11/06,05:00,340.4,4,5877,5881
2021/11/06,05:30,339.55,4,5901,5905
2021/11/06,06:00,340.99,5,5771,5776
2021/11/06,06:30,339.55,10,5678,5688
2021/11/06,07:00,339.55,260,5502,5762
2021/11/06,07:30,339.28,636,5442,6078
2021/11/06,08:00,339.83,1091,5229,6320
2021/11/06,08:30,339.01,1354,5101,6455
2021/11/06,09:00,339.83,1611,5009,6620
2021/11/06,09:30,339.55,1786,5057,6843
2021/11/06,10:00,339.28,1874,5103,6977
2021/11/06,10:30,339.28,1951,5118,7069
2021/11/06,11:00,338.74,1986,5207,7193
2021/11/06,11:30,339.28,1998,5236,7234
2021/11/06,12:00,339.01,1992,5281,7273
2021/11/06,12:30,339.83,1943,5386,7329
2021/11/06,13:00,339.28,1881,5518,7399
2021/11/06,13:30,339.55,1800,5660,7460
2021/11/06,14:00,337.98,1551,5877,7428
2021/11/06,14:30,339.01,1411,6134,7545
2021/11/06,15:00,338.48,1223,6377,7600
2021/11/06,15:30,340.11,756,6683,7439
2021/11/06,16:00,338.48,455,6862,7317
2021/11/06,16:30,339.01,228,7144,7372
2021/11/06,17:00,338.74,221,7251,7472
2021/11/06,17:30,339.28,106,7572,7678
2021/11/06,18:00,338.48,105,7633,7738
2021/11/06,18:30,339.01,62,7722,7784
2021/11/06,19:00,339.01,2,7729,7731
2021/11/06,19:30,339.01,2,7685,7687
2021/11/06,20:00,338.74,2,7620,7622
2021/11/06,20:30,337.25,2,7510,7512
2021/11/06,21:00,342.87,2,7381,7383
2021/11/06,21:30,340.69,2,7372,7374
2021/11/06,22:00,341.59,2,7257,7259
2021/11/06,22:30,341.29,2,7080,7082
2021/11/06,23:00,340.4,3,6877,6880
2021/11/06,23:30,340.99,4,6622,6626
2021/11/07,00:00,341.29,3,6347,6350
2021/11/07,00:30,340.4,3,6195,6198
2021/11/07,01:00,340.99,3,6013,6016
2021/11/07,01:30,340.69,1,5860,5861
2021/11/07,02:00,338.23,1,5815,5816
2021/11/07,02:30,341.9,1,5837,5838
2021/11/07,03:00,341.9,2,5840,5842
2021/11/07,03:30,342.54,3,5781,5784
2021/11/07,04:00,340.4,3,5847,5850
2021/11/07,04:30,341.9,3,5963,5966
2021/11/07,05:00,341.59,4,6026,6030
2021/11/07,05:30,341.9,6,6177,6183
2021/11/07,06:00,341.9,6,6208,6214
2021/11/07,06:30,337.98,12,6547,6559
2021/11/07,07:00,339.55,325,6663,6988
2021/11/07,07:30,339.28,695,6565,7260
2021/11/07,08:00,339.55,1030,6318,7348
2021/11/07,08:30,339.28,1459,6246,7705
2021/11/07,09:00,339.55,1650,6212,7862
2021/11/07,09:30,338.74,1780,6338,8118
2021/11/07,10:00,339.55,1905,6388,8293
2021/11/07,10:30,338.74,1964,6462,8426
2021/11/07,11:00,339.55,1997,6529,8526
2021/11/07,11:30,339.01,2013,6461,8474
2021/11/07,12:00,339.83,2003,6399,8402
2021/11/07,12:30,339.55,1965,6511,8476
2021/11/07,13:00,339.55,1888,6708,8596
2021/11/07,13:30,339.55,1779,6919,8698
2021/11/07,14:00,339.01,1656,7142,8798
2021/11/07,14:30,339.28,1473,7380,8853
2021/11/07,15:00,338.74,1188,7648,8836
2021/11/07,15:30,339.55,868,7979,8847
2021/11/07,16:00,333.35,475,8147,8622
2021/11/07,16:30,329.43,105,8334,8439
2021/11/07,17:00,329.13,105,8626,8731
2021/11/07,17:30,330.26,106,8713,8819
2021/11/07,18:00,329.92,108,8667,8775
2021/11/07,18:30,329.08,108,8541,8649
2021/11/07,19:00,329.08,107,8420,8527
2021/11/07,19:30,329.09,107,8316,8423
2021/11/07,20:00,329.43,107,8195,8302
2021/11/07,20:30,338.74,90,8059,8149
2021/11/07,21:00,341.59,1,7963,7964
2021/11/07,21:30,343.2,2,7747,7749
2021/11/07,22:00,341.59,3,7460,7463
2021/11/07,22:30,342.22,3,7391,7394
2021/11/07,23:00,340.69,3,7139,7142
2021/11/07,23:30,341.9,1,6887,6888
2021/11/08,00:00,341.59,2,6611,6613
2021/11/08,00:30,342.22,2,6385,6387
2021/11/08,01:00,339.28,1,6204,6205
2021/11/08,01:30,340.69,1,6054,6055
2021/11/08,02:00,341.29,1,6072,6073
2021/11/08,02:30,340.11,1,6004,6005
2021/11/08,03:00,340.4,1,5949,5950
2021/11/08,03:30,340.4,1,5920,5921
2021/11/08,04:00,340.11,1,5978,5979
2021/11/08,04:30,340.11,1,6044,6045
2021/11/08,05:00,340.4,2,6195,6197
2021/11/08,05:30,340.99,2,6343,6345
2021/11/08,06:00,339.83,2,6348,6350
2021/11/08,06:30,340.4,10,6542,6552
2021/11/08,07:00,339.01,265,6743,7008
2021/11/08,07:30,341.29,693,6681,7374
2021/11/08,08:00,341.59,1176,6380,7556
2021/11/08,08:30,340.69,1438,6376,7814
2021/11/08,09:00,340.69,1641,6370,8011
2021/11/08,09:30,340.99,1808,6424,8232
2021/11/08,10:00,340.69,1890,6459,8349
2021/11/08,10:30,340.99,1964,6487,8451
2021/11/08,11:00,340.69,2001,6554,8555
2021/11/08,11:30,339.83,2003,6639,8642
2021/11/08,12:00,340.69,1997,6712,8709
2021/11/08,12:30,339.55,1940,6724,8664
2021/11/08,13:00,340.4,1876,6762,8638
2021/11/08,13:30,340.4,1772,6978,8750
2021/11/08,14:00,340.4,1601,7189,8790
2021/11/08,14:30,339.83,1452,7447,8899
2021/11/08,15:00,340.69,1225,7721,8946
2021/11/08,15:30,383.09,812,8056,8868
2021/11/08,16:00,383.09,476,8272,8748
2021/11/08,16:30,386.13,226,8475,8701
2021/11/08,17:00,386.13,213,8631,8844
2021/11/08,17:30,387.25,104,8818,8922
2021/11/08,18:00,385.75,108,8737,8845
2021/11/08,18:30,383.09,108,8617,8725
2021/11/08,19:00,372.19,112,8483,8595
2021/11/08,19:30,376,111,8368,8479
2021/11/08,20:00,374.07,111,8211,8322
2021/11/08,20:30,371.94,78,8101,8179
2021/11/08,21:00,340.4,0,7980,7980
2021/11/08,21:30,340.69,3,7780,7783
2021/11/08,22:00,339.83,2,7509,7511
2021/11/08,22:30,340.4,2,7414,7416
2021/11/08,23:00,339.83,2,7166,7168
2021/11/08,23:30,341.9,2,6911,6913
2021/11/09,00:00,341.59,2,6646,6648
2021/11/09,00:30,341.59,2,6416,6418
2021/11/09,01:00,341.29,2,6370,6372
2021/11/09,01:30,341.29,2,6256,6258
2021/11/09,02:00,340.4,1,6142,6143
2021/11/09,02:30,340.99,1,6077,6078
2021/11/09,03:00,340.4,1,6022,6023
2021/11/09,03:30,341.59,1,6023,6024
2021/11/09,04:00,339.83,2,6155,6157
2021/11/09,04:30,339.83,1,6251,6252
2021/11/09,05:00,340.4,1,6349,6350
2021/11/09,05:30,340.4,1,6525,6526
2021/11/09,06:00,340.4,1,6512,6513
2021/11/09,06:30,340.4,10,6720,6730
2021/11/09,07:00,340.69,291,6795,7086
2021/11/09,07:30,339.83,705,6743,7448
2021/11/09,08:00,340.69,1066,6539,7605
2021/11/09,08:30,340.99,1437,6468,7905
2021/11/09,09:00,340.4,1655,6441,8096
2021/11/09,09:30,339.83,1770,6456,8226
2021/11/09,10:00,340.4,1874,6476,8350
2021/11/09,10:30,339.83,1943,6396,8339
2021/11/09,11:00,339.55,1981,6429,8410
2021/11/09,11:30,340.11,1994,6380,8374
2021/11/09,12:00,340.69,1985,6433,8418
2021/11/09,12:30,340.69,1951,6577,8528
2021/11/09,13:00,340.4,1893,6731,8624
2021/11/09,13:30,340.11,1762,6951,8713
2021/11/09,14:00,339.83,1607,7136,8743
2021/11/09,14:30,340.69,1486,7441,8927
2021/11/09,15:00,340.69,1177,7672,8849
2021/11/09,15:30,370.48,838,8052,8890
2021/11/09,16:00,370.48,519,8206,8725
2021/11/09,16:30,375.19,241,8433,8674
2021/11/09,17:00,370.48,103,8739,8842
2021/11/09,17:30,372.81,105,8773,8878
2021/11/09,18:00,372.81,105,8741,8846
2021/11/09,18:30,375.19,102,8648,8750
2021/11/09,19:00,340.4,101,8502,8603
2021/11/09,19:30,340.4,104,8427,8531
2021/11/09,20:00,340.11,56,8332,8388
2021/11/09,20:30,340.11,24,8197,8221
2021/11/09,21:00,340.69,1,8031,8032
2021/11/09,21:30,341.29,1,7798,7799
2021/11/09,22:00,340.69,1,7649,7650
2021/11/09,22:30,340.11,1,7484,7485
2021/11/09,23:00,341.29,1,7148,7149
2021/11/09,23:30,341.9,1,6866,6867
2021/11/10,00:00,340.69,1,6591,6592
2021/11/10,00:30,341.59,1,6375,6376
2021/11/10,01:00,341.59,1,6339,6340
2021/11/10,01:30,339.01,1,6190,6191
2021/11/10,02:00,337.02,1,6187,6188
2021/11/10,02:30,341.29,1,6136,6137
2021/11/10,03:00,340.99,1,6088,6089
2021/11/10,03:30,341.29,1,6063,6064
2021/11/10,04:00,340.99,1,6091,6092
2021/11/10,04:30,340.99,1,6172,6173
2021/11/10,05:00,340.4,1,6279,6280
2021/11/10,05:30,340.4,1,6456,6457
2021/11/10,06:00,340.99,1,6502,6503
2021/11/10,06:30,339.83,11,6656,6667
2021/11/10,07:00,340.69,301,6728,7029
2021/11/10,07:30,340.11,541,6702,7243
2021/11/10,08:00,340.4,915,6490,7405
2021/11/10,08:30,339.55,1339,6205,7544
2021/11/10,09:00,340.11,1595,6132,7727
2021/11/10,09:30,339.55,1764,6158,7922
2021/11/10,10:00,340.11,1880,6228,8108
2021/11/10,10:30,340.11,1943,6306,8249
2021/11/10,11:00,340.4,1983,6344,8327
2021/11/10,11:30,340.4,1992,6370,8362
2021/11/10,12:00,340.4,1991,6434,8425
2021/11/10,12:30,341.59,1960,6422,8382
2021/11/10,13:00,339.55,1836,6630,8466
2021/11/10,13:30,339.83,1795,6768,8563
2021/11/10,14:00,339.55,1677,6990,8667
2021/11/10,14:30,339.55,1406,7225,8631
2021/11/10,15:00,339.28,1172,7534,8706
2021/11/10,15:30,339.83,891,7812,8703
2021/11/10,16:00,339.28,429,8077,8506
2021/11/10,16:30,339.28,131,8251,8382
2021/11/10,17:00,340.4,95,8616,8711
2021/11/10,17:30,384.07,92,8684,8776
2021/11/10,18:00,384.14,99,8641,8740
2021/11/10,18:30,384.14,102,8594,8696
2021/11/10,19:00,382.13,101,8472,8573
2021/11/10,19:30,386.22,97,8342,8439
2021/11/10,20:00,382.13,45,8282,8327
2021/11/10,20:30,384.06,3,8187,8190
2021/11/10,21:00,386.22,7,7938,7945
2021/11/10,21:30,386.22,6,7780,7786
2021/11/10,22:00,381.88,7,7604,7611
2021/11/10,22:30,386.22,11,7392,7403
2021/11/10,23:00,378.92,11,7145,7156
2021/11/10,23:30,386.22,10,6848,6858
2021/11/11,00:00,339.83,10,6614,6624
2021/11/11,00:30,339.01,5,6353,6358
2021/11/11,01:00,339.28,5,6148,6153
2021/11/11,01:30,339.83,5,6011,6016
2021/11/11,02:00,341.9,1,6022,6023
2021/11/11,02:30,341.9,1,6000,6001
2021/11/11,03:00,341.59,1,5938,5939
2021/11/11,03:30,341.9,1,5902,5903
2021/11/11,04:00,341.59,1,5987,5988
2021/11/11,04:30,341.29,1,6092,6093
2021/11/11,05:00,342.22,1,6156,6157
2021/11/11,05:30,338.23,1,6234,6235
2021/11/11,06:00,339.55,1,6233,6234
2021/11/11,06:30,336.34,4,6569,6573
2021/11/11,07:00,336.13,262,6835,7097
2021/11/11,07:30,340.11,566,6840,7406
2021/11/11,08:00,341.59,771,6705,7476
2021/11/11,08:30,339.55,1026,6503,7529
2021/11/11,09:00,340.99,1372,6415,7787
2021/11/11,09:30,340.69,1517,6317,7834
2021/11/11,10:00,342.22,1722,6239,7961
2021/11/11,10:30,341.29,1567,6328,7895
2021/11/11,11:00,341.59,1729,6217,7946
2021/11/11,11:30,340.4,1703,6284,7987
2021/11/11,12:00,341.29,1746,6284,8030
2021/11/11,12:30,340.69,1630,6383,8013
2021/11/11,13:00,341.29,1624,6584,8208
2021/11/11,13:30,341.29,1599,6713,8312
2021/11/11,14:00,340.4,1458,6834,8292
2021/11/11,14:30,341.59,1314,6930,8244
2021/11/11,15:00,340.99,1062,7043,8105
2021/11/11,15:30,342.22,727,7324,8051
2021/11/11,16:00,341.29,418,7554,7972
2021/11/11,16:30,383.93,281,7785,8066
2021/11/11,17:00,383.98,137,8178,8315
2021/11/11,17:30,380,138,8296,8434
2021/11/11,18:00,384.14,138,8311,8449
2021/11/11,18:30,386.22,138,8260,8398
2021/11/11,19:00,386.22,140,8202,8342
2021/11/11,19:30,386.22,140,8106,8246
2021/11/11,20:00,386.22,126,7970,8096
2021/11/11,20:30,381.98,0,8051,8051
2021/11/11,21:00,386.22,0,7866,7866
2021/11/11,21:30,340.99,0,7690,7690
2021/11/11,22:00,340.4,0,7500,7500
2021/11/11,22:30,339.83,0,7293,7293
2021/11/11,23:00,341.29,0,7040,7040
2021/11/11,23:30,339.83,1,6740,6741
2021/11/12,00:00,341.9,1,6467,6468
2021/11/12,00:30,339.55,1,6290,6291
2021/11/12,01:00,340.69,1,6091,6092
2021/11/12,01:30,337.49,2,5903,5905
2021/11/12,02:00,340.69,3,5788,5791
2021/11/12,02:30,339.83,3,5683,5686
2021/11/12,03:00,340.69,3,5573,5576
2021/11/12,03:30,341.29,3,5564,5567
2021/11/12,04:00,340.69,2,5612,5614
2021/11/12,04:30,341.9,3,5624,5627
2021/11/12,05:00,340.69,4,5729,5733
2021/11/12,05:30,341.29,3,5873,5876
2021/11/12,06:00,341.29,6,5822,5828
2021/11/12,06:30,341.59,142,6017,6159
2021/11/12,07:00,340.99,275,6074,6349
2021/11/12,07:30,340.69,570,6061,6631
2021/11/12,08:00,339.83,955,5826,6781
2021/11/12,08:30,340.11,1327,5710,7037
2021/11/12,09:00,340.99,1569,5655,7224
2021/11/12,09:30,340.99,1670,5585,7255
2021/11/12,10:00,341.29,1854,5540,7394
2021/11/12,10:30,341.29,1878,5614,7492
2021/11/12,11:00,340.99,1909,5648,7557
2021/11/12,11:30,340.69,1864,5696,7560
2021/11/12,12:00,341.29,1758,5727,7485
2021/11/12,12:30,340.99,1750,5825,7575
2021/11/12,13:00,341.29,1533,5948,7481
2021/11/12,13:30,340.4,1229,6273,7502
2021/11/12,14:00,339.01,1057,6175,7232
2021/11/12,14:30,340.11,775,6418,7193
2021/11/12,15:00,340.99,480,6736,7216
2021/11/12,15:30,340.69,360,7021,7381
2021/11/12,16:00,342.54,180,7327,7507
2021/11/12,16:30,341.59,2,7382,7384
2021/11/12,17:00,342.22,3,7646,7649
2021/11/12,17:30,339.55,3,7722,7725
2021/11/12,18:00,340.69,3,7641,7644
2021/11/12,18:30,339.01,3,7525,7528
2021/11/12,19:00,339.83,3,7396,7399
2021/11/12,19:30,339.28,4,7238,7242
2021/11/12,20:00,340.99,3,7087,7090
2021/11/12,20:30,340.11,4,6975,6979
2021/11/12,21:00,339.83,3,6902,6905
2021/11/12,21:30,340.11,6,6825,6831
2021/11/12,22:00,340.4,6,6686,6692
2021/11/12,22:30,340.4,6,6612,6618
2021/11/12,23:00,340.4,6,6400,6406
2021/11/12,23:30,340.69,6,6253,6259
2021/11/13,00:00,337.98,6,6112,6118
2021/11/13,00:30,340.99,6,5882,5888
2021/11/13,01:00,341.29,6,5925,5931
2021/11/13,01:30,341.9,6,5989,5995
2021/11/13,02:00,341.29,6,5904,5910
2021/11/13,02:30,341.59,6,5862,5868
2021/11/13,03:00,340.4,8,5777,5785
2021/11/13,03:30,340.69,7,5805,5812
2021/11/13,04:00,341.29,7,5780,5787
2021/11/13,04:30,340.11,8,5839,5847
2021/11/13,05:00,340.99,10,5909,5919
2021/11/13,05:30,341.59,9,5901,5910
2021/11/13,06:00,340.69,10,5882,5892
2021/11/13,06:30,341.29,11,5725,5736
2021/11/13,07:00,340.99,176,5602,5778
2021/11/13,07:30,341.59,410,5506,5916
2021/11/13,08:00,340.11,824,5299,6123
2021/11/13,08:30,340.4,1095,5192,6287
2021/11/13,09:00,340.4,1287,5145,6432
2021/11/13,09:30,340.4,1537,5062,6599
2021/11/13,10:00,339.83,1529,5188,6717
2021/11/13,10:30,341.59,1511,5312,6823
2021/11/13,11:00,340.11,1401,5406,6807
2021/11/13,11:30,338.48,1218,5331,6549
2021/11/13,12:00,338.23,1061,5473,6534
2021/11/13,12:30,339.83,978,5647,6625
2021/11/13,13:00,338.48,852,5810,6662
2021/11/13,13:30,339.55,725,5962,6687
2021/11/13,14:00,338.23,639,6099,6738
2021/11/13,14:30,339.28,396,6291,6687
2021/11/13,15:00,338.74,269,6494,6763
2021/11/13,15:30,341.59,182,6628,6810
2021/11/13,16:00,341.29,95,6849,6944
2021/11/13,16:30,341.59,7,7095,7102
2021/11/13,17:00,386.22,5,7469,7474
2021/11/13,17:30,381.18,4,7668,7672
2021/11/13,18:00,381.18,4,7821,7825
2021/11/13,18:30,381.18,5,7867,7872
2021/11/13,19:00,381.18,5,7804,7809
2021/11/13,19:30,386.22,3,7737,7740
2021/11/13,20:00,381.18,3,7641,7644
2021/11/13,20:30,386.22,2,7558,7560
2021/11/13,21:00,377.79,1,7427,7428
2021/11/13,21:30,331.83,3,7277,7280
2021/11/13,22:00,331.48,3,7094,7097
2021/11/13,22:30,332.07,4,6927,6931
2021/11/13,23:00,331.83,3,6734,6737
2021/11/13,23:30,331.6,3,6488,6491
2021/11/14,00:00,332.07,3,6240,6243
2021/11/14,00:30,331.83,3,6163,6166
2021/11/14,01:00,331.83,3,5985,5988
2021/11/14,01:30,332.47,3,5846,5849
2021/11/14,02:00,331.6,3,5900,5903
2021/11/14,02:30,331.48,4,5809,5813
2021/11/14,03:00,331.95,4,5767,5771
2021/11/14,03:30,331.6,3,5789,5792
2021/11/14,04:00,331.83,3,5813,5816
2021/11/14,04:30,331.71,3,5925,5928
2021/11/14,05:00,331.17,3,6075,6078
2021/11/14,05:30,331.71,3,6284,6287
2021/11/14,06:00,332.33,3,6350,6353
2021/11/14,06:30,331.71,4,6579,6583
2021/11/14,07:00,332.2,144,6863,7007
2021/11/14,07:30,331.48,256,7146,7402
2021/11/14,08:00,330.29,363,6856,7219
2021/11/14,08:30,331.71,419,6964,7383
2021/11/14,09:00,331.71,705,6889,7594
2021/11/14,09:30,331.17,811,6994,7805
2021/11/14,10:00,332.33,1101,6846,7947
2021/11/14,10:30,331.6,1324,6763,8087
2021/11/14,11:00,331.71,1481,6728,8209
2021/11/14,11:30,332.2,1501,6706,8207
2021/11/14,12:00,340.11,1544,6773,8317
2021/11/14,12:30,341.59,1361,6867,8228
2021/11/14,13:00,340.4,1312,7063,8375
2021/11/14,13:30,339.28,1160,7155,8315
2021/11/14,14:00,338.74,1065,7325,8390
2021/11/14,14:30,337.98,721,7589,8310
2021/11/14,15:00,337.98,602,7688,8290
2021/11/14,15:30,383.62,533,7782,8315
2021/11/14,16:00,383.62,338,7929,8267
2021/11/14,16:30,383.62,147,8144,8291
2021/11/14,17:00,386.12,148,8483,8631
2021/11/14,17:30,386.12,148,8564,8712
2021/11/14,18:00,383.62,150,8553,8703
2021/11/14,18:30,383.62,149,8448,8597
2021/11/14,19:00,386.15,146,8341,8487
2021/11/14,19:30,383.62,93,8329,8422
2021/11/14,20:00,386.15,15,8266,8281
2021/11/14,20:30,375.45,8,8207,8215
2021/11/14,21:00,340.69,6,8044,8050
2021/11/14,21:30,341.9,3,7857,7860
2021/11/14,22:00,340.69,3,7658,7661
2021/11/14,22:30,341.9,3,7438,7441
2021/11/14,23:00,341.59,3,7138,7141
2021/11/14,23:30,338.74,3,6874,6877
2021/11/15,00:00,337.02,3,6597,6600
2021/11/15,00:30,337.49,3,6328,6331
2021/11/15,01:00,337.49,3,6081,6084
2021/11/15,01:30,336.34,3,6127,6130
2021/11/15,02:00,336.13,3,6111,6114
2021/11/15,02:30,335.71,3,6048,6051
2021/11/15,03:00,335.3,3,5982,5985
2021/11/15,03:30,335.91,3,5992,5995
2021/11/15,04:00,334.54,3,6054,6057
2021/11/15,04:30,335.3,3,6144,6147
2021/11/15,05:00,335.1,3,6298,6301
2021/11/15,05:30,335.71,3,6439,6442
2021/11/15,06:00,336.13,3,6520,6523
2021/11/15,06:30,335.3,3,6672,6675
2021/11/15,07:00,335.5,144,6780,6924
2021/11/15,07:30,341.59,398,6724,7122
2021/11/15,08:00,342.22,764,6507,7271
2021/11/15,08:30,341.9,1053,6458,7511
2021/11/15,09:00,341.59,1321,6372,7693
2021/11/15,09:30,341.9,1556,6324,7880
2021/11/15,10:00,339.83,1660,6345,8005
2021/11/15,10:30,342.54,1730,6249,7979
2021/11/15,11:00,342.87,1813,6263,8076
2021/11/15,11:30,341.9,1834,6304,8138
2021/11/15,12:00,342.22,1827,6325,8152
2021/11/15,12:30,342.22,1763,6433,8196
2021/11/15,13:00,341.9,1699,6618,8317
2021/11/15,13:30,342.22,1585,6638,8223
2021/11/15,14:00,338.48,1384,6847,8231
2021/11/15,14:30,342.54,1184,7084,8268
2021/11/15,15:00,341.9,916,7398,8314
2021/11/15,15:30,341.9,538,7640,8178
2021/11/15,16:00,341.9,293,7854,8147
2021/11/15,16:30,341.59,181,8100,8281
2021/11/15,17:00,341.29,102,8419,8521
2021/11/15,17:30,340.99,104,8553,8657
2021/11/15,18:00,340.69,85,8546,8631
2021/11/15,18:30,339.55,2,8591,8593
2021/11/15,19:00,340.11,1,8485,8486
2021/11/15,19:30,340.4,1,8396,8397
2021/11/15,20:00,340.69,1,8269,8270
2021/11/15,20:30,340.4,1,8222,8223
2021/11/15,21:00,340.4,1,8027,8028
2021/11/15,21:30,340.99,1,7866,7867
2021/11/15,22:00,340.4,1,7620,7621
2021/11/15,22:30,341.29,1,7399,7400
2021/11/15,23:00,340.4,1,7124,7125
2021/11/15,23:30,341.9,0,6789,6789
2021/11/16,00:00,339.83,0,6497,6497
2021/11/16,00:30,340.99,0,6241,6241
2021/11/16,01:00,338.74,0,6082,6082
2021/11/16,01:30,339.83,0,6047,6047
2021/11/16,02:00,338.74,0,6067,6067
2021/11/16,02:30,340.69,0,6030,6030
2021/11/16,03:00,339.01,0,5993,5993
2021/11/16,03:30,342.22,0,5922,5922
2021/11/16,04:00,339.55,0,6020,6020
2021/11/16,04:30,339.01,0,6112,6112
2021/11/16,05:00,340.4,0,6202,6202
2021/11/16,05:30,339.55,0,6443,6443
2021/11/16,06:00,340.4,0,6481,6481
2021/11/16,06:30,340.99,0,6703,6703
2021/11/16,07:00,340.69,144,6910,7054
2021/11/16,07:30,340.69,319,7038,7357
2021/11/16,08:00,341.29,529,6779,7308
2021/11/16,08:30,340.4,796,6721,7517
2021/11/16,09:00,341.9,1218,6479,7697
2021/11/16,09:30,339.83,1416,6392,7808
2021/11/16,10:00,340.99,1630,6332,7962
2021/11/16,10:30,339.28,1760,6309,8069
2021/11/16,11:00,342.54,1824,6269,8093
2021/11/16,11:30,339.01,1847,6269,8116
2021/11/16,12:00,339.28,1821,6058,7879
2021/11/16,12:30,339.55,1772,6156,7928
2021/11/16,13:00,339.01,1568,6438,8006
2021/11/16,13:30,339.55,1185,6858,8043
2021/11/16,14:00,339.28,951,7069,8020
2021/11/16,14:30,339.83,761,7392,8153
2021/11/16,15:00,339.55,558,7547,8105
2021/11/16,15:30,339.28,345,7749,8094
2021/11/16,16:00,339.01,250,7874,8124
2021/11/16,16:30,339.01,141,8090,8231
2021/11/16,17:00,338.74,142,8468,8610
2021/11/16,17:30,339.01,141,8561,8702
2021/11/16,18:00,338.48,132,8567,8699
2021/11/16,18:30,339.28,32,8607,8639
2021/11/16,19:00,339.55,32,8527,8559
2021/11/16,19:30,339.28,32,8418,8450
2021/11/16,20:00,339.55,31,8290,8321
2021/11/16,20:30,340.99,30,8283,8313
2021/11/16,21:00,339.55,29,8103,8132
2021/11/16,21:30,340.4,30,7901,7931
2021/11/16,22:00,339.83,29,7676,7705
2021/11/16,22:30,340.69,0,7464,7464
2021/11/16,23:00,340.4,0,7208,7208
2021/11/16,23:30,341.29,1,6851,6852
2021/11/17,00:00,340.99,1,6592,6593
2021/11/17,00:30,339.83,1,6331,6332
2021/11/17,01:00,339.55,1,6048,6049
2021/11/17,01:30,338.74,1,5964,5965
2021/11/17,02:00,339.28,1,5827,5828
2021/11/17,02:30,339.83,1,5710,5711
2021/11/17,03:00,339.01,1,5708,5709
2021/11/17,03:30,340.99,1,5691,5692
2021/11/17,04:00,340.11,1,5697,5698
2021/11/17,04:30,341.59,1,5841,5842
2021/11/17,05:00,338.74,1,5986,5987
2021/11/17,05:30,342.22,1,6163,6164
2021/11/17,06:00,340.4,2,6250,6252
2021/11/17,06:30,341.9,2,6480,6482
2021/11/17,07:00,340.69,114,6737,6851
2021/11/17,07:30,341.29,313,6800,7113
2021/11/17,08:00,339.83,427,6736,7163
2021/11/17,08:30,340.69,545,6797,7342
2021/11/17,09:00,340.11,675,6753,7428
2021/11/17,09:30,340.99,905,6702,7607
2021/11/17,10:00,336.79,1217,6714,7931
2021/11/17,10:30,340.69,1333,6620,7953
2021/11/17,11:00,341.29,1641,6471,8112
2021/11/17,11:30,340.99,1600,6580,8180
2021/11/17,12:00,340.99,1587,6575,8162
2021/11/17,12:30,339.83,1447,6728,8175
2021/11/17,13:00,341.29,1518,6753,8271
2021/11/17,13:30,339.83,1395,6941,8336
2021/11/17,14:00,340.11,1248,7133,8381
2021/11/17,14:30,340.4,1013,7374,8387
2021/11/17,15:00,340.4,836,7596,8432
2021/11/17,15:30,339.83,491,7844,8335
2021/11/17,16:00,339.28,303,7847,8150
2021/11/17,16:30,340.4,108,8113,8221
2021/11/17,17:00,339.28,109,8496,8605
2021/11/17,17:30,339.83,114,8616,8730
2021/11/17,18:00,341.9,114,8617,8731
2021/11/17,18:30,341.29,114,8586,8700
2021/11/17,19:00,341.59,113,8487,8600
2021/11/17,19:30,340.99,113,8415,8528
2021/11/17,20:00,341.9,112,8278,8390
2021/11/17,20:30,341.29,111,8215,8326
2021/11/17,21:00,341.59,86,8059,8145
2021/11/17,21:30,342.22,32,7900,7932
2021/11/17,22:00,340.99,1,7665,7666
2021/11/17,22:30,341.29,1,7398,7399
2021/11/17,23:00,340.4,1,7126,7127
2021/11/17,23:30,341.29,1,6799,6800
2021/11/18,00:00,341.59,0,6545,6545
2021/11/18,00:30,341.9,0,6281,6281
2021/11/18,01:00,341.59,0,6036,6036
2021/11/18,01:30,341.29,1,5900,5901
2021/11/18,02:00,341.29,1,5753,5754
2021/11/18,02:30,339.83,1,5684,5685
2021/11/18,03:00,341.29,1,5675,5676
2021/11/18,03:30,340.11,1,5663,5664
2021/11/18,04:00,342.22,1,5671,5672
2021/11/18,04:30,340.99,1,5790,5791
2021/11/18,05:00,340.4,1,5963,5964
2021/11/18,05:30,341.9,1,6156,6157
2021/11/18,06:00,340.69,1,6238,6239
2021/11/18,06:30,341.9,1,6425,6426
2021/11/18,07:00,340.69,123,6662,6785
2021/11/18,07:30,341.29,364,6697,7061
2021/11/18,08:00,341.29,728,6474,7202
2021/11/18,08:30,340.99,1003,6383,7386
2021/11/18,09:00,340.99,1278,6255,7533
2021/11/18,09:30,341.29,1482,6218,7700
2021/11/18,10:00,340.99,1530,6263,7793
2021/11/18,10:30,341.29,1424,6313,7737
2021/11/18,11:00,341.29,1422,6364,7786
2021/11/18,11:30,341.29,1468,6251,7719
2021/11/18,12:00,342.22,1361,6361,7722
2021/11/18,12:30,342.54,1159,6606,7765
2021/11/18,13:00,342.22,1161,6684,7845
2021/11/18,13:30,341.9,1194,6898,8092
2021/11/18,14:00,341.9,935,7098,8033
2021/11/18,14:30,342.54,657,7413,8070
2021/11/18,15:00,341.9,552,7501,8053
2021/11/18,15:30,342.54,411,7696,8107
2021/11/18,16:00,341.9,247,7836,8083
2021/11/18,16:30,341.9,264,7964,8228
2021/11/18,17:00,330.78,107,8505,8612
2021/11/18,17:30,330.22,107,8629,8736
2021/11/18,18:00,329.96,107,8652,8759
2021/11/18,18:30,330.09,108,8618,8726
2021/11/18,19:00,342.54,107,8518,8625
2021/11/18,19:30,341.9,106,8391,8497
2021/11/18,20:00,341.9,107,8240,8347
2021/11/18,20:30,341.9,106,8212,8318
2021/11/18,21:00,339.83,105,8100,8205
2021/11/18,21:30,339.83,84,7887,7971
2021/11/18,22:00,340.69,37,7609,7646
2021/11/18,22:30,339.83,2,7421,7423
2021/11/18,23:00,340.11,3,7194,7197
2021/11/18,23:30,339.83,3,6895,6898
2021/11/19,00:00,339.83,1,6616,6617
2021/11/19,00:30,340.99,2,6365,6367
2021/11/19,01:00,340.99,1,6112,6113
2021/11/19,01:30,333.67,0,6234,6234
2021/11/19,02:00,336.34,0,6114,6114
2021/11/19,02:30,334.72,0,5983,5983
2021/11/19,03:00,335.5,1,5900,5901
2021/11/19,03:30,334.91,0,5848,5848
2021/11/19,04:00,335.1,0,5910,5910
2021/11/19,04:30,335.71,0,5797,5797
2021/11/19,05:00,336.56,0,5895,5895
2021/11/19,05:30,335.91,1,5992,5993
2021/11/19,06:00,336.56,2,6159,6161
2021/11/19,06:30,336.56,0,6130,6130
2021/11/19,07:00,336.34,143,6294,6437
2021/11/19,07:30,334.91,254,6470,6724
2021/11/19,08:00,339.01,494,6381,6875
2021/11/19,08:30,336.13,628,6501,7129
2021/11/19,09:00,337.73,599,6738,7337
2021/11/19,09:30,335.5,608,6984,7592
2021/11/19,10:00,336.79,860,7017,7877
2021/11/19,10:30,336.56,816,7270,8086
2021/11/19,11:00,373.55,794,7379,8173
2021/11/19,11:30,364.23,861,7241,8102
2021/11/19,12:00,380.39,960,7108,8068
2021/11/19,12:30,376.08,769,7031,7800
2021/11/19,13:00,378.64,797,7076,7873
2021/11/19,13:30,376.1,647,7291,7938
2021/11/19,14:00,380.39,676,7344,8020
2021/11/19,14:30,380.39,636,7372,8008
2021/11/19,15:00,380.39,539,7452,7991
2021/11/19,15:30,378.68,442,7570,8012
2021/11/19,16:00,380.39,270,7681,7951
2021/11/19,16:30,376.47,13,7628,7641
2021/11/19,17:00,380.39,2,7922,7924
2021/11/19,17:30,378.8,2,8076,8078
2021/11/19,18:00,374.2,3,7964,7967
2021/11/19,18:30,378.8,1,7803,7804
2021/11/19,19:00,341.59,1,7582,7583
2021/11/19,19:30,341.59,4,7442,7446
2021/11/19,20:00,342.54,6,7266,7272
2021/11/19,20:30,341.9,8,7171,7179
2021/11/19,21:00,341.9,4,7065,7069
2021/11/19,21:30,341.9,1,6961,6962
2021/11/19,22:00,341.9,0,6800,6800
2021/11/19,22:30,341.9,2,6634,6636
2021/11/19,23:00,341.9,3,6463,6466
2021/11/19,23:30,341.59,2,6226,6228
2021/11/20,00:00,339.01,2,6032,6034
2021/11/20,00:30,336.34,3,5863,5866
2021/11/20,01:00,336.13,2,6010,6012
2021/11/20,01:30,340.11,1,5858,5859
2021/11/20,02:00,339.01,1,5773,5774
2021/11/20,02:30,340.4,1,5714,5715
2021/11/20,03:00,339.01,2,5688,5690
2021/11/20,03:30,339.55,2,5677,5679
2021/11/20,04:00,338.74,1,5674,5675
2021/11/20,04:30,339.83,1,5729,5730
2021/11/20,05:00,337.98,2,5792,5794
2021/11/20,05:30,339.83,2,5859,5861
2021/11/20,06:00,339.83,2,5839,5841
2021/11/20,06:30,339.55,2,5757,5759
2021/11/20,07:00,339.83,144,5712,5856
2021/11/20,07:30,339.28,439,5738,6177
2021/11/20,08:00,340.99,678,5739,6417
2021/11/20,08:30,338.48,872,5867,6739
2021/11/20,09:00,337.02,971,5982,6953
2021/11/20,09:30,337.02,1160,6093,7253
2021/11/20,10:00,338.48,938,6120,7058
2021/11/20,10:30,340.69,1316,6063,7379
2021/11/20,11:00,342.22,1483,6071,7554
2021/11/20,11:30,339.28,1672,6013,7685
2021/11/20,12:00,339.28,1495,6116,7611
2021/11/20,12:30,335.1,1370,6222,7592
2021/11/20,13:00,341.59,1330,6225,7555
2021/11/20,13:30,337.98,1215,6223,7438
2021/11/20,14:00,341.9,824,6322,7146
2021/11/20,14:30,340.11,742,6407,7149
2021/11/20,15:00,341.29,543,6661,7204
2021/11/20,15:30,340.11,393,6689,7082
2021/11/20,16:00,341.59,142,7041,7183
2021/11/20,16:30,376.09,152,7181,7333
2021/11/20,17:00,378.41,0,7770,7770
2021/11/20,17:30,378.41,0,8191,8191
2021/11/20,18:00,376.09,0,8490,8490
2021/11/20,18:30,376.09,0,8631,8631
2021/11/20,19:00,376.03,0,8606,8606
2021/11/20,19:30,378.39,0,8513,8513
2021/11/20,20:00,376.03,5,8408,8413
2021/11/20,20:30,378.37,5,8254,8259
2021/11/20,21:00,378.37,0,8047,8047
2021/11/20,21:30,374.48,1,7847,7848
2021/11/20,22:00,371.81,0,7585,7585
2021/11/20,22:30,340.99,1,7344,7345
2021/11/20,23:00,340.4,0,7075,7075
2021/11/20,23:30,340.99,1,6726,6727
2021/11/21,00:00,340.99,1,6382,6383
2021/11/21,00:30,341.9,1,6075,6076
2021/11/21,01:00,339.01,1,5838,5839
2021/11/21,01:30,339.28,0,5634,5634
2021/11/21,02:00,336.56,0,5619,5619
2021/11/21,02:30,335.5,0,5659,5659
2021/11/21,03:00,335.5,0,5646,5646
2021/11/21,03:30,335.3,0,5651,5651
2021/11/21,04:00,335.1,1,5697,5698
2021/11/21,04:30,335.91,0,5811,5811
2021/11/21,05:00,340.11,0,6002,6002
2021/11/21,05:30,342.54,0,6222,6222
2021/11/21,06:00,340.99,1,6365,6366
2021/11/21,06:30,341.9,3,6667,6670
2021/11/21,07:00,337.25,18,6901,6919
2021/11/21,07:30,336.34,174,7125,7299
2021/11/21,08:00,337.02,278,7026,7304
2021/11/21,08:30,336.56,457,6960,7417
2021/11/21,09:00,336.13,502,6969,7471
2021/11/21,09:30,336.79,702,6853,7555
2021/11/21,10:00,337.73,1000,6871,7871
2021/11/21,10:30,334.54,1224,6693,7917
2021/11/21,11:00,337.49,1446,6613,8059
2021/11/21,11:30,336.13,1400,6684,8084
2021/11/21,12:00,337.02,1367,6771,8138
2021/11/21,12:30,338.48,1316,6832,8148
2021/11/21,13:00,339.01,1281,6738,8019
2021/11/21,13:30,338.48,1173,6796,7969
2021/11/21,14:00,339.28,932,7074,8006
2021/11/21,14:30,338.48,639,7284,7923
2021/11/21,15:00,339.01,532,7427,7959
2021/11/21,15:30,338.48,397,7693,8090
2021/11/21,16:00,338.74,283,7942,8225
2021/11/21,16:30,338.23,112,8315,8427
2021/11/21,17:00,339.01,112,8849,8961
2021/11/21,17:30,334.91,113,9109,9222
2021/11/21,18:00,329.9,111,9212,9323
2021/11/21,18:30,329.09,110,9260,9370
2021/11/21,19:00,329.14,111,9204,9315
2021/11/21,19:30,333.19,110,9152,9262
2021/11/21,20:00,340.69,109,9041,9150
2021/11/21,20:30,339.83,108,8860,8968
2021/11/21,21:00,377.81,74,8666,8740
2021/11/21,21:30,375.44,38,8576,8614
2021/11/21,22:00,359.26,0,8238,8238
2021/11/21,22:30,340.4,0,7995,7995
2021/11/21,23:00,340.99,0,7607,7607
2021/11/21,23:30,340.4,0,7163,7163
2021/11/22,00:00,341.29,0,6757,6757
2021/11/22,00:30,340.11,0,6404,6404
2021/11/22,01:00,341.59,0,6165,6165
2021/11/22,01:30,340.4,0,5928,5928
2021/11/22,02:00,342.22,0,5781,5781
2021/11/22,02:30,340.4,0,5872,5872
2021/11/22,03:00,341.29,0,5795,5795
2021/11/22,03:30,340.69,0,5802,5802
2021/11/22,04:00,341.9,0,5819,5819
2021/11/22,04:30,340.4,0,5937,5937
2021/11/22,05:00,341.29,0,6114,6114
2021/11/22,05:30,340.11,0,6398,6398
2021/11/22,06:00,340.99,1,6621,6622
2021/11/22,06:30,403.01,1,6878,6879
2021/11/22,07:00,406.22,165,7119,7284
2021/11/22,07:30,403.01,430,7148,7578
2021/11/22,08:00,340.99,740,6723,7463
2021/11/22,08:30,341.9,1152,6535,7687
2021/11/22,09:00,340.69,1469,6239,7708
2021/11/22,09:30,341.29,1618,6126,7744
2021/11/22,10:00,337.49,1737,6038,7775
2021/11/22,10:30,335.71,1857,5908,7765
2021/11/22,11:00,335.1,1917,5820,7737
2021/11/22,11:30,340.99,1923,5821,7744
2021/11/22,12:00,340.4,1930,5888,7818
2021/11/22,12:30,340.69,1863,5966,7829
2021/11/22,13:00,341.29,1821,6116,7937
2021/11/22,13:30,341.29,1697,6295,7992
2021/11/22,14:00,340.69,1439,6659,8098
2021/11/22,14:30,340.69,1258,6832,8090
2021/11/22,15:00,339.83,1034,7127,8161
2021/11/22,15:30,337.73,682,7334,8016
2021/11/22,16:00,383.73,412,7706,8118
2021/11/22,16:30,417.53,201,8198,8399
2021/11/22,17:00,401.37,102,8746,8848
2021/11/22,17:30,386.13,103,8985,9088
2021/11/22,18:00,2067.47,105,9132,9237
2021/11/22,18:30,2090.34,105,9192,9297
2021/11/22,19:00,2045.61,105,9127,9232
2021/11/22,19:30,403.55,104,9117,9221
2021/11/22,20:00,403.55,104,8989,9093
2021/11/22,20:30,403.29,104,8922,9026
2021/11/22,21:00,406.22,69,8750,8819
2021/11/22,21:30,438.04,36,8521,8557
2021/11/22,22:00,434.1,0,8284,8284
2021/11/22,22:30,438.04,0,8021,8021
2021/11/22,23:00,384.6,0,7633,7633
2021/11/22,23:30,340.4,0,7188,7188
2021/11/23,00:00,340.69,0,6815,6815
2021/11/23,00:30,341.29,0,6429,6429
2021/11/23,01:00,341.29,0,6222,6222
2021/11/23,01:30,340.4,0,6052,6052
2021/11/23,02:00,341.29,0,5859,5859
2021/11/23,02:30,340.4,0,5939,5939
2021/11/23,03:00,340.99,0,6023,6023
2021/11/23,03:30,339.55,0,6055,6055
2021/11/23,04:00,341.9,0,6040,6040
2021/11/23,04:30,340.69,0,6205,6205
2021/11/23,05:00,341.59,0,6400,6400
2021/11/23,05:30,340.4,0,6640,6640
2021/11/23,06:00,340.99,1,6680,6681
2021/11/23,06:30,340.11,0,6924,6924
2021/11/23,07:00,342.54,154,7023,7177
2021/11/23,07:30,341.9,440,6909,7349
2021/11/23,08:00,341.59,900,6416,7316
2021/11/23,08:30,386.22,1265,6418,7683
2021/11/23,09:00,336.34,1487,6151,7638
2021/11/23,09:30,336.13,1676,6026,7702
2021/11/23,10:00,339.28,1791,5894,7685
2021/11/23,10:30,340.69,1857,5831,7688
2021/11/23,11:00,336.13,1900,5780,7680
2021/11/23,11:30,340.99,1928,5731,7659
2021/11/23,12:00,340.99,1920,5750,7670
2021/11/23,12:30,340.69,1895,5833,7728
2021/11/23,13:00,340.69,1813,5986,7799
2021/11/23,13:30,339.83,1711,5916,7627
2021/11/23,14:00,341.29,1587,6132,7719
2021/11/23,14:30,386.22,1364,6458,7822
2021/11/23,15:00,406.18,1073,6794,7867
2021/11/23,15:30,407.53,753,7227,7980
2021/11/23,16:00,406.32,448,7585,8033
2021/11/23,16:30,383.44,99,8022,8121
2021/11/23,17:00,2008.05,103,8592,8695
2021/11/23,17:30,2114.23,104,8814,8918
2021/11/23,18:00,2114.23,104,8918,9022
2021/11/23,18:30,2090.34,104,8952,9056
2021/11/23,19:00,2114.23,104,8934,9038
2021/11/23,19:30,329.87,105,8898,9003
2021/11/23,20:00,329.74,105,8782,8887
2021/11/23,20:30,342.87,73,8673,8746
2021/11/23,21:00,341.59,0,8592,8592
2021/11/23,21:30,341.9,1,8358,8359
2021/11/23,22:00,386.55,1,8108,8109
2021/11/23,22:30,341.9,1,7796,7797
2021/11/23,23:00,341.9,1,7461,7462
2021/11/23,23:30,341.9,1,7122,7123
2021/11/24,00:00,341.9,1,6748,6749
2021/11/24,00:30,335.5,1,6469,6470
2021/11/24,01:00,337.02,1,6361,6362
2021/11/24,01:30,334.18,1,6317,6318
2021/11/24,02:00,334.91,1,6104,6105
2021/11/24,02:30,337.73,1,6077,6078
2021/11/24,03:00,337.02,1,6025,6026
2021/11/24,03:30,339.01,1,5955,5956
2021/11/24,04:00,362.04,1,6029,6030
2021/11/24,04:30,362.04,1,6148,6149
2021/11/24,05:00,335.1,1,6300,6301
2021/11/24,05:30,338.72,1,6588,6589
2021/11/24,06:00,380.6,1,6779,6780
2021/11/24,06:30,340.87,23,7044,7067
2021/11/24,07:00,340.4,160,7291,7451
2021/11/24,07:30,346.15,466,7252,7718
2021/11/24,08:00,386.22,794,6846,7640
2021/11/24,08:30,377.92,1167,6313,7480
2021/11/24,09:00,339.55,1520,6067,7587
2021/11/24,09:30,340.11,1673,5849,7522
2021/11/24,10:00,340.4,1770,5755,7525
2021/11/24,10:30,340.11,1858,5671,7529
2021/11/24,11:00,339.28,1881,5648,7529
2021/11/24,11:30,339.01,1882,5706,7588
2021/11/24,12:00,336.56,1874,5583,7457
2021/11/24,12:30,340.69,1793,5637,7430
2021/11/24,13:00,341.29,1706,5888,7594
2021/11/24,13:30,340.69,1537,6148,7685
2021/11/24,14:00,341.59,1160,6530,7690
2021/11/24,14:30,360.59,902,6789,7691
2021/11/24,15:00,360.9,779,7010,7789
2021/11/24,15:30,380.88,639,7264,7903
2021/11/24,16:00,407.82,266,7692,7958
2021/11/24,16:30,329.09,119,8098,8217
2021/11/24,17:00,2002.55,0,8735,8735
2021/11/24,17:30,2090.34,1,8941,8942
2021/11/24,18:00,2090.34,1,9016,9017
2021/11/24,18:30,2045.61,1,9073,9074
2021/11/24,19:00,2090.34,1,9024,9025
2021/11/24,19:30,2067.47,1,8938,8939
2021/11/24,20:00,2067.47,1,8826,8827
2021/11/24,20:30,2090.34,1,8703,8704
2021/11/24,21:00,330.2,1,8511,8512
2021/11/24,21:30,407.82,1,8302,8303
2021/11/24,22:00,403.26,0,8077,8077
2021/11/24,22:30,403.26,0,7772,7772
2021/11/24,23:00,341.59,0,7448,7448
2021/11/24,23:30,340.99,0,7044,7044
2021/11/25,00:00,341.59,0,6708,6708
2021/11/25,00:30,341.29,0,6403,6403
2021/11/25,01:00,341.9,0,6146,6146
2021/11/25,01:30,341.59,0,5956,5956
2021/11/25,02:00,340.69,0,5825,5825
2021/11/25,02:30,340.4,0,5871,5871
2021/11/25,03:00,340.69,0,5814,5814
2021/11/25,03:30,338.23,0,5941,5941
2021/11/25,04:00,340.11,0,5971,5971
2021/11/25,04:30,340.4,0,6072,6072
2021/11/25,05:00,340.11,0,6256,6256
2021/11/25,05:30,337.49,0,6382,6382
2021/11/25,06:00,337.49,0,6511,6511
2021/11/25,06:30,337.49,0,6754,6754
2021/11/25,07:00,338.23,142,6982,7124
2021/11/25,07:30,337.49,315,7110,7425
2021/11/25,08:00,339.55,569,6771,7340
2021/11/25,08:30,338.48,1008,6559,7567
2021/11/25,09:00,338.23,1258,6570,7828
2021/11/25,09:30,342.54,1400,6436,7836
2021/11/25,10:00,340.4,1553,6360,7913
2021/11/25,10:30,341.29,1574,6304,7878
2021/11/25,11:00,340.69,1625,6288,7913
2021/11/25,11:30,341.29,1624,6263,7887
2021/11/25,12:00,339.01,1530,6325,7855
2021/11/25,12:30,340.11,1418,6424,7842
2021/11/25,13:00,339.28,1376,6493,7869
2021/11/25,13:30,340.4,1435,6521,7956
2021/11/25,14:00,339.55,1298,6713,8011
2021/11/25,14:30,340.4,1080,6908,7988
2021/11/25,15:00,340.11,774,7086,7860
2021/11/25,15:30,339.01,448,7482,7930
2021/11/25,16:00,387.37,218,7790,8008
2021/11/25,16:30,371.5,78,8167,8245
2021/11/25,17:00,365.67,3,8684,8687
2021/11/25,17:30,329.19,3,8877,8880
2021/11/25,18:00,329.08,2,8964,8966
2021/11/25,18:30,329.79,2,8957,8959
2021/11/25,19:00,329.59,2,8904,8906
2021/11/25,19:30,329.59,2,8836,8838
2021/11/25,20:00,329.64,1,8748,8749
2021/11/25,20:30,400.86,2,8588,8590
2021/11/25,21:00,382.85,1,8400,8401
2021/11/25,21:30,341.59,0,8088,8088
2021/11/25,22:00,386.22,1,7941,7942
2021/11/25,22:30,339.83,1,7748,7749
2021/11/25,23:00,339.28,1,7464,7465
2021/11/25,23:30,339.28,1,7138,7139
2021/11/26,00:00,340.69,1,6797,6798
2021/11/26,00:30,341.29,0,6514,6514
2021/11/26,01:00,341.59,0,6256,6256
2021/11/26,01:30,340.99,0,6018,6018
2021/11/26,02:00,341.29,1,5892,5893
2021/11/26,02:30,340.4,1,5769,5770
2021/11/26,03:00,341.59,0,5701,5701
2021/11/26,03:30,341.29,0,5652,5652
2021/11/26,04:00,341.59,1,5777,5778
2021/11/26,04:30,335.91,0,5881,5881
2021/11/26,05:00,339.55,0,6011,6011
2021/11/26,05:30,339.28,0,6163,6163
2021/11/26,06:00,338.74,0,6349,6349
2021/11/26,06:30,339.01,0,6337,6337
2021/11/26,07:00,341.29,115,6391,6506
2021/11/26,07:30,341.59,412,6406,6818
2021/11/26,08:00,342.22,805,6183,6988
2021/11/26,08:30,341.9,1110,6040,7150
2021/11/26,09:00,340.11,1292,5933,7225
2021/11/26,09:30,340.99,1558,5866,7424
2021/11/26,10:00,341.59,1683,5799,7482
2021/11/26,10:30,340.69,1759,5798,7557
2021/11/26,11:00,340.99,1829,5761,7590
2021/11/26,11:30,340.69,1845,5769,7614
2021/11/26,12:00,340.99,1837,5686,7523
2021/11/26,12:30,340.99,1778,5661,7439
2021/11/26,13:00,340.11,1720,5771,7491
2021/11/26,13:30,339.55,1632,5799,7431
2021/11/26,14:00,339.83,1484,5989,7473
2021/11/26,14:30,339.83,1233,6226,7459
2021/11/26,15:00,339.55,978,6519,7497
2021/11/26,15:30,339.55,673,6999,7672
2021/11/26,16:00,403.78,258,7427,7685
2021/11/26,16:30,339.28,2,7550,7552
2021/11/26,17:00,338.74,2,7951,7953
2021/11/26,17:30,339.28,1,8007,8008
2021/11/26,18:00,407.89,1,8013,8014
2021/11/26,18:30,383.31,0,7874,7874
2021/11/26,19:00,381.18,0,7776,7776
2021/11/26,19:30,385.49,0,7600,7600
2021/11/26,20:00,339.28,0,7525,7525
2021/11/26,20:30,378.4,0,7416,7416
2021/11/26,21:00,379.84,0,7282,7282
2021/11/26,21:30,339.28,0,7171,7171
2021/11/26,22:00,378.18,0,7011,7011
2021/11/26,22:30,338.74,0,6842,6842
2021/11/26,23:00,339.55,0,6628,6628
2021/11/26,23:30,339.28,0,6431,6431
2021/11/27,00:00,339.28,0,6231,6231
2021/11/27,00:30,339.28,0,6001,6001
2021/11/27,01:00,338.74,0,5804,5804
2021/11/27,01:30,338.74,0,5702,5702
2021/11/27,02:00,338.74,1,5760,5761
2021/11/27,02:30,339.83,1,5689,5690
2021/11/27,03:00,339.55,1,5629,5630
2021/11/27,03:30,340.11,0,5568,5568
2021/11/27,04:00,338.48,0,5744,5744
2021/11/27,04:30,341.29,0,5780,5780
2021/11/27,05:00,341.29,1,5854,5855
2021/11/27,05:30,340.99,1,5916,5917
2021/11/27,06:00,341.29,1,5983,5984
2021/11/27,06:30,341.29,2,5896,5898
2021/11/27,07:00,339.83,146,5825,5971
2021/11/27,07:30,340.11,471,5624,6095
2021/11/27,08:00,338.74,805,5356,6161
2021/11/27,08:30,340.99,1164,5184,6348
2021/11/27,09:00,340.4,1443,5072,6515
2021/11/27,09:30,340.11,1557,5046,6603
2021/11/27,10:00,340.4,1679,4975,6654
2021/11/27,10:30,340.4,1793,4991,6784
2021/11/27,11:00,339.83,1832,4941,6773
2021/11/27,11:30,340.11,1848,4917,6765
2021/11/27,12:00,339.55,1826,4955,6781
2021/11/27,12:30,341.29,1771,4834,6605
2021/11/27,13:00,337.73,1663,4849,6512
2021/11/27,13:30,339.01,1553,4973,6526
2021/11/27,14:00,337.25,1278,5290,6568
2021/11/27,14:30,340.4,1117,5446,6563
2021/11/27,15:00,338.48,926,5735,6661
2021/11/27,15:30,341.29,586,6137,6723
2021/11/27,16:00,340.99,291,6491,6782
2021/11/27,16:30,398.06,103,6915,7018
2021/11/27,17:00,398.06,32,7416,7448
2021/11/27,17:30,400.81,32,7662,7694
2021/11/27,18:00,398.28,32,7905,7937
2021/11/27,18:30,403.78,31,7985,8016
2021/11/27,19:00,398.42,30,7951,7981
2021/11/27,19:30,401.07,31,7935,7966
2021/11/27,20:00,400.97,30,7850,7880
2021/11/27,20:30,400.53,10,7772,7782
2021/11/27,21:00,400.08,0,7770,7770
2021/11/27,21:30,400.08,1,7600,7601
2021/11/27,22:00,400.08,1,7416,7417
2021/11/27,22:30,341.29,1,7193,7194
2021/11/27,23:00,341.29,1,6916,6917
2021/11/27,23:30,340.99,1,6641,6642
2021/11/28,00:00,339.83,1,6354,6355
2021/11/28,00:30,335.5,1,6363,6364
2021/11/28,01:00,340.4,1,6151,6152
2021/11/28,01:30,339.28,1,5942,5943
2021/11/28,02:00,340.11,1,5810,5811
2021/11/28,02:30,339.83,1,5702,5703
2021/11/28,03:00,339.55,1,5669,5670
2021/11/28,03:30,340.11,1,5676,5677
2021/11/28,04:00,339.28,1,5722,5723
2021/11/28,04:30,339.55,1,5801,5802
2021/11/28,05:00,339.28,1,6004,6005
2021/11/28,05:30,338.74,1,6128,6129
2021/11/28,06:00,340.69,0,6255,6255
2021/11/28,06:30,341.29,0,6478,6478
2021/11/28,07:00,339.01,133,6559,6692
2021/11/28,07:30,340.99,431,6559,6990
2021/11/28,08:00,339.28,863,6196,7059
2021/11/28,08:30,341.29,1189,5991,7180
2021/11/28,09:00,340.69,1385,5809,7194
2021/11/28,09:30,340.69,1555,5898,7453
2021/11/28,10:00,339.55,1687,5812,7499
2021/11/28,10:30,340.99,1749,5818,7567
2021/11/28,11:00,339.28,1785,5814,7599
2021/11/28,11:30,341.9,1814,5836,7650
2021/11/28,12:00,340.11,1792,5755,7547
2021/11/28,12:30,341.29,1761,5827,7588
2021/11/28,13:00,340.11,1687,5988,7675
2021/11/28,13:30,340.4,1596,6201,7797
2021/11/28,14:00,2120.56,1493,6439,7932
2021/11/28,14:30,340.11,1365,6670,8035
2021/11/28,15:00,342.22,896,7011,7907
2021/11/28,15:30,403.3,732,7351,8083
2021/11/28,16:00,403.73,299,7649,7948
2021/11/28,16:30,378.97,96,7943,8039
2021/11/28,17:00,2090.34,0,8489,8489
2021/11/28,17:30,2067.47,0,8591,8591
2021/11/28,18:00,329.73,1,8563,8564
2021/11/28,18:30,329.09,0,8544,8544
2021/11/28,19:00,329.11,1,8420,8421
2021/11/28,19:30,329.74,1,8347,8348
2021/11/28,20:00,340.4,2,8235,8237
2021/11/28,20:30,397.76,3,8153,8156
2021/11/28,21:00,382.67,4,8007,8011
2021/11/28,21:30,341.9,5,7792,7797
2021/11/28,22:00,340.4,4,7606,7610
2021/11/28,22:30,380.77,4,7456,7460
2021/11/28,23:00,340.4,2,7162,7164
2021/11/28,23:30,341.29,2,6774,6776
2021/11/29,00:00,338.48,1,6492,6493
2021/11/29,00:30,339.01,1,6338,6339
2021/11/29,01:00,337.02,1,6132,6133
2021/11/29,01:30,338.74,1,5998,5999
2021/11/29,02:00,338.74,1,5823,5824
2021/11/29,02:30,335.5,1,5920,5921
2021/11/29,03:00,335.71,1,5894,5895
2021/11/29,03:30,336.13,1,5819,5820
2021/11/29,04:00,337.02,1,5888,5889
2021/11/29,04:30,336.56,1,5983,5984
2021/11/29,05:00,336.34,1,6182,6183
2021/11/29,05:30,336.13,1,6294,6295
2021/11/29,06:00,336.34,0,6421,6421
2021/11/29,06:30,337.98,0,6623,6623
2021/11/29,07:00,335.71,133,6815,6948
2021/11/29,07:30,336.79,401,6781,7182
2021/11/29,08:00,337.02,782,6480,7262
2021/11/29,08:30,335.91,1118,6235,7353
2021/11/29,09:00,336.34,1333,6099,7432
2021/11/29,09:30,336.13,1483,6062,7545
2021/11/29,10:00,336.13,1504,6106,7610
2021/11/29,10:30,335.91,1640,6043,7683
2021/11/29,11:00,335.71,1606,6019,7625
2021/11/29,11:30,335.91,1455,6140,7595
2021/11/29,12:00,336.13,1479,6139,7618
2021/11/29,12:30,335.71,1573,6169,7742
2021/11/29,13:00,336.34,1653,6220,7873
2021/11/29,13:30,336.13,1555,6457,8012
2021/11/29,14:00,335.71,1436,6680,8116
2021/11/29,14:30,403.32,1313,7060,8373
2021/11/29,15:00,400.2,1005,7241,8246
2021/11/29,15:30,403.32,774,7511,8285
2021/11/29,16:00,375.64,654,7781,8435
2021/11/29,16:30,378.24,606,8095,8701
2021/11/29,17:00,383.5,0,8518,8518
2021/11/29,17:30,378.24,0,8621,8621
2021/11/29,18:00,371.44,0,8633,8633
2021/11/29,18:30,376.34,0,8535,8535
2021/11/29,19:00,407.86,0,8471,8471
2021/11/29,19:30,401.18,0,8349,8349
2021/11/29,20:00,398.4,0,8230,8230
2021/11/29,20:30,397.78,0,8079,8079
2021/11/29,21:00,380.15,0,7910,7910
2021/11/29,21:30,341.59,1,7778,7779
2021/11/29,22:00,340.4,2,7544,7546
2021/11/29,22:30,341.9,2,7398,7400
2021/11/29,23:00,338.48,5,7099,7104
2021/11/29,23:30,341.9,5,6726,6731
2021/11/30,00:00,339.28,8,6441,6449
2021/11/30,00:30,341.59,4,6163,6167
2021/11/30,01:00,341.29,6,6115,6121
2021/11/30,01:30,340.11,4,5996,6000
2021/11/30,02:00,339.01,4,5864,5868
2021/11/30,02:30,339.55,4,5806,5810
2021/11/30,03:00,340.69,5,5742,5747
2021/11/30,03:30,340.69,5,5708,5713
2021/11/30,04:00,340.4,5,5776,5781
2021/11/30,04:30,339.55,5,5863,5868
2021/11/30,05:00,341.29,4,6036,6040
2021/11/30,05:30,338.48,2,6261,6263
2021/11/30,06:00,340.11,3,6369,6372
2021/11/30,06:30,338.48,3,6546,6549
2021/11/30,07:00,340.4,134,6627,6761
2021/11/30,07:30,340.4,414,6631,7045
2021/11/30,08:00,339.83,865,6350,7215
2021/11/30,08:30,341.29,1139,6409,7548
2021/11/30,09:00,340.99,1326,6248,7574
2021/11/30,09:30,341.59,1553,6279,7832
2021/11/30,10:00,341.59,1628,6270,7898
2021/11/30,10:30,341.9,1744,6261,8005
2021/11/30,11:00,341.29,1759,6302,8061
2021/11/30,11:30,341.9,1771,6403,8174
2021/11/30,12:00,341.9,1758,6466,8224
2021/11/30,12:30,341.59,1740,6589,8329
2021/11/30,13:00,341.29,1619,6754,8373
2021/11/30,13:30,341.9,1505,6687,8192
2021/11/30,14:00,337.73,1372,6731,8103
2021/11/30,14:30,400.33,1200,6921,8121
2021/11/30,15:00,400.33,814,7235,8049
2021/11/30,15:30,408,480,7546,8026
2021/11/30,16:00,383.54,254,7780,8034
2021/11/30,16:30,371.94,3,8055,8058
2021/11/30,17:00,369.8,2,8517,8519
2021/11/30,17:30,374.13,2,8664,8666
2021/11/30,18:00,371.94,3,8601,8604
2021/11/30,18:30,376.85,8,8594,8602
2021/11/30,19:00,372.59,16,8526,8542
2021/11/30,19:30,374.66,17,8416,8433
2021/11/30,20:00,408,16,8322,8338
2021/11/30,20:30,380,18,8196,8214
2021/11/30,21:00,377.86,18,8026,8044
2021/11/30,21:30,341.59,18,7870,7888
2021/11/30,22:00,341.59,18,7564,7582
2021/11/30,22:30,341.9,19,7404,7423
2021/11/30,23:00,342.87,19,7149,7168
2021/11/30,23:30,340.4,19,6830,6849
2021/12/01,00:00,337.98,19,6539,6558
2021/12/01,00:30,336.75,18,6241,6259
2021/12/01,01:00,342.22,18,6033,6051
2021/12/01,01:30,336.56,18,6035,6053
2021/12/01,02:00,338.48,18,5926,5944
2021/12/01,02:30,341.59,14,5953,5967
2021/12/01,03:00,341.59,13,5945,5958
2021/12/01,03:30,339.01,12,5920,5932
2021/12/01,04:00,337.48,10,5959,5969
2021/12/01,04:30,337.86,10,6010,6020
2021/12/01,05:00,337.12,12,6202,6214
2021/12/01,05:30,334.36,13,6462,6475
2021/12/01,06:00,333.51,13,6601,6614
2021/12/01,06:30,334.54,13,6783,6796
2021/12/01,07:00,337.02,120,6856,6976
2021/12/01,07:30,339.01,211,7038,7249
2021/12/01,08:00,364.36,326,7069,7395
2021/12/01,08:30,380.61,466,7352,7818
2021/12/01,09:00,386.08,521,7301,7822
2021/12/01,09:30,383.31,685,7336,8021
2021/12/01,10:00,386.08,622,7409,8031
2021/12/01,10:30,377.35,659,7321,7980
2021/12/01,11:00,380.63,805,7235,8040
2021/12/01,11:30,383.19,635,7267,7902
2021/12/01,12:00,387.96,614,7348,7962
2021/12/01,12:30,386.08,570,7422,7992
2021/12/01,13:00,387.96,773,7443,8216
2021/12/01,13:30,383.31,586,7500,8086
2021/12/01,14:00,386.12,546,7599,8145
2021/12/01,14:30,397.52,542,7676,8218
2021/12/01,15:00,403.69,432,7812,8244
2021/12/01,15:30,403.69,286,8022,8308
2021/12/01,16:00,408.24,229,8165,8394
2021/12/01,16:30,335.35,36,8443,8479
2021/12/01,17:00,329.84,43,8893,8936
2021/12/01,17:30,329.9,43,9035,9078
2021/12/01,18:00,329.9,37,9035,9072
2021/12/01,18:30,329.79,14,9037,9051
2021/12/01,19:00,330.87,1,8926,8927
2021/12/01,19:30,342.54,2,8803,8805
2021/12/01,20:00,398.76,2,8636,8638
2021/12/01,20:30,403.95,3,8429,8432
2021/12/01,21:00,340.69,3,8256,8259
2021/12/01,21:30,340.4,5,7958,7963
2021/12/01,22:00,383.77,5,7691,7696
2021/12/01,22:30,340.99,4,7524,7528
2021/12/01,23:00,340.99,3,7217,7220
2021/12/01,23:30,339.28,3,6911,6914
2021/12/02,00:00,263.9,3,6620,6623
2021/12/02,00:30,262.43,5,6640,6645
2021/12/02,01:00,263.9,4,6414,6418
2021/12/02,01:30,263.66,6,6224,6230
2021/12/02,02:00,263.9,5,6085,6090
2021/12/02,02:30,263.9,4,5980,5984
2021/12/02,03:00,263.66,3,5914,5917
2021/12/02,03:30,263.66,3,5909,5912
2021/12/02,04:00,263.42,4,5950,5954
2021/12/02,04:30,263.66,3,6066,6069
2021/12/02,05:00,263.42,4,6242,6246
2021/12/02,05:30,263.66,3,6468,6471
2021/12/02,06:00,264.14,4,6594,6598
2021/12/02,06:30,263.66,3,6817,6820
2021/12/02,07:00,263.9,15,7017,7032
2021/12/02,07:30,263.66,286,7062,7348
2021/12/02,08:00,263.9,721,6906,7627
2021/12/02,08:30,263.66,974,6806,7780
2021/12/02,09:00,263.66,1205,6732,7937
2021/12/02,09:30,262.3,1295,6748,8043
2021/12/02,10:00,263.19,1405,6648,8053
2021/12/02,10:30,262.52,1522,6601,8123
2021/12/02,11:00,262.31,1598,6603,8201
2021/12/02,11:30,262.18,1236,6574,7810
2021/12/02,12:00,262.06,1235,6579,7814
2021/12/02,12:30,262.18,1233,6626,7859
2021/12/02,13:00,262.31,1160,6690,7850
2021/12/02,13:30,262.06,1171,6746,7917
2021/12/02,14:00,262.31,1169,6890,8059
2021/12/02,14:30,386.22,1059,7179,8238
2021/12/02,15:00,319.98,841,7376,8217
2021/12/02,15:30,314.53,699,7573,8272
2021/12/02,16:00,400.76,582,7705,8287
2021/12/02,16:30,323.9,679,8034,8713
2021/12/02,17:00,323.52,1,8533,8534
2021/12/02,17:30,323.02,1,8693,8694
2021/12/02,18:00,323.6,1,8739,8740
2021/12/02,18:30,324.39,1,8687,8688
2021/12/02,19:00,324.21,0,8614,8614
2021/12/02,19:30,324.09,0,8525,8525
2021/12/02,20:00,378.89,0,8432,8432
2021/12/02,20:30,319.09,1,8270,8271
2021/12/02,21:00,311.85,1,8066,8067
2021/12/02,21:30,311.37,1,7864,7865
2021/12/02,22:00,321.71,1,7673,7674
2021/12/02,22:30,321.66,0,7586,7586
2021/12/02,23:00,262.3,0,7334,7334
2021/12/02,23:30,262.08,0,7083,7083
2021/12/03,00:00,262.3,0,6796,6796
2021/12/03,00:30,262.08,0,6513,6513
2021/12/03,01:00,262.08,0,6308,6308
2021/12/03,01:30,262.3,0,6101,6101
2021/12/03,02:00,263.66,0,6065,6065
2021/12/03,02:30,263.42,0,6085,6085
2021/12/03,03:00,263.66,0,5994,5994
2021/12/03,03:30,263.42,0,5988,5988
2021/12/03,04:00,263.66,0,5970,5970
2021/12/03,04:30,263.66,0,6061,6061
2021/12/03,05:00,263.42,0,6175,6175
2021/12/03,05:30,263.66,0,6320,6320
2021/12/03,06:00,263.66,0,6411,6411
2021/12/03,06:30,263.19,0,6274,6274
2021/12/03,07:00,263.42,112,6119,6231
2021/12/03,07:30,264.39,321,6043,6364
2021/12/03,08:00,263.42,612,6204,6816
2021/12/03,08:30,263.19,681,6309,6990
2021/12/03,09:00,263.42,778,6342,7120
2021/12/03,09:30,263.42,858,6458,7316
2021/12/03,10:00,262.96,1056,6451,7507
2021/12/03,10:30,262.96,1255,6408,7663
2021/12/03,11:00,263.9,1322,6353,7675
2021/12/03,11:30,263.19,1376,6309,7685
2021/12/03,12:00,261.67,1435,6313,7748
2021/12/03,12:30,263.19,1386,6324,7710
2021/12/03,13:00,263.66,1240,6418,7658
2021/12/03,13:30,263.42,1169,6554,7723
2021/12/03,14:00,359.47,1002,6730,7732
2021/12/03,14:30,384.62,784,6949,7733
2021/12/03,15:00,381.99,694,7303,7997
2021/12/03,15:30,384.65,567,7719,8286
2021/12/03,16:00,384.91,544,7812,8356
2021/12/03,16:30,381.56,0,7854,7854
2021/12/03,17:00,381.56,16,8136,8152
2021/12/03,17:30,379.34,22,8115,8137
2021/12/03,18:00,386.46,21,8097,8118
2021/12/03,18:30,346.73,24,7958,7982
2021/12/03,19:00,369.72,24,7745,7769
2021/12/03,19:30,383.11,23,7596,7619
2021/12/03,20:00,371.73,25,7442,7467
2021/12/03,20:30,310.02,13,7466,7479
2021/12/03,21:00,300.14,0,7351,7351
2021/12/03,21:30,302.82,4,7214,7218
2021/12/03,22:00,366.48,4,7095,7099
2021/12/03,22:30,374.22,4,6935,6939
2021/12/03,23:00,263.9,4,6740,6744
2021/12/03,23:30,264.14,4,6533,6537
2021/12/04,00:00,263.9,4,6285,6289
2021/12/04,00:30,264.14,4,6099,6103
2021/12/04,01:00,263.19,4,5901,5905
2021/12/04,01:30,262.43,4,5772,5776
2021/12/04,02:00,262.43,4,5798,5802
2021/12/04,02:30,262.56,4,5707,5711
2021/12/04,03:00,262.43,4,5667,5671
2021/12/04,03:30,262.43,4,5644,5648
2021/12/04,04:00,262.43,4,5658,5662
2021/12/04,04:30,262.43,4,5723,5727
2021/12/04,05:00,262.18,4,5936,5940
2021/12/04,05:30,261.87,4,6029,6033
2021/12/04,06:00,261.87,4,6086,6090
2021/12/04,06:30,261.67,4,5977,5981
2021/12/04,07:00,262.52,128,5916,6044
2021/12/04,07:30,261.94,363,5798,6161
2021/12/04,08:00,261.87,547,5742,6289
2021/12/04,08:30,262.08,767,5642,6409
2021/12/04,09:00,263.19,1024,5483,6507
2021/12/04,09:30,262.52,1123,5434,6557
2021/12/04,10:00,262.06,1227,5574,6801
2021/12/04,10:30,262.3,1395,5433,6828
2021/12/04,11:00,261.69,1296,5688,6984
2021/12/04,11:30,261.81,1248,5765,7013
2021/12/04,12:00,263.19,1289,5743,7032
2021/12/04,12:30,263.19,1298,5787,7085
2021/12/04,13:00,262.52,1249,5825,7074
2021/12/04,13:30,262.74,1109,6027,7136
2021/12/04,14:00,261.94,1031,6087,7118
2021/12/04,14:30,263.42,934,6114,7048
2021/12/04,15:00,262.08,812,6380,7192
2021/12/04,15:30,262.52,613,6645,7258
2021/12/04,16:00,262.68,535,6992,7527
2021/12/04,16:30,371.14,25,7365,7390
2021/12/04,17:00,373.32,26,7703,7729
2021/12/04,17:30,369.01,26,7982,8008
2021/12/04,18:00,353.78,24,8128,8152
2021/12/04,18:30,357.43,30,8191,8221
2021/12/04,19:00,373.83,30,8133,8163
2021/12/04,19:30,373.83,31,8091,8122
2021/12/04,20:00,357.17,30,8037,8067
2021/12/04,20:30,375.43,30,7946,7976
2021/12/04,21:00,353,30,7806,7836
2021/12/04,21:30,352.78,16,7775,7791
2021/12/04,22:00,359.08,1,7631,7632
2021/12/04,22:30,366.51,1,7428,7429
2021/12/04,23:00,262.08,1,7166,7167
2021/12/04,23:30,262.74,1,6840,6841
2021/12/05,00:00,262.3,1,6503,6504
2021/12/05,00:30,263.9,1,6224,6225
2021/12/05,01:00,263.19,1,6155,6156
2021/12/05,01:30,262.74,1,6076,6077
2021/12/05,02:00,262.74,1,5907,5908
2021/12/05,02:30,262.3,1,5814,5815
2021/12/05,03:00,263.66,1,5743,5744
2021/12/05,03:30,262.3,1,5740,5741
2021/12/05,04:00,263.42,1,5765,5766
2021/12/05,04:30,263.19,1,5877,5878
2021/12/05,05:00,263.19,1,6045,6046
2021/12/05,05:30,263.42,1,6304,6305
2021/12/05,06:00,262.96,1,6405,6406
2021/12/05,06:30,262.74,1,6638,6639
2021/12/05,07:00,262.18,112,6737,6849
2021/12/05,07:30,262.74,335,6553,6888
2021/12/05,08:00,262.56,623,6362,6985
2021/12/05,08:30,262.8,886,6183,7069
2021/12/05,09:00,262.31,1154,6311,7465
2021/12/05,09:30,262.74,1324,6310,7634
2021/12/05,10:00,262.43,1392,6248,7640
2021/12/05,10:30,262.18,1453,6190,7643
2021/12/05,11:00,262.43,1468,6209,7677
2021/12/05,11:30,262.43,1521,6187,7708
2021/12/05,12:00,262.43,1482,6383,7865
2021/12/05,12:30,262.74,1359,6443,7802
2021/12/05,13:00,262.52,1279,6589,7868
2021/12/05,13:30,262.52,1234,6718,7952
2021/12/05,14:00,262.43,1120,7030,8150
2021/12/05,14:30,262.18,1008,7345,8353
2021/12/05,15:00,262.43,792,7715,8507
2021/12/05,15:30,345.04,667,8012,8679
2021/12/05,16:00,403.19,258,8191,8449
2021/12/05,16:30,330.81,36,8543,8579
2021/12/05,17:00,2002.55,39,9075,9114
2021/12/05,17:30,2025.76,42,9250,9292
2021/12/05,18:00,395.24,37,9286,9323
2021/12/05,18:30,403.34,38,9256,9294
2021/12/05,19:00,400.63,39,9175,9214
2021/12/05,19:30,406.13,39,9056,9095
2021/12/05,20:00,403.29,36,8897,8933
2021/12/05,20:30,400.09,35,8730,8765
2021/12/05,21:00,379.47,19,8509,8528
2021/12/05,21:30,379.41,4,8295,8299
2021/12/05,22:00,263.9,1,8037,8038
2021/12/05,22:30,264.39,0,7908,7908
2021/12/05,23:00,263.9,0,7567,7567
2021/12/05,23:30,263.9,0,7219,7219
2021/12/06,00:00,262.25,0,6859,6859
2021/12/06,00:30,262,1,6556,6557
2021/12/06,01:00,262.96,1,6325,6326
2021/12/06,01:30,262,1,6348,6349
2021/12/06,02:00,262.08,1,6175,6176
2021/12/06,02:30,262,1,6100,6101
2021/12/06,03:00,261.88,1,6031,6032
2021/12/06,03:30,262.25,2,5979,5981
2021/12/06,04:00,262.25,2,6054,6056
2021/12/06,04:30,262.25,1,6118,6119
2021/12/06,05:00,261.87,1,6329,6330
2021/12/06,05:30,261.75,1,6588,6589
2021/12/06,06:00,261.88,1,6746,6747
2021/12/06,06:30,261.67,1,6974,6975
2021/12/06,07:00,261.88,14,7276,7290
2021/12/06,07:30,261.88,279,7205,7484
2021/12/06,08:00,262,532,6928,7460
2021/12/06,08:30,261.88,858,6740,7598
2021/12/06,09:00,261.88,1096,6594,7690
2021/12/06,09:30,261.88,1249,6424,7673
2021/12/06,10:00,262,1367,6268,7635
2021/12/06,10:30,262.74,1487,6212,7699
2021/12/06,11:00,263.42,1537,6153,7690
2021/12/06,11:30,261.67,1686,6165,7851
2021/12/06,12:00,261.88,1546,6261,7807
2021/12/06,12:30,261.87,1156,6280,7436
2021/12/06,13:00,261.63,1229,6420,7649
2021/12/06,13:30,261.26,1209,6632,7841
2021/12/06,14:00,261.26,1010,6899,7909
2021/12/06,14:30,384.52,792,7203,7995
2021/12/06,15:00,381.89,629,7421,8050
2021/12/06,15:30,402.79,477,7769,8246
2021/12/06,16:00,403.24,430,8036,8466
2021/12/06,16:30,377.19,2,8392,8394
2021/12/06,17:00,392.3,0,8925,8925
2021/12/06,17:30,379.22,0,9153,9153
2021/12/06,18:00,395.65,1,9242,9243
2021/12/06,18:30,396.85,1,9238,9239
2021/12/06,19:00,428.37,1,9244,9245
2021/12/06,19:30,418.63,1,9172,9173
2021/12/06,20:00,423.01,1,9043,9044
2021/12/06,20:30,428.41,1,8872,8873
2021/12/06,21:00,428.41,1,8652,8653
2021/12/06,21:30,399.66,1,8418,8419
2021/12/06,22:00,402.79,1,8111,8112
2021/12/06,22:30,263.19,1,7907,7908
2021/12/06,23:00,262.3,1,7551,7552
2021/12/06,23:30,262.96,1,7143,7144
2021/12/07,00:00,262.74,1,6760,6761
2021/12/07,00:30,264.14,1,6464,6465
2021/12/07,01:00,262.96,1,6344,6345
2021/12/07,01:30,262.96,1,6296,6297
2021/12/07,02:00,262.3,1,6146,6147
2021/12/07,02:30,261.87,1,6079,6080
2021/12/07,03:00,261.67,1,6008,6009
2021/12/07,03:30,263.19,1,5943,5944
2021/12/07,04:00,261.94,3,6016,6019
2021/12/07,04:30,262.52,3,6179,6182
2021/12/07,05:00,262.74,2,6308,6310
2021/12/07,05:30,262.08,6,6599,6605
2021/12/07,06:00,262.96,9,6805,6814
2021/12/07,06:30,263.42,8,7016,7024
2021/12/07,07:00,385.24,10,7265,7275
2021/12/07,07:30,312.07,254,7567,7821
2021/12/07,08:00,387.12,288,7511,7799
2021/12/07,08:30,403.04,450,7697,8147
2021/12/07,09:00,403.02,449,7633,8082
2021/12/07,09:30,399.89,428,7700,8128
2021/12/07,10:00,399.89,536,7692,8228
2021/12/07,10:30,406.24,727,7865,8592
2021/12/07,11:00,399.89,609,7793,8402
2021/12/07,11:30,399.89,683,7839,8522
2021/12/07,12:00,463.58,673,7862,8535
2021/12/07,12:30,483.24,586,7916,8502
2021/12/07,13:00,476.31,582,8005,8587
2021/12/07,13:30,473,525,8134,8659
2021/12/07,14:00,487.9,391,8272,8663
2021/12/07,14:30,479.73,444,8252,8696
2021/12/07,15:00,486.84,402,8362,8764
2021/12/07,15:30,483.24,264,8479,8743
2021/12/07,16:00,486.84,34,8584,8618
2021/12/07,16:30,479.73,33,8858,8891
2021/12/07,17:00,1899.79,33,9287,9320
2021/12/07,17:30,1935.24,33,9521,9554
2021/12/07,18:00,1940.71,33,9581,9614
2021/12/07,18:30,1935.24,33,9641,9674
2021/12/07,19:00,1935.24,33,9622,9655
2021/12/07,19:30,466.61,33,9548,9581
2021/12/07,20:00,476.32,33,9422,9455
2021/12/07,20:30,466.65,34,9229,9263
2021/12/07,21:00,469.77,35,9032,9067
2021/12/07,21:30,406.24,34,8770,8804
2021/12/07,22:00,403.02,16,8339,8355
2021/12/07,22:30,399.89,1,8149,8150
2021/12/07,23:00,399.89,1,7765,7766
2021/12/07,23:30,263.42,1,7341,7342
2021/12/08,00:00,263.66,2,6993,6995
2021/12/08,00:30,263.9,2,6655,6657
2021/12/08,01:00,263.42,1,6522,6523
2021/12/08,01:30,262.3,3,6473,6476
2021/12/08,02:00,263.42,5,6317,6322
2021/12/08,02:30,263.9,2,6201,6203
2021/12/08,03:00,262.74,8,6094,6102
2021/12/08,03:30,263.42,9,6141,6150
2021/12/08,04:00,263.66,11,6179,6190
2021/12/08,04:30,262.96,10,6306,6316
2021/12/08,05:00,262.3,6,6532,6538
2021/12/08,05:30,262.52,11,6799,6810
2021/12/08,06:00,262.25,11,7063,7074
2021/12/08,06:30,262.96,18,7418,7436
2021/12/08,07:00,263.42,21,7721,7742
2021/12/08,07:30,262.96,261,7740,8001
2021/12/08,08:00,262.74,576,7449,8025
2021/12/08,08:30,263.19,869,7333,8202
2021/12/08,09:00,262.74,1164,7145,8309
2021/12/08,09:30,262.96,1367,7018,8385
2021/12/08,10:00,262.74,1490,6962,8452
2021/12/08,10:30,263.42,1527,6932,8459
2021/12/08,11:00,263.42,1585,6859,8444
2021/12/08,11:30,263.19,1559,6898,8457
2021/12/08,12:00,263.9,1536,6950,8486
2021/12/08,12:30,263.19,1443,7091,8534
2021/12/08,13:00,262.06,1264,7233,8497
2021/12/08,13:30,262.31,1065,7628,8693
2021/12/08,14:00,402.86,919,7891,8810
2021/12/08,14:30,402.86,751,8232,8983
2021/12/08,15:00,402.84,484,8548,9032
2021/12/08,15:30,406.05,263,8926,9189
2021/12/08,16:00,406.19,169,9126,9295
2021/12/08,16:30,400.48,49,9499,9548
2021/12/08,17:00,1940.71,50,10049,10099
2021/12/08,17:30,2003.61,49,10292,10341
2021/12/08,18:00,2025.76,47,10385,10432
2021/12/08,18:30,2003.61,30,10473,10503
2021/12/08,19:00,2003.61,18,10439,10457
2021/12/08,19:30,2025.76,17,10352,10369
2021/12/08,20:00,1982.43,16,10219,10235
2021/12/08,20:30,403.12,16,9975,9991
2021/12/08,21:00,407.4,16,9728,9744
2021/12/08,21:30,261.87,13,9279,9292
2021/12/08,22:00,263.9,13,8891,8904
2021/12/08,22:30,264.14,13,8597,8610
2021/12/08,23:00,263.42,12,8193,8205
2021/12/08,23:30,263.9,5,7708,7713
2021/12/09,00:00,263.3,3,7253,7256
2021/12/09,00:30,262.74,3,6836,6839
2021/12/09,01:00,262.08,5,6551,6556
2021/12/09,01:30,262.96,5,6504,6509
2021/12/09,02:00,262.18,3,6458,6461
2021/12/09,02:30,261.81,3,6345,6348
2021/12/09,03:00,261.57,4,6247,6251
2021/12/09,03:30,262.06,5,6256,6261
2021/12/09,04:00,262.96,4,6297,6301
2021/12/09,04:30,263.66,5,6412,6417
2021/12/09,05:00,263.66,4,6599,6603
2021/12/09,05:30,263.42,5,6897,6902
2021/12/09,06:00,262.52,4,7112,7116
2021/12/09,06:30,263.19,6,7531,7537
2021/12/09,07:00,262.96,10,7862,7872
2021/12/09,07:30,263.66,215,7917,8132
2021/12/09,08:00,263.19,377,7747,8124
2021/12/09,08:30,263.42,571,7795,8366
2021/12/09,09:00,263.66,814,7653,8467
2021/12/09,09:30,263.9,984,7568,8552
2021/12/09,10:00,261.94,1187,7659,8846
2021/12/09,10:30,263.9,1261,7663,8924
2021/12/09,11:00,263.19,1221,7815,9036
2021/12/09,11:30,263.42,1184,7825,9009
2021/12/09,12:00,262.52,983,7876,8859
2021/12/09,12:30,263.42,911,7890,8801
2021/12/09,13:00,262.06,931,7914,8845
2021/12/09,13:30,262.3,929,7991,8920
2021/12/09,14:00,262.52,958,7954,8912
2021/12/09,14:30,384.8,870,8118,8988
2021/12/09,15:00,379.58,722,8302,9024
2021/12/09,15:30,382.17,480,8521,9001
2021/12/09,16:00,380.6,285,8685,8970
2021/12/09,16:30,400.32,61,9065,9126
2021/12/09,17:00,386.13,50,9687,9737
2021/12/09,17:30,322.47,33,9977,10010
2021/12/09,18:00,323.07,33,10099,10132
2021/12/09,18:30,323.28,33,10171,10204
2021/12/09,19:00,386.13,33,10117,10150
2021/12/09,19:30,400.35,33,10075,10108
2021/12/09,20:00,406.27,33,9891,9924
2021/12/09,20:30,403.26,33,9696,9729
2021/12/09,21:00,399.85,32,9490,9522
2021/12/09,21:30,376.87,31,9197,9228
2021/12/09,22:00,379.45,11,8903,8914
2021/12/09,22:30,376.87,0,8634,8634
2021/12/09,23:00,263.42,0,8327,8327
2021/12/09,23:30,262.68,0,7918,7918
2021/12/10,00:00,263.42,0,7511,7511
2021/12/10,00:30,262.68,0,7122,7122
2021/12/10,01:00,262.74,0,6783,6783
2021/12/10,01:30,262.31,0,6699,6699
2021/12/10,02:00,262.31,0,6640,6640
2021/12/10,02:30,263.19,0,6477,6477
2021/12/10,03:00,262.74,1,6394,6395
2021/12/10,03:30,262.31,0,6313,6313
2021/12/10,04:00,262.68,1,6348,6349
2021/12/10,04:30,262.68,0,6408,6408
2021/12/10,05:00,262.8,3,6560,6563
2021/12/10,05:30,262.18,3,6751,6754
2021/12/10,06:00,262.74,5,6899,6904
2021/12/10,06:30,263.42,4,6850,6854
2021/12/10,07:00,262.18,17,6880,6897
2021/12/10,07:30,262.43,224,7017,7241
2021/12/10,08:00,262.96,614,6765,7379
2021/12/10,08:30,262.3,987,6561,7548
2021/12/10,09:00,263.19,1260,6410,7670
2021/12/10,09:30,263.9,1368,6309,7677
2021/12/10,10:00,263.42,1553,6467,8020
2021/12/10,10:30,263.19,1670,6406,8076
2021/12/10,11:00,263.42,1562,6532,8094
2021/12/10,11:30,262.52,1548,6652,8200
2021/12/10,12:00,263.42,1514,6619,8133
2021/12/10,12:30,263.19,1459,6613,8072
2021/12/10,13:00,263.42,1500,6639,8139
2021/12/10,13:30,262.31,1350,6793,8143
2021/12/10,14:00,262.96,1194,6925,8119
2021/12/10,14:30,261.67,1028,7100,8128
2021/12/10,15:00,262.52,824,7333,8157
2021/12/10,15:30,262.52,483,7789,8272
2021/12/10,16:00,262.74,245,8108,8353
2021/12/10,16:30,262.08,89,8144,8233
2021/12/10,17:00,262.31,102,8543,8645
2021/12/10,17:30,262.06,102,8704,8806
2021/12/10,18:00,262.31,58,8703,8761
2021/12/10,18:30,262.31,39,8621,8660
2021/12/10,19:00,262.52,38,8472,8510
2021/12/10,19:30,262.52,37,8299,8336
2021/12/10,20:00,264.39,19,8114,8133
2021/12/10,20:30,262.31,3,8095,8098
2021/12/10,21:00,263.42,2,7984,7986
2021/12/10,21:30,262.96,4,7837,7841
2021/12/10,22:00,263.19,4,7632,7636
2021/12/10,22:30,262.3,4,7469,7473
2021/12/10,23:00,262.52,4,7244,7248
2021/12/10,23:30,262.74,4,6967,6971
2021/12/11,00:00,263.19,4,6698,6702
2021/12/11,00:30,262.3,4,6471,6475
2021/12/11,01:00,262.93,4,6232,6236
2021/12/11,01:30,263.42,4,6077,6081
2021/12/11,02:00,263.42,6,5902,5908
2021/12/11,02:30,262.74,8,5821,5829
2021/12/11,03:00,262.68,7,5750,5757
2021/12/11,03:30,262.52,7,5720,5727
2021/12/11,04:00,262.74,7,5713,5720
2021/12/11,04:30,262.31,6,5741,5747
2021/12/11,05:00,262.74,7,5868,5875
2021/12/11,05:30,263.42,4,5980,5984
2021/12/11,06:00,262.96,4,6043,6047
2021/12/11,06:30,263.19,5,5978,5983
2021/12/11,07:00,263.42,13,5922,5935
2021/12/11,07:30,263.42,256,5856,6112
2021/12/11,08:00,262.43,610,5819,6429
2021/12/11,08:30,262.18,931,5794,6725
2021/12/11,09:00,262.18,1185,5602,6787
2021/12/11,09:30,263.9,1405,5489,6894
2021/12/11,10:00,262.96,1564,5439,7003
2021/12/11,10:30,262.96,1650,5341,6991
2021/12/11,11:00,263.9,1674,5302,6976
2021/12/11,11:30,263.42,1718,5248,6966
2021/12/11,12:00,262.74,1717,5240,6957
2021/12/11,12:30,262.52,1669,5266,6935
2021/12/11,13:00,262.96,1607,5299,6906
2021/12/11,13:30,262.96,1464,5406,6870
2021/12/11,14:00,262.52,1252,5609,6861
2021/12/11,14:30,262.31,1073,5741,6814
2021/12/11,15:00,262.18,782,6083,6865
2021/12/11,15:30,262.31,502,6317,6819
2021/12/11,16:00,262.31,260,6782,7042
2021/12/11,16:30,261.07,72,7230,7302
2021/12/11,17:00,262.31,83,7640,7723
2021/12/11,17:30,255.39,84,8021,8105
2021/12/11,18:00,262.3,84,8324,8408
2021/12/11,18:30,264.14,30,8525,8555
2021/12/11,19:00,262.68,8,8541,8549
2021/12/11,19:30,262.96,9,8531,8540
2021/12/11,20:00,263.19,9,8494,8503
2021/12/11,20:30,262.43,10,8400,8410
2021/12/11,21:00,262.52,10,8337,8347
2021/12/11,21:30,262.43,12,8266,8278
2021/12/11,22:00,262.96,11,8068,8079
2021/12/11,22:30,262.18,10,7796,7806
2021/12/11,23:00,263.19,9,7504,7513
2021/12/11,23:30,262.74,9,7143,7152
2021/12/12,00:00,262.06,10,6716,6726
2021/12/12,00:30,263.9,10,6402,6412
2021/12/12,01:00,263.55,11,6281,6292
2021/12/12,01:30,263.42,10,6072,6082
2021/12/12,02:00,262.52,9,5915,5924
2021/12/12,02:30,263.9,9,5804,5813
2021/12/12,03:00,263.19,9,5743,5752
2021/12/12,03:30,263.42,9,5726,5735
2021/12/12,04:00,262.43,9,5759,5768
2021/12/12,04:30,263.42,9,5891,5900
2021/12/12,05:00,262.52,8,6088,6096
2021/12/12,05:30,262.52,8,6398,6406
2021/12/12,06:00,262.43,8,6468,6476
2021/12/12,06:30,262.18,8,6820,6828
2021/12/12,07:00,275.41,10,7226,7236
2021/12/12,07:30,279.23,188,7360,7548
2021/12/12,08:00,278.73,392,7120,7512
2021/12/12,08:30,280.23,598,6934,7532
2021/12/12,09:00,279.73,861,6715,7576
2021/12/12,09:30,278.73,1076,6562,7638
2021/12/12,10:00,279.23,1205,6709,7914
2021/12/12,10:30,278.73,1329,6619,7948
2021/12/12,11:00,277.76,1353,6575,7928
2021/12/12,11:30,278.25,1327,6641,7968
2021/12/12,12:00,279.23,1314,6708,8022
2021/12/12,12:30,279.23,1277,6871,8148
2021/12/12,13:00,278.73,995,7110,8105
2021/12/12,13:30,278.73,769,7400,8169
2021/12/12,14:00,278.73,606,7607,8213
2021/12/12,14:30,278.73,534,7856,8390
2021/12/12,15:00,278.73,447,7765,8212
2021/12/12,15:30,278.73,366,7922,8288
2021/12/12,16:00,278.73,294,7920,8214
2021/12/12,16:30,278.25,125,8237,8362
2021/12/12,17:00,278.73,126,8775,8901
2021/12/12,17:30,280.23,125,9015,9140
2021/12/12,18:00,279.23,125,9112,9237
2021/12/12,18:30,278.25,125,9149,9274
2021/12/12,19:00,279.23,124,9157,9281
2021/12/12,19:30,278.73,124,9095,9219
2021/12/12,20:00,279.23,124,9026,9150
2021/12/12,20:30,278.73,124,8840,8964
2021/12/12,21:00,278.73,123,8628,8751
2021/12/12,21:30,278.25,90,8385,8475
2021/12/12,22:00,278.73,17,8098,8115
2021/12/12,22:30,277.28,5,7968,7973
2021/12/12,23:00,278.73,6,7633,7639
2021/12/12,23:30,279.23,6,7211,7217
2021/12/13,00:00,262.18,5,6837,6842
2021/12/13,00:30,262.43,5,6619,6624
2021/12/13,01:00,262.93,5,6313,6318
2021/12/13,01:30,262.18,4,6312,6316
2021/12/13,02:00,262.8,4,6148,6152
2021/12/13,02:30,262.43,7,6051,6058
2021/12/13,03:00,262.43,7,5998,6005
2021/12/13,03:30,262.43,7,6037,6044
2021/12/13,04:00,262.18,7,6014,6021
2021/12/13,04:30,262.43,6,6204,6210
2021/12/13,05:00,262.43,7,6391,6398
2021/12/13,05:30,262.43,3,6657,6660
2021/12/13,06:00,262.25,5,6904,6909
2021/12/13,06:30,262.43,3,7246,7249
2021/12/13,07:00,262.31,3,7582,7585
2021/12/13,07:30,258.46,192,7472,7664
2021/12/13,08:00,261.07,418,7250,7668
2021/12/13,08:30,262.08,437,7147,7584
2021/12/13,09:00,263.9,500,7008,7508
2021/12/13,09:30,263.9,793,6835,7628
2021/12/13,10:00,263.9,921,6700,7621
2021/12/13,10:30,264.14,940,6695,7635
2021/12/13,11:00,263.9,1090,6584,7674
2021/12/13,11:30,264.39,1055,6680,7735
2021/12/13,12:00,263.42,909,6848,7757
2021/12/13,12:30,263.9,930,6674,7604
2021/12/13,13:00,263.9,988,6880,7868
2021/12/13,13:30,263.9,851,7061,7912
2021/12/13,14:00,263.9,853,7104,7957
2021/12/13,14:30,266.5,603,7400,8003
2021/12/13,15:00,266.78,465,7658,8123
2021/12/13,15:30,266.21,279,7832,8111
2021/12/13,16:00,266.21,200,7843,8043
2021/12/13,16:30,266.5,114,8151,8265
2021/12/13,17:00,266.5,123,8634,8757
2021/12/13,17:30,266.78,102,8906,9008
2021/12/13,18:00,266.21,91,8978,9069
2021/12/13,18:30,266.21,90,9050,9140
2021/12/13,19:00,266.5,94,8990,9084
2021/12/13,19:30,265.65,94,8940,9034
2021/12/13,20:00,265.93,93,8843,8936
2021/12/13,20:30,266.21,81,8672,8753
2021/12/13,21:00,266.5,2,8533,8535
2021/12/13,21:30,265.93,4,8302,8306
2021/12/13,22:00,265.93,4,7958,7962
2021/12/13,22:30,266.5,2,7831,7833
2021/12/13,23:00,266.78,2,7542,7544
2021/12/13,23:30,266.5,1,7151,7152
2021/12/14,00:00,266.5,1,6785,6786
2021/12/14,00:30,266.5,1,6494,6495
2021/12/14,01:00,266.78,1,6214,6215
2021/12/14,01:30,266.5,1,6006,6007
2021/12/14,02:00,266.21,1,5848,5849
2021/12/14,02:30,265.93,1,5893,5894
2021/12/14,03:00,266.5,1,6012,6013
2021/12/14,03:30,266.5,1,6001,6002
2021/12/14,04:00,266.5,1,5985,5986
2021/12/14,04:30,266.21,2,6168,6170
2021/12/14,05:00,265.93,2,6350,6352
2021/12/14,05:30,266.21,2,6486,6488
2021/12/14,06:00,266.5,2,6487,6489
2021/12/14,06:30,266.5,1,6858,6859
2021/12/14,07:00,266.21,1,7194,7195
2021/12/14,07:30,266.21,116,7385,7501
2021/12/14,08:00,266.78,289,7206,7495
2021/12/14,08:30,265.93,465,7148,7613
2021/12/14,09:00,266.21,596,6938,7534
2021/12/14,09:30,266.21,841,6905,7746
2021/12/14,10:00,266.5,1102,6682,7784
2021/12/14,10:30,266.5,1249,6678,7927
2021/12/14,11:00,266.78,1319,6654,7973
2021/12/14,11:30,267.08,1358,6569,7927
2021/12/14,12:00,266.5,1312,6593,7905
2021/12/14,12:30,266.78,1296,6640,7936
2021/12/14,13:00,266.5,1338,6757,8095
2021/12/14,13:30,266.5,1148,6979,8127
2021/12/14,14:00,266.5,940,7276,8216
2021/12/14,14:30,266.5,775,7245,8020
2021/12/14,15:00,266.21,523,7540,8063
2021/12/14,15:30,266.5,301,7835,8136
2021/12/14,16:00,266.21,157,7990,8147
2021/12/14,16:30,266.5,89,8383,8472
2021/12/14,17:00,266.5,101,8962,9063
2021/12/14,17:30,266.5,104,9231,9335
2021/12/14,18:00,387.4,109,9293,9402
2021/12/14,18:30,379.52,104,9349,9453
2021/12/14,19:00,266.21,110,9272,9382
2021/12/14,19:30,266.78,110,9194,9304
2021/12/14,20:00,265.93,111,9050,9161
2021/12/14,20:30,265.38,59,8905,8964
2021/12/14,21:00,265.65,10,8665,8675
2021/12/14,21:30,265.65,6,8420,8426
2021/12/14,22:00,265.93,9,8109,8118
2021/12/14,22:30,265.93,15,7927,7942
2021/12/14,23:00,266.78,13,7592,7605
2021/12/14,23:30,266.5,16,7182,7198
2021/12/15,00:00:00,266.5,8,6824,6832
2021/12/15,00:30:00,266.21,6,6531,6537
2021/12/15,01:00:00,265.93,6,6291,6297
2021/12/15,01:30:00,266.5,5,6046,6051
2021/12/15,02:00:00,265.65,5,5922,5927
2021/12/15,02:30:00,266.21,5,5926,5931
2021/12/15,03:00:00,265.93,5,5959,5964
2021/12/15,03:30:00,266.21,5,5945,5950
2021/12/15,04:00:00,266.5,6,5970,5976
2021/12/15,04:30:00,266.5,6,6068,6074
2021/12/15,05:00:00,266.5,5,6270,6275
2021/12/15,05:30:00,266.21,8,6383,6391
2021/12/15,06:00:00,266.5,20,6575,6595
2021/12/15,06:30:00,266.21,26,6932,6958
2021/12/15,07:00:00,266.21,20,7294,7314
2021/12/15,07:30:00,265.93,179,7416,7595
2021/12/15,08:00:00,265.93,435,7233,7668
2021/12/15,08:30:00,265.93,708,7165,7873
2021/12/15,09:00:00,265.65,967,6959,7926
2021/12/15,09:30:00,265.65,1201,6867,8068
2021/12/15,10:00:00,265.93,1414,6846,8260
2021/12/15,10:30:00,266.21,1471,6852,8323
2021/12/15,11:00:00,266.5,1521,6839,8360
2021/12/15,11:30:00,266.5,1650,6730,8380
2021/12/15,12:00:00,265.38,1649,6685,8334
2021/12/15,12:30:00,265.93,1694,6630,8324
2021/12/15,13:00:00,266.5,1616,6741,8357
2021/12/15,13:30:00,266.78,1540,6866,8406
2021/12/15,14:00:00,265.93,1448,6852,8300
2021/12/15,14:30:00,266.78,1299,6930,8229
2021/12/15,15:00:00,266.5,1024,7176,8200
2021/12/15,15:30:00,266.5,688,7527,8215
2021/12/15,16:00:00,266.21,408,7830,8238
2021/12/15,16:30:00,266.21,92,8254,8346
2021/12/15,17:00:00,266.21,100,8940,9040
2021/12/15,17:30:00,266.5,100,9285,9385
2021/12/15,18:00:00,265.93,98,9459,9557
2021/12/15,18:30:00,265.65,73,9538,9611
2021/12/15,19:00:00,265.93,29,9559,9588
2021/12/15,19:30:00,265.93,5,9561,9566
2021/12/15,20:00:00,265.93,5,9447,9452
2021/12/15,20:30:00,265.65,6,9297,9303
2021/12/15,21:00:00,265.65,6,9080,9086
2021/12/15,21:30:00,265.93,6,8806,8812
2021/12/15,22:00:00,265.93,7,8432,8439
2021/12/15,22:30:00,266.21,5,8226,8231
2021/12/15,23:00:00,265.93,5,7875,7880
2021/12/15,23:30:00,266.5,1,7476,7477
2021/12/16,00:00:00,266.21,2,7093,7095
2021/12/16,00:30:00,266.21,2,6894,6896
2021/12/16,01:00:00,267.08,2,6714,6716
2021/12/16,01:30:00,265.93,2,6488,6490
2021/12/16,02:00:00,266.5,2,6340,6342
2021/12/16,02:30:00,265.65,2,6217,6219
2021/12/16,03:00:00,264.85,5,6171,6176
2021/12/16,03:30:00,264.58,4,6156,6160
2021/12/16,04:00:00,264.85,5,6182,6187
2021/12/16,04:30:00,264.58,3,6306,6309
2021/12/16,05:00:00,264.58,3,6498,6501
2021/12/16,05:30:00,265.11,3,6723,6726
2021/12/16,06:00:00,265.38,3,6882,6885
2021/12/16,06:30:00,265.38,2,7306,7308
2021/12/16,07:00:00,265.93,0,7747,7747
2021/12/16,07:30:00,266.78,177,7798,7975
2021/12/16,08:00:00,266.5,350,7651,8001
2021/12/16,08:30:00,266.5,598,7692,8290
2021/12/16,09:00:00,266.21,944,7541,8485
2021/12/16,09:30:00,265.93,1154,7444,8598
2021/12/16,10:00:00,266.78,1058,7368,8426
2021/12/16,10:30:00,265.65,1507,7131,8638
2021/12/16,11:00:00,265.93,1320,7242,8562
2021/12/16,11:30:00,266.21,1267,7139,8406
2021/12/16,12:00:00,265.65,1148,7250,8398
2021/12/16,12:30:00,266.5,1128,7235,8363
2021/12/16,13:00:00,266.78,1277,7163,8440
2021/12/16,13:30:00,265.65,1262,7196,8458
2021/12/16,14:00:00,265.65,1148,7421,8569
2021/12/16,14:30:00,265.65,949,7696,8645
2021/12/16,15:00:00,265.65,755,7928,8683
2021/12/16,15:30:00,266.21,637,8209,8846
2021/12/16,16:00:00,266.78,359,8363,8722
2021/12/16,16:30:00,266.21,53,8940,8993
2021/12/16,17:00:00,266.5,1,9643,9644
2021/12/16,17:30:00,377.6,0,9975,9975
2021/12/16,18:00:00,383.86,0,10146,10146
2021/12/16,18:30:00,385.76,0,10168,10168
2021/12/16,19:00:00,377.93,1,10144,10145
2021/12/16,19:30:00,267.08,1,10039,10040
2021/12/16,20:00:00,265.93,1,9909,9910
2021/12/16,20:30:00,265.93,1,9682,9683
2021/12/16,21:00:00,265.93,0,9413,9413
2021/12/16,21:30:00,266.5,0,9172,9172
2021/12/16,22:00:00,266.78,0,8803,8803
2021/12/16,22:30:00,266.78,0,8612,8612
2021/12/16,23:00:00,265.93,1,8247,8248
2021/12/16,23:30:00,266.21,0,7896,7896
2021/12/17,00:00,265.11,0,7462,7462
2021/12/17,00:30,266.21,0,7090,7090
2021/12/17,01:00,264.85,1,6778,6779
2021/12/17,01:30,265.38,1,6501,6502
2021/12/17,02:00,264.07,0,6597,6597
2021/12/17,02:30,264.33,1,6455,6456
2021/12/17,03:00,264.33,1,6364,6365
2021/12/17,03:30,264.07,1,6306,6307
2021/12/17,04:00,264.33,0,6299,6299
2021/12/17,04:30,264.58,0,6382,6382
2021/12/17,05:00,264.07,0,6544,6544
2021/12/17,05:30,264.07,0,6760,6760
2021/12/17,06:00,264.33,0,6933,6933
2021/12/17,06:30,264.85,0,7077,7077
2021/12/17,07:00,264.07,3,7385,7388
2021/12/17,07:30,261.67,221,7601,7822
2021/12/17,08:00,255.94,327,7716,8043
2021/12/17,08:30,254.07,413,7911,8324
2021/12/17,09:00,254.14,571,7958,8529
2021/12/17,09:30,254.1,692,7926,8618
2021/12/17,10:00,254.14,825,7912,8737
2021/12/17,10:30,254.07,1034,7677,8711
2021/12/17,11:00,254.12,981,7840,8821
2021/12/17,11:30,254,967,8077,9044
2021/12/17,12:00,260.68,1002,8223,9225
2021/12/17,12:30,263.19,950,8658,9608
2021/12/17,13:00,267.08,845,8951,9796
2021/12/17,13:30,405.53,824,9197,10021
2021/12/17,14:00,396.17,787,9342,10129
2021/12/17,14:30,405.53,642,9502,10144
2021/12/17,15:00,402.33,535,9644,10179
2021/12/17,15:30,402.33,413,9746,10159
2021/12/17,16:00,399.68,223,9824,10047
2021/12/17,16:30,405.62,2,9714,9716
2021/12/17,17:00,402.61,2,9952,9954
2021/12/17,17:30,399.68,2,10011,10013
2021/12/17,18:00,402.61,2,9912,9914
2021/12/17,18:30,405.62,1,9732,9733
2021/12/17,19:00,402.61,1,9449,9450
2021/12/17,19:30,402.61,2,9212,9214
2021/12/17,20:00,263.19,1,8991,8992
2021/12/17,20:30,262.74,3,8942,8945
2021/12/17,21:00,266.5,5,8778,8783
2021/12/17,21:30,263.42,1,8637,8638
2021/12/17,22:00,262.96,2,8401,8403
2021/12/17,22:30,263.42,2,8210,8212
2021/12/17,23:00,262.74,3,7966,7969
2021/12/17,23:30,262.96,3,7632,7635
2021/12/18,00:00,265.93,3,7298,7301
2021/12/18,00:30,265.93,8,6952,6960
2021/12/18,01:00,266.5,4,6870,6874
2021/12/18,01:30,266.21,2,6788,6790
2021/12/18,02:00,265.93,2,6610,6612
2021/12/18,02:30,265.38,2,6494,6496
2021/12/18,03:00,265.93,2,6398,6400
2021/12/18,03:30,265.93,3,6391,6394
2021/12/18,04:00,265.93,1,6393,6394
2021/12/18,04:30,266.21,3,6423,6426
2021/12/18,05:00,265.93,3,6557,6560
2021/12/18,05:30,266.5,2,6692,6694
2021/12/18,06:00,265.93,3,6771,6774
2021/12/18,06:30,266.21,3,6804,6807
2021/12/18,07:00,265.65,9,6831,6840
2021/12/18,07:30,265.11,232,6897,7129
2021/12/18,08:00,265.65,573,6908,7481
2021/12/18,08:30,265.11,935,6932,7867
2021/12/18,09:00,265.11,1160,7010,8170
2021/12/18,09:30,265.38,1400,7050,8450
2021/12/18,10:00,265.38,1577,7140,8717
2021/12/18,10:30,265.38,1675,7130,8805
2021/12/18,11:00,265.11,1751,7107,8858
2021/12/18,11:30,265.11,1783,7016,8799
2021/12/18,12:00,265.65,1757,6853,8610
2021/12/18,12:30,265.38,1723,6933,8656
2021/12/18,13:00,265.11,1692,6704,8396
2021/12/18,13:30,265.38,1607,6749,8356
2021/12/18,14:00,265.38,1479,6813,8292
2021/12/18,14:30,265.65,1248,7106,8354
2021/12/18,15:00,264.58,922,7387,8309
2021/12/18,15:30,265.38,574,7811,8385
2021/12/18,16:00,264.85,359,8314,8673
2021/12/18,16:30,264.85,33,8792,8825
2021/12/18,17:00,265.65,4,9294,9298
2021/12/18,17:30,265.38,3,9766,9769
2021/12/18,18:00,265.38,4,10129,10133
2021/12/18,18:30,382.18,5,10260,10265
2021/12/18,19:00,382.18,5,10251,10256
2021/12/18,19:30,382.18,4,10205,10209
2021/12/18,20:00,382.12,5,10093,10098
2021/12/18,20:30,379.54,6,9966,9972
2021/12/18,21:00,378.73,6,9813,9819
2021/12/18,21:30,264.85,9,9696,9705
2021/12/18,22:00,265.38,9,9382,9391
2021/12/18,22:30,265.38,11,9039,9050
2021/12/18,23:00,265.11,14,8643,8657
2021/12/18,23:30,265.65,15,8168,8183
2021/12/19,00:00,266.21,15,7807,7822
2021/12/19,00:30,266.21,14,7309,7323
2021/12/19,01:00,265.93,14,7084,7098
2021/12/19,01:30,265.38,16,6792,6808
2021/12/19,02:00,266.21,15,6595,6610
2021/12/19,02:30,266.5,14,6453,6467
2021/12/19,03:00,266.78,14,6353,6367
2021/12/19,03:30,266.5,12,6354,6366
2021/12/19,04:00,265.65,11,6381,6392
2021/12/19,04:30,264.85,13,6531,6544
2021/12/19,05:00,265.93,13,6748,6761
2021/12/19,05:30,265.11,13,7074,7087
2021/12/19,06:00,265.11,10,7389,7399
2021/12/19,06:30,266.5,11,7910,7921
2021/12/19,07:00,265.38,15,8147,8162
2021/12/19,07:30,264.85,283,8278,8561
2021/12/19,08:00,265.65,636,7845,8481
2021/12/19,08:30,265.65,984,7672,8656
2021/12/19,09:00,264.33,1255,7469,8724
2021/12/19,09:30,266.21,1537,7397,8934
2021/12/19,10:00,263.9,1742,7198,8940
2021/12/19,10:30,264.51,1805,7112,8917
2021/12/19,11:00,264.89,1879,7080,8959
2021/12/19,11:30,264.63,1819,7024,8843
2021/12/19,12:00,264.56,1889,7009,8898
2021/12/19,12:30,264.93,1860,7019,8879
2021/12/19,13:00,264.89,1752,7190,8942
2021/12/19,13:30,263.66,1678,7390,9068
2021/12/19,14:00,262.8,1480,7639,9119
2021/12/19,14:30,462.44,1305,7961,9266
2021/12/19,15:00,466.09,1017,8256,9273
2021/12/19,15:30,466.08,678,8662,9340
2021/12/19,16:00,408.13,341,9041,9382
2021/12/19,16:30,404.53,46,9617,9663
2021/12/19,17:00,404.52,3,10370,10373
2021/12/19,17:30,402.35,4,10759,10763
2021/12/19,18:00,402.34,4,10988,10992
2021/12/19,18:30,398.63,6,11109,11115
2021/12/19,19:00,400.83,7,11119,11126
2021/12/19,19:30,584.92,8,11156,11164
2021/12/19,20:00,580.35,7,11062,11069
2021/12/19,20:30,575.21,8,10905,10913
2021/12/19,21:00,262.3,8,10657,10665
2021/12/19,21:30,262.8,6,10336,10342
2021/12/19,22:00,262.43,5,9892,9897
2021/12/19,22:30,262.8,5,9578,9583
2021/12/19,23:00,262.56,2,9041,9043
2021/12/19,23:30,262.43,1,8519,8520
2021/12/20,00:00,262.43,2,7945,7947
2021/12/20,00:30,263.66,1,7510,7511
2021/12/20,01:00,262.06,1,7096,7097
2021/12/20,01:30,263.19,1,6796,6797
2021/12/20,02:00,262.52,4,6753,6757
2021/12/20,02:30,263.9,4,6742,6746
2021/12/20,03:00,262.31,5,6691,6696
2021/12/20,03:30,263.19,6,6665,6671
2021/12/20,04:00,262.52,5,6690,6695
2021/12/20,04:30,263.42,5,6797,6802
2021/12/20,05:00,262.08,12,7078,7090
2021/12/20,05:30,263.19,12,7398,7410
2021/12/20,06:00,262.31,10,7702,7712
2021/12/20,06:30,262.96,11,8239,8250
2021/12/20,07:00,263.42,9,8811,8820
2021/12/20,07:30,263.19,150,9193,9343
2021/12/20,08:00,262.52,218,9181,9399
2021/12/20,08:30,266.5,285,9398,9683
2021/12/20,09:00,266.21,651,9466,10117
2021/12/20,09:30,266.5,1010,9443,10453
2021/12/20,10:00,266.21,1254,9365,10619
2021/12/20,10:30,266.5,1380,9369,10749
2021/12/20,11:00,266.5,1472,9238,10710
2021/12/20,11:30,266.21,1406,9187,10593
2021/12/20,12:00,263.42,1392,9444,10836
2021/12/20,12:30,378.54,772,9846,10618
2021/12/20,13:00,399.2,639,10036,10675
2021/12/20,13:30,402.32,562,10316,10878
2021/12/20,14:00,405.53,541,10650,11191
2021/12/20,14:30,402.32,429,10945,11374
2021/12/20,15:00,402.32,355,11058,11413
2021/12/20,15:30,383.65,315,11270,11585
2021/12/20,16:00,367.85,176,11337,11513
2021/12/20,16:30,338.65,15,11717,11732
2021/12/20,17:00,338.64,13,12134,12147
2021/12/20,17:30,1982.43,12,12460,12472
2021/12/20,18:00,1612.26,11,12628,12639
2021/12/20,18:30,1617.75,12,12675,12687
2021/12/20,19:00,1577.5,1,12623,12624
2021/12/20,19:30,2025.76,8,12466,12474
2021/12/20,20:00,338.6,7,12306,12313
2021/12/20,20:30,338.6,10,12047,12057
2021/12/20,21:00,390.25,10,11669,11679
2021/12/20,21:30,390.25,12,11281,11293
2021/12/20,22:00,384.67,7,10749,10756
2021/12/20,22:30,266.21,7,10320,10327
2021/12/20,23:00,266.21,12,9689,9701
2021/12/20,23:30,266.21,11,9068,9079
2021/12/21,00:00,266.21,10,8453,8463
2021/12/21,00:30,266.21,6,7938,7944
2021/12/21,01:00,266.5,8,7494,7502
2021/12/21,01:30,266.5,11,7538,7549
2021/12/21,02:00,266.21,15,7318,7333
2021/12/21,02:30,266.21,15,7163,7178
2021/12/21,03:00,266.5,15,7109,7124
2021/12/21,03:30,265.65,15,7078,7093
2021/12/21,04:00,266.21,8,7143,7151
2021/12/21,04:30,266.5,11,7232,7243
2021/12/21,05:00,266.5,10,7488,7498
2021/12/21,05:30,266.21,11,7880,7891
2021/12/21,06:00,266.5,5,8107,8112
2021/12/21,06:30,266.5,4,8732,8736
2021/12/21,07:00,266.21,4,9207,9211
2021/12/21,07:30,261.51,218,9756,9974
2021/12/21,08:00,255.32,347,9695,10042
2021/12/21,08:30,255.12,431,9988,10419
2021/12/21,09:00,343.37,405,10174,10579
2021/12/21,09:30,305.31,456,10400,10856
2021/12/21,10:00,306.16,529,10390,10919
2021/12/21,10:30,306.77,847,10501,11348
2021/12/21,11:00,307.07,1032,10498,11530
2021/12/21,11:30,308.68,1087,10500,11587
2021/12/21,12:00,307.03,1152,10506,11658
2021/12/21,12:30,311.98,1176,10435,11611
2021/12/21,13:00,311.98,1037,10506,11543
2021/12/21,13:30,311.98,790,10505,11295
2021/12/21,14:00,504.84,789,10535,11324
2021/12/21,14:30,510.79,880,10481,11361
2021/12/21,15:00,510.77,745,10629,11374
2021/12/21,15:30,504.47,527,10878,11405
2021/12/21,16:00,484.78,303,11053,11356
2021/12/21,16:30,478.44,102,11450,11552
2021/12/21,17:00,2431.47,116,12036,12152
2021/12/21,17:30,2584.74,120,12249,12369
2021/12/21,18:00,2042.88,120,12417,12537
2021/12/21,18:30,2090.19,120,12444,12564
2021/12/21,19:00,490.14,105,12412,12517
2021/12/21,19:30,489.88,96,12385,12481
2021/12/21,20:00,478.74,96,12230,12326
2021/12/21,20:30,475.29,99,12036,12135
2021/12/21,21:00,487.06,98,11696,11794
2021/12/21,21:30,547.08,9,11476,11485
2021/12/21,22:00,535.18,4,10903,10907
2021/12/21,22:30,547.08,4,10578,10582
2021/12/21,23:00,266.5,5,9947,9952
2021/12/21,23:30,266.21,7,9217,9224
2021/12/22,00:00,265.65,5,8597,8602
2021/12/22,00:30,266.5,6,8005,8011
2021/12/22,01:00,266.21,3,7665,7668
2021/12/22,01:30,266.21,2,7568,7570
2021/12/22,02:00,266.21,1,7380,7381
2021/12/22,02:30,266.21,1,7216,7217
2021/12/22,03:00,266.78,2,7163,7165
2021/12/22,03:30,266.21,1,7129,7130
2021/12/22,04:00,266.5,1,7092,7093
2021/12/22,04:30,266.78,1,7277,7278
2021/12/22,05:00,266.5,1,7510,7511
2021/12/22,05:30,355.24,2,7909,7911
2021/12/22,06:00,357.34,1,8002,8003
2021/12/22,06:30,352.32,1,8498,8499
2021/12/22,07:00,305.25,3,9156,9159
2021/12/22,07:30,364.13,215,9531,9746
2021/12/22,08:00,341.54,585,9296,9881
2021/12/22,08:30,337.22,914,9169,10083
2021/12/22,09:00,266.78,1193,9032,10225
2021/12/22,09:30,266.21,1525,9024,10549
2021/12/22,10:00,266.21,1689,8910,10599
2021/12/22,10:30,265.93,1770,8866,10636
2021/12/22,11:00,266.5,1788,8875,10663
2021/12/22,11:30,265.65,1836,8824,10660
2021/12/22,12:00,266.21,1825,8931,10756
2021/12/22,12:30,266.21,1792,9054,10846
2021/12/22,13:00,266.21,1760,9316,11076
2021/12/22,13:30,266.21,1453,9474,10927
2021/12/22,14:00,265.93,1315,9860,11175
2021/12/22,14:30,266.21,1140,10131,11271
2021/12/22,15:00,266.21,1049,10343,11392
2021/12/22,15:30,266.5,692,10566,11258
2021/12/22,16:00,257.43,341,10849,11190
2021/12/22,16:30,382.11,82,11319,11401
2021/12/22,17:00,320.58,103,11810,11913
2021/12/22,17:30,319.62,106,12026,12132
2021/12/22,18:00,320.04,107,12181,12288
2021/12/22,18:30,320.53,104,12281,12385
2021/12/22,19:00,351.57,101,12186,12287
2021/12/22,19:30,384.43,104,12095,12199
2021/12/22,20:00,384.41,104,11926,12030
2021/12/22,20:30,377.36,76,11737,11813
2021/12/22,21:00,379.62,1,11451,11452
2021/12/22,21:30,263.82,2,11040,11042
2021/12/22,22:00,263.33,1,10561,10562
2021/12/22,22:30,263.82,2,10189,10191
2021/12/22,23:00,263.82,2,9607,9609
2021/12/22,23:30,264.33,2,9017,9019
2021/12/23,00:00,376.3,1,8397,8398
2021/12/23,00:30,262.43,1,8010,8011
2021/12/23,01:00,262.25,2,7711,7713
2021/12/23,01:30,262.06,2,7370,7372
2021/12/23,02:00,264.93,2,7147,7149
2021/12/23,02:30,264.68,2,7026,7028
2021/12/23,03:00,265.01,2,6919,6921
2021/12/23,03:30,264.76,2,6898,6900
2021/12/23,04:00,264.93,1,6914,6915
2021/12/23,04:30,264.89,1,7069,7070
2021/12/23,05:00,265.27,1,7320,7321
2021/12/23,05:30,264.89,1,7715,7716
2021/12/23,06:00,264.89,1,8025,8026
2021/12/23,06:30,262.93,1,8455,8456
2021/12/23,07:00,261.51,5,9074,9079
2021/12/23,07:30,261.51,180,9432,9612
2021/12/23,08:00,261.51,364,9100,9464
2021/12/23,08:30,261.72,605,9211,9816
2021/12/23,09:00,261.09,744,8994,9738
2021/12/23,09:30,264.14,907,8841,9748
2021/12/23,10:00,266.5,906,8753,9659
2021/12/23,10:30,266.78,1116,8648,9764
2021/12/23,11:00,265.93,1102,8669,9771
2021/12/23,11:30,266.5,1154,8783,9937
2021/12/23,12:00,265.93,1125,8906,10031
2021/12/23,12:30,265.93,911,9263,10174
2021/12/23,13:00,265.93,670,9572,10242
2021/12/23,13:30,266.5,497,9694,10191
2021/12/23,14:00,265.65,429,9850,10279
2021/12/23,14:30,547.08,414,10107,10521
2021/12/23,15:00,547.08,364,10253,10617
2021/12/23,15:30,478.27,203,10492,10695
2021/12/23,16:00,477.5,121,10711,10832
2021/12/23,16:30,478.61,28,11139,11167
2021/12/23,17:00,490.54,27,11689,11716
2021/12/23,17:30,490.01,3,12025,12028
2021/12/23,18:00,458.2,3,12127,12130
2021/12/23,18:30,435.33,4,12180,12184
2021/12/23,19:00,490.77,2,12082,12084
2021/12/23,19:30,489.37,4,12014,12018
2021/12/23,20:00,489.12,2,11805,11807
2021/12/23,20:30,485.55,2,11526,11528
2021/12/23,21:00,472.68,3,11195,11198
2021/12/23,21:30,468.04,3,10842,10845
2021/12/23,22:00,468.04,3,10399,10402
2021/12/23,22:30,517.69,1,10091,10092
2021/12/23,23:00,378.96,1,9630,9631
2021/12/23,23:30,266.5,1,9067,9068
2021/12/23,00:00:00,263.57,1,8397,8398
2021/12/23,00:30:00,262.43,1,8010,8011
2021/12/23,01:00:00,262.25,2,7711,7713
2021/12/23,01:30:00,262.06,2,7370,7372
2021/12/23,02:00:00,264.93,2,7147,7149
2021/12/23,02:30:00,264.68,2,7026,7028
2021/12/23,03:00:00,265.01,2,6919,6921
2021/12/23,03:30:00,264.76,2,6898,6900
2021/12/23,04:00:00,264.93,1,6914,6915
2021/12/23,04:30:00,264.89,1,7069,7070
2021/12/23,05:00:00,265.27,1,7320,7321
2021/12/23,05:30:00,264.89,1,7715,7716
2021/12/23,06:00:00,264.89,1,8025,8026
2021/12/23,06:30:00,262.93,1,8455,8456
2021/12/23,07:00:00,261.51,5,9074,9079
2021/12/23,07:30:00,261.51,180,9432,9612
2021/12/23,08:00:00,261.51,364,9100,9464
2021/12/23,08:30:00,261.72,605,9211,9816
2021/12/23,09:00:00,261.09,744,8994,9738
2021/12/23,09:30:00,264.14,907,8841,9748
2021/12/23,10:00:00,266.5,906,8753,9659
2021/12/23,10:30:00,266.78,1116,8648,9764
2021/12/23,11:00:00,265.93,1102,8669,9771
2021/12/23,11:30:00,266.5,1154,8783,9937
2021/12/23,12:00:00,265.93,1125,8906,10031
2021/12/23,12:30:00,265.93,911,9263,10174
2021/12/23,13:00:00,265.93,670,9572,10242
2021/12/23,13:30:00,266.5,497,9694,10191
2021/12/23,14:00:00,265.65,429,9850,10279
2021/12/23,14:30:00,547.08,414,10107,10521
2021/12/23,15:00:00,547.08,364,10253,10617
2021/12/23,15:30:00,478.27,203,10492,10695
2021/12/23,16:00:00,477.5,121,10711,10832
2021/12/23,16:30:00,478.61,28,11139,11167
2021/12/23,17:00:00,490.54,27,11689,11716
2021/12/23,17:30:00,490.01,3,12025,12028
2021/12/23,18:00:00,458.2,3,12127,12130
2021/12/23,18:30:00,435.33,4,12180,12184
2021/12/23,19:00:00,490.77,2,12082,12084
2021/12/23,19:30:00,489.37,4,12014,12018
2021/12/23,20:00:00,489.12,2,11805,11807
2021/12/23,20:30:00,485.55,2,11526,11528
2021/12/23,21:00:00,472.68,3,11195,11198
2021/12/23,21:30:00,468.04,3,10842,10845
2021/12/23,22:00:00,468.04,3,10399,10402
2021/12/23,22:30:00,517.69,1,10091,10092
2021/12/23,23:00:00,378.96,1,9630,9631
2021/12/23,23:30:00,266.5,1,9067,9068
2021/12/24,00:00,266.5,1,8533,8534
2021/12/24,00:30,266.5,1,8046,8047
2021/12/24,01:00,266.5,1,7628,7629
2021/12/24,01:30,266.21,1,7431,7432
2021/12/24,02:00,266.21,1,7313,7314
2021/12/24,02:30,266.5,1,7125,7126
2021/12/24,03:00,266.21,2,6981,6983
2021/12/24,03:30,266.21,2,6901,6903
2021/12/24,04:00,265.93,3,6908,6911
2021/12/24,04:30,265.93,3,6993,6996
2021/12/24,05:00,266.5,3,7135,7138
2021/12/24,05:30,265.93,3,7350,7353
2021/12/24,06:00,266.5,4,7562,7566
2021/12/24,06:30,265.93,3,7810,7813
2021/12/24,07:00,266.5,2,8141,8143
2021/12/24,07:30,376.66,102,8443,8545
2021/12/24,08:00,384.81,240,8488,8728
2021/12/24,08:30,371.63,360,8507,8867
2021/12/24,09:00,266.21,432,8668,9100
2021/12/24,09:30,266.5,525,8751,9276
2021/12/24,10:00,266.78,677,8864,9541
2021/12/24,10:30,266.21,937,8788,9725
2021/12/24,11:00,266.78,1145,8889,10034
2021/12/24,11:30,266.21,951,8944,9895
2021/12/24,12:00,266.21,989,9023,10012
2021/12/24,12:30,266.21,977,8966,9943
2021/12/24,13:00,266.5,746,9232,9978
2021/12/24,13:30,266.5,768,9353,10121
2021/12/24,14:00,266.21,653,9459,10112
2021/12/24,14:30,322.75,579,9658,10237
2021/12/24,15:00,329.44,431,9890,10321
2021/12/24,15:30,379.16,396,10193,10589
2021/12/24,16:00,382.4,258,10390,10648
2021/12/24,16:30,378.03,32,10408,10440
2021/12/24,17:00,378.03,29,10702,10731
2021/12/24,17:30,382.4,29,10821,10850
2021/12/24,18:00,378.24,4,10789,10793
2021/12/24,18:30,382.56,2,10620,10622
2021/12/24,19:00,380.44,0,10331,10331
2021/12/24,19:30,380.44,0,10084,10084
2021/12/24,20:00,380.34,0,9791,9791
2021/12/24,20:30,379.91,1,9738,9739
2021/12/24,21:00,266.21,1,9556,9557
2021/12/24,21:30,266.5,1,9414,9415
2021/12/24,22:00,266.5,1,9196,9197
2021/12/24,22:30,266.5,1,8988,8989
2021/12/24,23:00,266.21,1,8670,8671
2021/12/24,23:30,266.21,0,8287,8287
2021/12/25,00:00,266.5,0,7913,7913
2021/12/25,00:30,266.5,0,7599,7599
2021/12/25,01:00,265.65,0,7284,7284
2021/12/25,01:30,266.5,0,7024,7024
2021/12/25,02:00,266.78,0,6954,6954
2021/12/25,02:30,266.21,0,6825,6825
2021/12/25,03:00,266.5,0,6845,6845
2021/12/25,03:30,266.5,0,6800,6800
2021/12/25,04:00,266.21,0,6801,6801
2021/12/25,04:30,266.5,0,6840,6840
2021/12/25,05:00,266.5,0,6933,6933
2021/12/25,05:30,266.21,0,7081,7081
2021/12/25,06:00,266.21,0,7155,7155
2021/12/25,06:30,266.5,0,7226,7226
2021/12/25,07:00,266.5,0,7243,7243
2021/12/25,07:30,266.21,167,7341,7508
2021/12/25,08:00,266.21,373,7439,7812
2021/12/25,08:30,266.5,663,7393,8056
2021/12/25,09:00,266.5,1053,7340,8393
2021/12/25,09:30,265.65,1212,7265,8477
2021/12/25,10:00,266.78,1355,7119,8474
2021/12/25,10:30,266.5,1473,7045,8518
2021/12/25,11:00,265.93,1616,7010,8626
2021/12/25,11:30,266.78,1746,6995,8741
2021/12/25,12:00,266.5,1627,7120,8747
2021/12/25,12:30,266.21,1591,7074,8665
2021/12/25,13:00,266.5,1656,6876,8532
2021/12/25,13:30,266.21,1508,6882,8390
2021/12/25,14:00,266.5,1495,6965,8460
2021/12/25,14:30,266.5,1346,7171,8517
2021/12/25,15:00,266.5,1127,7403,8530
2021/12/25,15:30,266.78,810,7911,8721
2021/12/25,16:00,265.93,452,8490,8942
2021/12/25,16:30,266.21,56,9038,9094
2021/12/25,17:00,266.78,38,9691,9729
2021/12/25,17:30,379.21,0,10268,10268
2021/12/25,18:00,385.2,0,10810,10810
2021/12/25,18:30,385.2,0,11008,11008
2021/12/25,19:00,354.44,0,11016,11016
2021/12/25,19:30,342.77,0,11083,11083
2021/12/25,20:00,385.2,0,11041,11041
2021/12/25,20:30,378.93,0,10962,10962
2021/12/25,21:00,374.48,0,10820,10820
2021/12/25,21:30,375.5,0,10651,10651
2021/12/25,22:00,331.82,0,10289,10289
2021/12/25,22:30,331.77,0,9976,9976
2021/12/25,23:00,367.06,0,9452,9452
2021/12/25,23:30,303.21,1,8872,8873
2021/12/26,00:00,266.5,2,8287,8289
2021/12/26,00:30,266.5,3,7760,7763
2021/12/26,01:00,266.21,4,7305,7309
2021/12/26,01:30,266.5,4,6978,6982
2021/12/26,02:00,266.21,3,7025,7028
2021/12/26,02:30,265.93,3,6847,6850
2021/12/26,03:00,266.5,3,6728,6731
2021/12/26,03:30,266.5,2,6709,6711
2021/12/26,04:00,266.21,3,6719,6722
2021/12/26,04:30,266.5,3,6898,6901
2021/12/26,05:00,267.37,3,7131,7134
2021/12/26,05:30,265.93,3,7537,7540
2021/12/26,06:00,266.5,3,7704,7707
2021/12/26,06:30,265.93,2,8166,8168
2021/12/26,07:00,266.78,4,8766,8770
2021/12/26,07:30,266.5,267,9014,9281
2021/12/26,08:00,266.5,608,8640,9248
2021/12/26,08:30,266.21,952,8367,9319
2021/12/26,09:00,265.65,1318,8104,9422
2021/12/26,09:30,266.21,1605,7815,9420
2021/12/26,10:00,266.78,1764,7615,9379
2021/12/26,10:30,266.5,1856,7457,9313
2021/12/26,11:00,266.5,1925,7313,9238
2021/12/26,11:30,266.5,1951,7189,9140
2021/12/26,12:00,266.78,1952,7112,9064
2021/12/26,12:30,266.5,1927,7221,9148
2021/12/26,13:00,266.21,1859,7290,9149
2021/12/26,13:30,266.5,1781,7408,9189
2021/12/26,14:00,266.78,1667,7581,9248
2021/12/26,14:30,266.21,1481,7841,9322
2021/12/26,15:00,266.78,1173,8237,9410
2021/12/26,15:30,266.5,834,8700,9534
2021/12/26,16:00,336.25,451,9117,9568
2021/12/26,16:30,335.05,94,9701,9795
2021/12/26,17:00,332.69,86,10585,10671
2021/12/26,17:30,333.64,92,11227,11319
2021/12/26,18:00,334.01,89,11553,11642
2021/12/26,18:30,2055.12,102,11751,11853
2021/12/26,19:00,1943.95,104,11827,11931
2021/12/26,19:30,1982.43,109,11893,12002
2021/12/26,20:00,2025.76,108,11829,11937
2021/12/26,20:30,2003.61,105,11655,11760
2021/12/26,21:00,381.15,58,11447,11505
2021/12/26,21:30,380.59,2,11188,11190
2021/12/26,22:00,322.88,2,10674,10676
2021/12/26,22:30,322.87,2,10261,10263
2021/12/26,23:00,366.03,2,9651,9653
2021/12/26,23:30,321.02,2,9005,9007
2021/12/27,00:00,335,2,8352,8354
2021/12/27,00:30,373.08,2,7762,7764
2021/12/27,01:00,266.21,2,7581,7583
2021/12/27,01:30,266.5,2,7302,7304
2021/12/27,02:00,266.5,2,7061,7063
2021/12/27,02:30,265.65,2,6947,6949
2021/12/27,03:00,266.21,2,6794,6796
2021/12/27,03:30,266.78,2,6778,6780
2021/12/27,04:00,266.5,4,6814,6818
2021/12/27,04:30,265.93,4,6965,6969
2021/12/27,05:00,265.93,4,7228,7232
2021/12/27,05:30,266.78,7,7615,7622
2021/12/27,06:00,266.21,6,7644,7650
2021/12/27,06:30,266.21,6,8188,8194
2021/12/27,07:00,266.21,3,8737,8740
2021/12/27,07:30,266.5,209,8983,9192
2021/12/27,08:00,266.5,506,8590,9096
2021/12/27,08:30,265.65,848,8626,9474
2021/12/27,09:00,262.96,1206,8233,9439
2021/12/27,09:30,262.96,1532,7912,9444
2021/12/27,10:00,263.19,1664,7650,9314
2021/12/27,10:30,263.66,1765,7427,9192
2021/12/27,11:00,262.74,1856,7276,9132
2021/12/27,11:30,266.5,1876,7139,9015
2021/12/27,12:00,266.21,1880,7114,8994
2021/12/27,12:30,265.65,1857,7094,8951
2021/12/27,13:00,265.38,1784,7206,8990
2021/12/27,13:30,265.65,1700,7312,9012
2021/12/27,14:00,310.68,1595,7391,8986
2021/12/27,14:30,311.44,1359,7576,8935
2021/12/27,15:00,332.22,1055,7943,8998
2021/12/27,15:30,334.12,727,8372,9099
2021/12/27,16:00,351.86,393,8766,9159
2021/12/27,16:30,334.78,89,9350,9439
2021/12/27,17:00,333.63,101,10262,10363
2021/12/27,17:30,332.51,105,10814,10919
2021/12/27,18:00,333.55,102,11156,11258
2021/12/27,18:30,332.45,45,11424,11469
2021/12/27,19:00,331.37,1,11501,11502
2021/12/27,19:30,330.41,1,11537,11538
2021/12/27,20:00,330.83,0,11503,11503
2021/12/27,20:30,327.3,0,11341,11341
2021/12/27,21:00,351.88,1,11135,11136
2021/12/27,21:30,323.26,1,10765,10766
2021/12/27,22:00,323.25,1,10339,10340
2021/12/27,22:30,367.25,1,9900,9901
2021/12/27,23:00,305.5,4,9379,9383
2021/12/27,23:30,306.72,4,8760,8764
2021/12/28,00:00:00,308.62,4,8131,8135
2021/12/28,00:30:00,266.5,3,7605,7608
2021/12/28,01:00:00,266.5,5,7327,7332
2021/12/28,01:30:00,266.5,3,7119,7122
2021/12/28,02:00:00,266.21,3,6908,6911
2021/12/28,02:30:00,267.08,3,6803,6806
2021/12/28,03:00:00,265.93,3,6707,6710
2021/12/28,03:30:00,266.21,3,6614,6617
2021/12/28,04:00:00,266.21,3,6693,6696
2021/12/28,04:30:00,266.21,3,6839,6842
2021/12/28,05:00:00,266.5,4,7076,7080
2021/12/28,05:30:00,305.69,4,7436,7440
2021/12/28,06:00:00,327.2,4,7747,7751
2021/12/28,06:30:00,320.44,5,8282,8287
2021/12/28,07:00:00,322.39,1,8642,8643
2021/12/28,07:30:00,323.39,104,8892,8996
2021/12/28,08:00:00,323.4,279,8804,9083
2021/12/28,08:30:00,324.54,347,8911,9258
2021/12/28,09:00:00,377.17,478,8860,9338
2021/12/28,09:30:00,377.17,654,8838,9492
2021/12/28,10:00:00,377.17,715,8832,9547
2021/12/28,10:30:00,377.17,711,8793,9504
2021/12/28,11:00:00,377.17,0,9351,9351
2021/12/28,11:30:00,265.93,0,9164,9164
2021/12/28,12:00:00,265.11,751,8320,9071
2021/12/28,12:30:00,265.38,767,8461,9228
2021/12/28,13:00:00,265.93,800,8539,9339
2021/12/28,13:30:00,265.65,835,8492,9327
2021/12/28,14:00:00,265.38,953,8466,9419
2021/12/28,14:30:00,265.65,918,8493,9411
2021/12/28,15:00:00,265.38,781,8770,9551
2021/12/28,15:30:00,339.61,702,9043,9745
2021/12/28,16:00:00,377.17,624,9294,9918
2021/12/28,16:30:00,353.69,564,9835,10399
2021/12/28,17:00:00,336.89,2,10601,10603
2021/12/28,17:30:00,338.04,2,11124,11126
2021/12/28,18:00:00,336.68,2,11395,11397
2021/12/28,18:30:00,335.58,2,11562,11564
2021/12/28,19:00:00,334.49,2,11609,11611
2021/12/28,19:30:00,329.1,2,11654,11656
2021/12/28,20:00:00,329.63,2,11579,11581
2021/12/28,20:30:00,327.16,2,11426,11428
2021/12/28,21:00:00,378.09,2,11190,11192
2021/12/28,21:30:00,324.27,3,10848,10851
2021/12/28,22:00:00,352.91,3,10438,10441
2021/12/28,22:30:00,354.01,3,10046,10049
2021/12/28,23:00:00,324.24,3,9494,9497
2021/12/28,23:30:00,328.56,4,8823,8827
2021/12/29,00:00:00,339.35,4,8215,8219
2021/12/29,00:30:00,265.93,4,7643,7647
2021/12/29,01:00:00,266.21,4,7523,7527
2021/12/29,01:30:00,266.5,4,7199,7203
2021/12/29,02:00:00,266.5,3,6968,6971
2021/12/29,02:30:00,266.5,3,6832,6835
2021/12/29,03:00:00,266.21,3,6721,6724
2021/12/29,03:30:00,266.78,4,6656,6660
2021/12/29,04:00:00,266.5,3,6754,6757
2021/12/29,04:30:00,266.21,4,6883,6887
2021/12/29,05:00:00,266.21,4,7120,7124
2021/12/29,05:30:00,266.5,4,7505,7509
2021/12/29,06:00:00,312.07,4,7767,7771
2021/12/29,06:30:00,307.69,2,8191,8193
2021/12/29,07:00:00,308.17,2,8564,8566
2021/12/29,07:30:00,308.42,27,8858,8885
2021/12/29,08:00:00,308.43,76,8711,8787
2021/12/29,08:30:00,309.18,145,8520,8665
2021/12/29,09:00:00,309.98,105,8346,8451
2021/12/29,09:30:00,371.85,148,8181,8329
2021/12/29,10:00:00,266.21,208,7987,8195
2021/12/29,10:30:00,266.5,1015,7801,8816
2021/12/29,11:00:00,266.5,1344,7606,8950
2021/12/29,11:30:00,266.5,1207,7654,8861
2021/12/29,12:00:00,265.93,1177,7649,8826
2021/12/29,12:30:00,265.93,1089,7934,9023
2021/12/29,13:00:00,266.5,1011,8379,9390
2021/12/29,13:30:00,344.8,875,8717,9592
2021/12/29,14:00:00,372.3,789,9086,9875
2021/12/29,14:30:00,381.3,719,9437,10156
2021/12/29,15:00:00,384,535,9840,10375
2021/12/29,15:30:00,384,345,10139,10484
2021/12/29,16:00:00,383.86,207,10291,10498
2021/12/29,16:30:00,373.22,149,10579,10728
2021/12/29,17:00:00,414.64,26,11394,11420
2021/12/29,17:30:00,436.53,26,11792,11818
2021/12/29,18:00:00,413.61,26,11948,11974
2021/12/29,18:30:00,435.76,16,12044,12060
2021/12/29,19:00:00,435.45,1,12022,12023
2021/12/29,19:30:00,412.38,0,11951,11951
2021/12/29,20:00:00,408.1,0,11856,11856
2021/12/29,20:30:00,408.07,0,11641,11641
2021/12/29,21:00:00,454.04,0,11345,11345
2021/12/29,21:30:00,454.03,0,10994,10994
2021/12/29,22:00:00,454.03,0,10540,10540
2021/12/29,22:30:00,305.56,0,10082,10082
2021/12/29,23:00:00,310.27,0,9491,9491
2021/12/29,23:30:00,308.65,0,8849,8849
2021/12/30,00:00:00,266.21,0,8194,8194
2021/12/30,00:30:00,266.78,0,7685,7685
2021/12/30,01:00:00,266.5,0,7270,7270
2021/12/30,01:30:00,266.78,0,6920,6920
2021/12/30,02:00:00,266.21,0,6714,6714
2021/12/30,02:30:00,267.08,0,6529,6529
2021/12/30,03:00:00,265.38,0,6421,6421
2021/12/30,03:30:00,266.78,0,6369,6369
2021/12/30,04:00:00,266.5,0,6447,6447
2021/12/30,04:30:00,266.78,0,6599,6599
2021/12/30,05:00:00,266.21,0,6835,6835
2021/12/30,05:30:00,266.78,0,7166,7166
2021/12/30,06:00:00,266.78,0,7521,7521
2021/12/30,06:30:00,266.5,1,7986,7987
2021/12/30,07:00:00,266.21,1,8459,8460
2021/12/30,07:30:00,266.5,153,8753,8906
2021/12/30,08:00:00,266.5,403,8514,8917
2021/12/30,08:30:00,266.21,843,8328,9171
2021/12/30,09:00:00,266.5,904,8407,9311
2021/12/30,09:30:00,266.5,804,8441,9245
2021/12/30,10:00:00,367.42,894,8335,9229
2021/12/30,10:30:00,370.61,901,8238,9139
2021/12/30,11:00:00,369.02,965,8114,9079
2021/12/30,11:30:00,369.02,1168,7844,9012
2021/12/30,12:00:00,369.02,1376,7704,9080
2021/12/30,12:30:00,365.89,1381,7656,9037
2021/12/30,13:00:00,371.73,1265,7791,9056
2021/12/30,13:30:00,371.73,1206,7788,8994
2021/12/30,14:00:00,369.14,944,8062,9006
2021/12/30,14:30:00,376.42,759,8336,9095
2021/12/30,15:00:00,377.02,524,8617,9141
2021/12/30,15:30:00,377.02,369,8949,9318
2021/12/30,16:00:00,377.02,171,9193,9364
2021/12/30,16:30:00,367.27,1,9691,9692
2021/12/30,17:00:00,459.93,0,10458,10458
2021/12/30,17:30:00,454.38,0,10919,10919
2021/12/30,18:00:00,457.63,0,11116,11116
2021/12/30,18:30:00,446.32,0,11250,11250
2021/12/30,19:00:00,408.36,0,11230,11230
2021/12/30,19:30:00,408.36,2,11199,11201
2021/12/30,20:00:00,408.35,2,11073,11075
2021/12/30,20:30:00,346.7,1,10869,10870
2021/12/30,21:00:00,352.35,1,10581,10582
2021/12/30,21:30:00,341.56,4,10276,10280
2021/12/30,22:00:00,371.53,4,9876,9880
2021/12/30,22:30:00,333.87,3,9503,9506
2021/12/30,23:00:00,320.41,3,9115,9118
2021/12/30,23:30:00,371.73,3,8586,8589
2021/12/31,00:00:00,589.21,3,8060,8063
2021/12/31,00:30:00,265.11,3,7554,7557
2021/12/31,01:00:00,265.38,3,7306,7309
2021/12/31,01:30:00,265.38,4,6992,6996
2021/12/31,02:00:00,265.38,3,6902,6905
2021/12/31,02:30:00,264.58,2,6699,6701
2021/12/31,03:00:00,264.85,2,6603,6605
2021/12/31,03:30:00,264.85,2,6503,6505
2021/12/31,04:00:00,264.85,2,6517,6519
2021/12/31,04:30:00,265.38,3,6577,6580
2021/12/31,05:00:00,264.85,2,6739,6741
2021/12/31,05:30:00,264.85,3,6997,7000
2021/12/31,06:00:00,264.85,3,7171,7174
2021/12/31,06:30:00,265.11,2,7352,7354
2021/12/31,07:00:00,264.85,2,7543,7545
2021/12/31,07:30:00,264.33,3,7856,7859
2021/12/31,08:00:00,264.85,156,7882,8038
2021/12/31,08:30:00,264.85,255,7913,8168
2021/12/31,09:00:00,265.11,400,7987,8387
2021/12/31,09:30:00,263.82,554,8052,8606
2021/12/31,10:00:00,265.65,617,8034,8651
2021/12/31,10:30:00,264.58,722,8049,8771
2021/12/31,11:00:00,264.58,876,8005,8881
2021/12/31,11:30:00,265.11,858,8059,8917
2021/12/31,12:00:00,264.85,810,7971,8781
2021/12/31,12:30:00,265.11,901,7965,8866
2021/12/31,13:00:00,264.58,832,7994,8826
2021/12/31,13:30:00,266.21,669,8271,8940
2021/12/31,14:00:00,264.07,500,8428,8928
2021/12/31,14:30:00,264.85,387,8754,9141
2021/12/31,15:00:00,353.98,272,9087,9359
2021/12/31,15:30:00,313.75,214,9457,9671
2021/12/31,16:00:00,351.79,299,9738,10037
2021/12/31,16:30:00,366.59,25,9691,9716
2021/12/31,17:00:00,372.21,26,9886,9912
2021/12/31,17:30:00,377.14,17,10045,10062
2021/12/31,18:00:00,371.86,1,10005,10006
2021/12/31,18:30:00,368.73,1,9862,9863
2021/12/31,19:00:00,377.14,1,9624,9625
2021/12/31,19:30:00,372.04,2,9392,9394
2021/12/31,20:00:00,372.04,2,9149,9151
2021/12/31,20:30:00,372.04,2,8928,8930
2021/12/31,21:00:00,320.92,2,8720,8722
2021/12/31,21:30:00,327.11,1,8489,8490
2021/12/31,22:00:00,333.35,1,8218,8219
2021/12/31,22:30:00,328.16,1,8010,8011
2021/12/31,23:00:00,265.38,1,7725,7726
2021/12/31,23:30:00,265.11,1,7457,7458
2022/01/01,00:00:00,264.85,1,7161,7162
2022/01/01,00:30:00,266.21,1,6895,6896
2022/01/01,01:00:00,264.33,2,6673,6675
2022/01/01,01:30:00,265.11,1,6650,6651
2022/01/01,02:00:00,264.85,2,6487,6489
2022/01/01,02:30:00,264.58,1,6493,6494
2022/01/01,03:00:00,264.85,1,6386,6387
2022/01/01,03:30:00,264.33,1,6328,6329
2022/01/01,04:00:00,264.58,1,6322,6323
2022/01/01,04:30:00,265.38,2,6354,6356
2022/01/01,05:00:00,264.58,5,6436,6441
2022/01/01,05:30:00,263.82,6,6554,6560
2022/01/01,06:00:00,264.58,8,6597,6605
2022/01/01,06:30:00,265.11,7,6581,6588
2022/01/01,07:00:00,267.09,7,6552,6559
2022/01/01,07:30:00,264.85,10,6695,6705
2022/01/01,08:00:00,264.58,149,6820,6969
2022/01/01,08:30:00,264.33,222,7018,7240
2022/01/01,09:00:00,263.82,255,7173,7428
2022/01/01,09:30:00,309.31,328,7323,7651
2022/01/01,10:00:00,351.8,482,7418,7900
2022/01/01,10:30:00,326.28,547,7477,8024
2022/01/01,11:00:00,326.33,622,7462,8084
2022/01/01,11:30:00,326.28,681,7542,8223
2022/01/01,12:00:00,326.35,787,7441,8228
2022/01/01,12:30:00,326.35,1039,7075,8114
2022/01/01,13:00:00,326.38,1145,6999,8144
2022/01/01,13:30:00,327.62,1233,6981,8214
2022/01/01,14:00:00,326.41,1294,7009,8303
2022/01/01,14:30:00,326.46,1144,7223,8367
2022/01/01,15:00:00,330.47,1082,7490,8572
2022/01/01,15:30:00,327.85,814,7793,8607
2022/01/01,16:00:00,325.52,470,8243,8713
2022/01/01,16:30:00,328.25,64,8758,8822
2022/01/01,17:00:00,331.75,46,9218,9264
2022/01/01,17:30:00,416.68,4,9629,9633
2022/01/01,18:00:00,406.7,3,10090,10093
2022/01/01,18:30:00,404.41,2,10259,10261
2022/01/01,19:00:00,404.37,4,10230,10234
2022/01/01,19:30:00,404.34,3,10195,10198
2022/01/01,20:00:00,404.3,3,10085,10088
2022/01/01,20:30:00,476,2,9924,9926
2022/01/01,21:00:00,330.47,4,9727,9731
2022/01/01,21:30:00,329.94,6,9547,9553
2022/01/01,22:00:00,326.55,6,9278,9284
2022/01/01,22:30:00,324.39,4,8965,8969
2022/01/01,23:00:00,376.49,3,8488,8491
2022/01/01,23:30:00,373.39,3,7999,8002
2022/01/02,00:00:00,252.33,3,7448,7451
2022/01/02,00:30:00,252.69,3,7130,7133
2022/01/02,01:00:00,253.05,4,6917,6921
2022/01/02,01:30:00,253.05,5,6606,6611
2022/01/02,02:00:00,253.17,4,6387,6391
2022/01/02,02:30:00,252.57,3,6284,6287
2022/01/02,03:00:00,252.69,4,6193,6197
2022/01/02,03:30:00,252.69,3,6157,6160
2022/01/02,04:00:00,252.45,5,6212,6217
2022/01/02,04:30:00,253.05,6,6346,6352
2022/01/02,05:00:00,253.05,8,6539,6547
2022/01/02,05:30:00,252.81,8,6917,6925
2022/01/02,06:00:00,252.81,2,7212,7214
2022/01/02,06:30:00,308.25,3,7685,7688
2022/01/02,07:00:00,308.68,1,7858,7859
2022/01/02,07:30:00,310.38,114,8254,8368
2022/01/02,08:00:00,316.72,294,8227,8521
2022/01/02,08:30:00,309.06,629,8154,8783
2022/01/02,09:00:00,312.37,942,7877,8819
2022/01/02,09:30:00,318.82,1123,7643,8766
2022/01/02,10:00:00,371.88,1262,7409,8671
2022/01/02,10:30:00,367.58,1424,7255,8679
2022/01/02,11:00:00,252.45,1493,7035,8528
2022/01/02,11:30:00,252.45,1500,6968,8468
2022/01/02,12:00:00,252.45,1548,6898,8446
2022/01/02,12:30:00,252.45,1544,6936,8480
2022/01/02,13:00:00,252.69,1482,7108,8590
2022/01/02,13:30:00,252.45,1309,7264,8573
2022/01/02,14:00:00,252.45,1126,7468,8594
2022/01/02,14:30:00,252.45,1053,7689,8742
2022/01/02,15:00:00,252.45,965,7911,8876
2022/01/02,15:30:00,252.45,615,8349,8964
2022/01/02,16:00:00,246.23,352,8673,9025
2022/01/02,16:30:00,1935.24,135,9223,9358
2022/01/02,17:00:00,1929.63,6,10027,10033
2022/01/02,17:30:00,486.21,8,10563,10571
2022/01/02,18:00:00,2047.88,6,10801,10807
2022/01/02,18:30:00,2025.48,8,10953,10961
2022/01/02,19:00:00,486.21,6,10993,10999
2022/01/02,19:30:00,486.21,6,11017,11023
2022/01/02,20:00:00,486.21,6,11013,11019
2022/01/02,20:30:00,486.21,5,10842,10847
2022/01/02,21:00:00,405.7,4,10614,10618
2022/01/02,21:30:00,380.16,2,10294,10296
2022/01/02,22:00:00,359.6,1,9845,9846
2022/01/02,22:30:00,361.43,0,9444,9444
2022/01/02,23:00:00,357.02,0,8969,8969
2022/01/02,23:30:00,358.1,0,8359,8359
2022/01/03,00:00:00,252.57,1,7725,7726
2022/01/03,00:30:00,252.21,0,7416,7416
2022/01/03,01:00:00,252.45,0,7079,7079
2022/01/03,01:30:00,252.57,0,6909,6909
2022/01/03,02:00:00,252.81,1,6527,6528
2022/01/03,02:30:00,252.57,0,6395,6395
2022/01/03,03:00:00,252.81,0,6318,6318
2022/01/03,03:30:00,252.69,0,6447,6447
2022/01/03,04:00:00,252.45,0,6499,6499
2022/01/03,04:30:00,252.69,0,6608,6608
2022/01/03,05:00:00,252.69,0,6812,6812
2022/01/03,05:30:00,248.36,0,7031,7031
2022/01/03,06:00:00,252.21,0,7347,7347
2022/01/03,06:30:00,252.33,0,7645,7645
2022/01/03,07:00:00,252.21,0,8060,8060
2022/01/03,07:30:00,250.09,132,8417,8549
2022/01/03,08:00:00,257.55,266,8328,8594
2022/01/03,08:30:00,252.81,370,8338,8708
2022/01/03,09:00:00,346.48,619,8243,8862
2022/01/03,09:30:00,377.3,739,8147,8886
2022/01/03,10:00:00,371.71,965,8068,9033
2022/01/03,10:30:00,377.3,1145,8023,9168
2022/01/03,11:00:00,371.71,1197,8114,9311
2022/01/03,11:30:00,373.33,1179,8031,9210
2022/01/03,12:00:00,376.62,1040,8048,9088
2022/01/03,12:30:00,374.94,995,8001,8996
2022/01/03,13:00:00,373.27,971,7984,8955
2022/01/03,13:30:00,370.03,1145,7807,8952
2022/01/03,14:00:00,376.64,1085,7891,8976
2022/01/03,14:30:00,370.39,974,8037,9011
2022/01/03,15:00:00,373.47,908,8149,9057
2022/01/03,15:30:00,375.17,596,8520,9116
2022/01/03,16:00:00,372.49,365,8837,9202
2022/01/03,16:30:00,329.75,217,9330,9547
2022/01/03,17:00:00,333.23,26,10174,10200
2022/01/03,17:30:00,457.41,5,10753,10758
2022/01/03,18:00:00,434.57,5,11015,11020
2022/01/03,18:30:00,463.15,3,11195,11198
2022/01/03,19:00:00,452,3,11192,11195
2022/01/03,19:30:00,475.52,3,11186,11189
2022/01/03,20:00:00,460.26,3,11067,11070
2022/01/03,20:30:00,463.15,2,10936,10938
2022/01/03,21:00:00,397.32,1,10651,10652
2022/01/03,21:30:00,323.78,1,10356,10357
2022/01/03,22:00:00,318.85,1,9921,9922
2022/01/03,22:30:00,324.84,1,9544,9545
2022/01/03,23:00:00,252.45,1,9064,9065
2022/01/03,23:30:00,252.81,1,8460,8461
2022/01/04,00:00:00,249.96,1,7906,7907
2022/01/04,00:30:00,249.72,1,7467,7468
2022/01/04,01:00:00,250.09,1,7176,7177
2022/01/04,01:30:00,252.57,1,6884,6885
2022/01/04,02:00:00,252.57,1,6793,6794
2022/01/04,02:30:00,252.81,1,6634,6635
2022/01/04,03:00:00,252.81,1,6556,6557
2022/01/04,03:30:00,248.77,1,6495,6496
2022/01/04,04:00:00,244.92,1,6585,6586
2022/01/04,04:30:00,245.03,1,6699,6700
2022/01/04,05:00:00,245.26,1,6932,6933
2022/01/04,05:30:00,244.8,1,7291,7292
2022/01/04,06:00:00,244.92,0,7356,7356
2022/01/04,06:30:00,245.61,0,7772,7772
2022/01/04,07:00:00,245.26,0,8207,8207
2022/01/04,07:30:00,336.83,151,8658,8809
2022/01/04,08:00:00,374.85,335,8591,8926
2022/01/04,08:30:00,370.76,553,8624,9177
2022/01/04,09:00:00,371.95,768,8507,9275
2022/01/04,09:30:00,368.33,923,8433,9356
2022/01/04,10:00:00,371.95,943,8239,9182
2022/01/04,10:30:00,373.19,1022,7995,9017
2022/01/04,11:00:00,369.06,1215,7817,9032
2022/01/04,11:30:00,371.95,1366,7748,9114
2022/01/04,12:00:00,371.95,1423,8078,9501
2022/01/04,12:30:00,343.79,1488,8400,9888
2022/01/04,13:00:00,376.16,1365,8770,10135
2022/01/04,13:30:00,457.25,1083,9179,10262
2022/01/04,14:00:00,462.96,883,9461,10344
2022/01/04,14:30:00,454.51,825,9577,10402
2022/01/04,15:00:00,454.51,816,9709,10525
2022/01/04,15:30:00,454.51,575,9697,10272
2022/01/04,16:00:00,454.51,267,9938,10205
2022/01/04,16:30:00,462.95,134,10293,10427
2022/01/04,17:00:00,460.06,54,10785,10839
2022/01/04,17:30:00,457.23,81,11110,11191
2022/01/04,18:00:00,482.1,89,11276,11365
2022/01/04,18:30:00,472.13,96,11371,11467
2022/01/04,19:00:00,468.98,101,11333,11434
2022/01/04,19:30:00,472.12,100,11328,11428
2022/01/04,20:00:00,475.35,101,11195,11296
2022/01/04,20:30:00,475.35,103,10956,11059
2022/01/04,21:00:00,472.12,103,10699,10802
2022/01/04,21:30:00,378.9,33,10418,10451
2022/01/04,22:00:00,337.98,7,10072,10079
2022/01/04,22:30:00,365.55,10,9647,9657
2022/01/04,23:00:00,321.01,10,9080,9090
2022/01/04,23:30:00,253.05,7,8466,8473
2022/01/05,00:00:00,252.45,14,7853,7867
2022/01/05,00:30:00,249,13,7421,7434
2022/01/05,01:00:00,249.39,10,7033,7043
2022/01/05,01:30:00,250.44,11,6874,6885
2022/01/05,02:00:00,249,9,6838,6847
2022/01/05,02:30:00,250.32,6,6704,6710
2022/01/05,03:00:00,251.62,7,6593,6600
2022/01/05,03:30:00,252.69,7,6558,6565
2022/01/05,04:00:00,252.33,5,6539,6544
2022/01/05,04:30:00,252.33,6,6706,6712
2022/01/05,05:00:00,252.57,5,6900,6905
2022/01/05,05:30:00,252.45,4,7339,7343
2022/01/05,06:00:00,252.45,0,7480,7480
2022/01/05,06:30:00,252.45,0,7902,7902
2022/01/05,07:00:00,252.45,1,8313,8314
2022/01/05,07:30:00,251.86,166,8602,8768
2022/01/05,08:00:00,252.45,375,8603,8978
2022/01/05,08:30:00,252.81,558,8761,9319
2022/01/05,09:00:00,252.81,830,8661,9491
2022/01/05,09:30:00,252.33,1073,8613,9686
2022/01/05,10:00:00,251.38,1341,8590,9931
2022/01/05,10:30:00,249.72,1422,8538,9960
2022/01/05,11:00:00,253.41,1555,8413,9968
2022/01/05,11:30:00,252.81,1657,8382,10039
2022/01/05,12:00:00,252.57,1666,8387,10053
2022/01/05,12:30:00,252.81,1632,8390,10022
2022/01/05,13:00:00,252.81,1551,8480,10031
2022/01/05,13:30:00,252.57,1445,8489,9934
2022/01/05,14:00:00,252.33,1323,8584,9907
2022/01/05,14:30:00,253.05,1213,8769,9982
2022/01/05,15:00:00,253.29,986,8983,9969
2022/01/05,15:30:00,244.78,721,9287,10008
2022/01/05,16:00:00,371.93,431,9529,9960
2022/01/05,16:30:00,412.05,213,10014,10227
2022/01/05,17:00:00,430.82,83,10660,10743
2022/01/05,17:30:00,430.64,93,11022,11115
2022/01/05,18:00:00,422.19,104,11207,11311
2022/01/05,18:30:00,407.32,103,11272,11375
2022/01/05,19:00:00,434.22,103,11264,11367
2022/01/05,19:30:00,410.43,103,11236,11339
2022/01/05,20:00:00,458.01,104,11084,11188
2022/01/05,20:30:00,462.97,103,10915,11018
2022/01/05,21:00:00,457.25,83,10640,10723
2022/01/05,21:30:00,399.45,0,10407,10407
2022/01/05,22:00:00,327.87,0,9990,9990
2022/01/05,22:30:00,322.65,0,9604,9604
2022/01/05,23:00:00,334.6,0,9163,9163
2022/01/05,23:30:00,253.41,1,8576,8577
2022/01/06,00:00:00,253.17,1,8039,8040
2022/01/06,00:30:00,252.81,1,7576,7577
2022/01/06,01:00:00,252.69,1,7168,7169
2022/01/06,01:30:00,253.05,1,6855,6856
2022/01/06,02:00:00,252.69,0,6918,6918
2022/01/06,02:30:00,252.45,0,6776,6776
2022/01/06,03:00:00,252.33,0,6649,6649
2022/01/06,03:30:00,252.45,0,6613,6613
2022/01/06,04:00:00,252.45,1,6651,6652
2022/01/06,04:30:00,347.46,0,6773,6773
2022/01/06,05:00:00,361.18,0,6982,6982
2022/01/06,05:30:00,339.65,0,7314,7314
2022/01/06,06:00:00,324.05,1,7652,7653
2022/01/06,06:30:00,323.66,1,8049,8050
2022/01/06,07:00:00,405.37,1,8303,8304
2022/01/06,07:30:00,383.53,197,8531,8728
2022/01/06,08:00:00,353.35,541,8181,8722
2022/01/06,08:30:00,340.67,1000,8042,9042
2022/01/06,09:00:00,337.84,1320,7697,9017
2022/01/06,09:30:00,357.79,1613,7395,9008
2022/01/06,10:00:00,360.87,1796,7154,8950
2022/01/06,10:30:00,359.31,1894,6978,8872
2022/01/06,11:00:00,367.33,1946,6718,8664
2022/01/06,11:30:00,364.04,1980,6625,8605
2022/01/06,12:00:00,365.69,1973,6520,8493
2022/01/06,12:30:00,365.69,1961,6537,8498
2022/01/06,13:00:00,364.04,1892,6596,8488
2022/01/06,13:30:00,365.69,1762,6736,8498
2022/01/06,14:00:00,318.12,1598,6856,8454
2022/01/06,14:30:00,315.07,1442,6955,8397
2022/01/06,15:00:00,315.07,1058,7382,8440
2022/01/06,15:30:00,405.38,552,7863,8415
2022/01/06,16:00:00,465.81,255,8304,8559
2022/01/06,16:30:00,439.61,210,8786,8996
2022/01/06,17:00:00,430.96,107,9480,9587
2022/01/06,17:30:00,429.67,109,10065,10174
2022/01/06,18:00:00,428.79,109,10344,10453
2022/01/06,18:30:00,427.92,109,10484,10593
2022/01/06,19:00:00,414.52,109,10513,10622
2022/01/06,19:30:00,408.18,108,10490,10598
2022/01/06,20:00:00,408.15,108,10370,10478
2022/01/06,20:30:00,408.14,103,10219,10322
2022/01/06,21:00:00,375.26,1,10107,10108
2022/01/06,21:30:00,336.82,3,9819,9822
2022/01/06,22:00:00,337.76,3,9460,9463
2022/01/06,22:30:00,329.05,4,9170,9174
2022/01/06,23:00:00,329.9,3,8799,8802
2022/01/06,23:30:00,337.21,3,8322,8325
2022/01/07,00:00:00,253.05,3,7873,7876
2022/01/07,00:30:00,253.17,3,7418,7421
2022/01/07,01:00:00,252.81,2,7093,7095
2022/01/07,01:30:00,252.81,2,6911,6913
2022/01/07,02:00:00,252.57,2,6837,6839
2022/01/07,02:30:00,252.33,2,6693,6695
2022/01/07,03:00:00,252.57,3,6555,6558
2022/01/07,03:30:00,252.33,3,6485,6488
2022/01/07,04:00:00,252.33,1,6467,6468
2022/01/07,04:30:00,252.33,1,6556,6557
2022/01/07,05:00:00,252.33,1,6693,6694
2022/01/07,05:30:00,252.21,1,6931,6932
2022/01/07,06:00:00,252.21,1,7130,7131
2022/01/07,06:30:00,251.97,1,7288,7289
2022/01/07,07:00:00,252.21,1,7363,7364
2022/01/07,07:30:00,252.21,209,7357,7566
2022/01/07,08:00:00,252.21,588,6993,7581
2022/01/07,08:30:00,252.45,1023,6727,7750
2022/01/07,09:00:00,252.45,1316,6631,7947
2022/01/07,09:30:00,252.45,1625,6385,8010
2022/01/07,10:00:00,252.21,1796,6234,8030
2022/01/07,10:30:00,252.33,1901,6135,8036
2022/01/07,11:00:00,252.21,1953,6071,8024
2022/01/07,11:30:00,252.09,1997,6044,8041
2022/01/07,12:00:00,252.33,1998,5937,7935
2022/01/07,12:30:00,252.33,1985,5890,7875
2022/01/07,13:00:00,252.45,1935,5923,7858
2022/01/07,13:30:00,252.21,1851,5942,7793
2022/01/07,14:00:00,252.33,1744,6113,7857
2022/01/07,14:30:00,252.33,1605,6363,7968
2022/01/07,15:00:00,251.97,1352,6764,8116
2022/01/07,15:30:00,252.33,942,7272,8214
2022/01/07,16:00:00,252.33,569,7945,8514
2022/01/07,16:30:00,322.43,249,8362,8611
2022/01/07,17:00:00,360.11,46,8750,8796
2022/01/07,17:30:00,374.65,0,9256,9256
2022/01/07,18:00:00,344.72,0,9370,9370
2022/01/07,18:30:00,386.08,0,9359,9359
2022/01/07,19:00:00,345.61,0,9212,9212
2022/01/07,19:30:00,252.69,0,9055,9055
2022/01/07,20:00:00,252.81,0,8880,8880
2022/01/07,20:30:00,252.57,0,8755,8755
2022/01/07,21:00:00,253.17,0,8597,8597
2022/01/07,21:30:00,251.86,0,8520,8520
2022/01/07,22:00:00,253.05,0,8331,8331
2022/01/07,22:30:00,253.05,0,8117,8117
2022/01/07,23:00:00,252.93,0,7873,7873
2022/01/07,23:30:00,253.17,0,7528,7528
2022/01/08,00:00:00,252.57,1,7188,7189
2022/01/08,00:30:00,252.81,1,6861,6862
2022/01/08,01:00:00,252.81,1,6598,6599
2022/01/08,01:30:00,252.81,1,6369,6370
2022/01/08,02:00:00,252.93,1,6195,6196
2022/01/08,02:30:00,252.69,1,6075,6076
2022/01/08,03:00:00,252.69,2,6160,6162
2022/01/08,03:30:00,252.81,3,6248,6251
2022/01/08,04:00:00,253.29,3,6221,6224
2022/01/08,04:30:00,252.81,2,6281,6283
2022/01/08,05:00:00,253.17,2,6399,6401
2022/01/08,05:30:00,252.81,2,6565,6567
2022/01/08,06:00:00,252.81,2,6639,6641
2022/01/08,06:30:00,252.57,3,6638,6641
2022/01/08,07:00:00,252.81,3,6595,6598
2022/01/08,07:30:00,252.57,208,6538,6746
2022/01/08,08:00:00,252.81,540,6365,6905
2022/01/08,08:30:00,252.57,879,6205,7084
2022/01/08,09:00:00,252.57,1288,5867,7155
2022/01/08,09:30:00,253.29,1616,5655,7271
2022/01/08,10:00:00,254.87,1670,5573,7243
2022/01/08,10:30:00,254.02,1826,5475,7301
2022/01/08,11:00:00,254.26,1946,5301,7247
2022/01/08,11:30:00,254.87,1991,5209,7200
2022/01/08,12:00:00,255.72,1999,5135,7134
2022/01/08,12:30:00,255.35,1972,5158,7130
2022/01/08,13:00:00,255.23,1919,5194,7113
2022/01/08,13:30:00,255.23,1830,5228,7058
2022/01/08,14:00:00,255.11,1727,5363,7090
2022/01/08,14:30:00,254.5,1590,5644,7234
2022/01/08,15:00:00,252.09,1345,6000,7345
2022/01/08,15:30:00,251.97,907,6477,7384
2022/01/08,16:00:00,377.58,555,7102,7657
2022/01/08,16:30:00,400.06,238,7423,7661
2022/01/08,17:00:00,397.36,103,8048,8151
2022/01/08,17:30:00,405.73,103,8596,8699
2022/01/08,18:00:00,376.36,103,9172,9275
2022/01/08,18:30:00,340.57,103,9426,9529
2022/01/08,19:00:00,337.28,103,9480,9583
2022/01/08,19:30:00,337.94,104,9510,9614
2022/01/08,20:00:00,325.03,104,9435,9539
2022/01/08,20:30:00,325.55,89,9360,9449
2022/01/08,21:00:00,321.93,17,9276,9293
2022/01/08,21:30:00,321,4,9115,9119
2022/01/08,22:00:00,321.38,4,8860,8864
2022/01/08,22:30:00,347.11,2,8538,8540
2022/01/08,23:00:00,386.22,2,8174,8176
2022/01/08,23:30:00,251.97,2,7736,7738
2022/01/09,00:00:00,252.81,2,7310,7312
2022/01/09,00:30:00,252.93,2,6891,6893
2022/01/09,01:00:00,252.93,2,6582,6584
2022/01/09,01:30:00,252.93,1,6310,6311
2022/01/09,02:00:00,252.93,1,6074,6075
2022/01/09,02:30:00,252.81,1,5958,5959
2022/01/09,03:00:00,252.93,1,5878,5879
2022/01/09,03:30:00,253.17,1,5854,5855
2022/01/09,04:00:00,252.81,2,5878,5880
2022/01/09,04:30:00,252.93,2,6008,6010
2022/01/09,05:00:00,252.81,2,6266,6268
2022/01/09,05:30:00,253.17,2,6601,6603
2022/01/09,06:00:00,252.81,1,6913,6914
2022/01/09,06:30:00,252.93,2,7328,7330
2022/01/09,07:00:00,252.81,3,7707,7710
2022/01/09,07:30:00,249.72,181,7911,8092
2022/01/09,08:00:00,249.96,570,7577,8147
2022/01/09,08:30:00,251.03,910,7318,8228
2022/01/09,09:00:00,252.57,1211,7008,8219
2022/01/09,09:30:00,253.17,1563,6704,8267
2022/01/09,10:00:00,252.33,1730,6470,8200
2022/01/09,10:30:00,252.09,1760,6469,8229
2022/01/09,11:00:00,252.21,1529,6822,8351
2022/01/09,11:30:00,253.05,1348,6927,8275
2022/01/09,12:00:00,252.21,1332,6916,8248
2022/01/09,12:30:00,252.21,1239,7025,8264
2022/01/09,13:00:00,255.17,1079,7396,8475
2022/01/09,13:30:00,255.3,825,7722,8547
2022/01/09,14:00:00,402.6,704,7966,8670
2022/01/09,14:30:00,402.6,651,8284,8935
2022/01/09,15:00:00,405.81,458,8355,8813
2022/01/09,15:30:00,402.6,284,8684,8968
2022/01/09,16:00:00,403.11,186,8908,9094
2022/01/09,16:30:00,407.15,105,9272,9377
2022/01/09,17:00:00,478.86,13,9941,9954
2022/01/09,17:30:00,454.68,13,10481,10494
2022/01/09,18:00:00,460.25,13,10723,10736
2022/01/09,18:30:00,454.67,13,10842,10855
2022/01/09,19:00:00,475.5,14,10843,10857
2022/01/09,19:30:00,469.12,12,10815,10827
2022/01/09,20:00:00,469.12,12,10698,10710
2022/01/09,20:30:00,463.1,8,10513,10521
2022/01/09,21:00:00,475.52,2,10285,10287
2022/01/09,21:30:00,252.45,2,9915,9917
2022/01/09,22:00:00,251.5,2,9512,9514
2022/01/09,22:30:00,251.62,3,9189,9192
2022/01/09,23:00:00,251.86,3,8674,8677
2022/01/09,23:30:00,251.74,2,8162,8164
2022/01/10,00:00:00,251.74,1,7630,7631
2022/01/10,00:30:00,251.74,1,7152,7153
2022/01/10,01:00:00,251.5,1,7007,7008
2022/01/10,01:30:00,252.33,1,6872,6873
2022/01/10,02:00:00,252.45,2,6649,6651
2022/01/10,02:30:00,251.62,2,6554,6556
2022/01/10,03:00:00,252.09,2,6476,6478
2022/01/10,03:30:00,252.33,4,6439,6443
2022/01/10,04:00:00,252.33,4,6530,6534
2022/01/10,04:30:00,251.86,3,6682,6685
2022/01/10,05:00:00,252.09,3,6829,6832
2022/01/10,05:30:00,252.09,3,7207,7210
2022/01/10,06:00:00,251.86,4,7387,7391
2022/01/10,06:30:00,252.45,6,7699,7705
2022/01/10,07:00:00,246.45,5,8196,8201
2022/01/10,07:30:00,245.69,192,8406,8598
2022/01/10,08:00:00,251.74,569,8038,8607
2022/01/10,08:30:00,253.05,940,7728,8668
2022/01/10,09:00:00,252.93,1287,7377,8664
2022/01/10,09:30:00,253.05,1625,7211,8836
2022/01/10,10:00:00,252.81,1813,6992,8805
2022/01/10,10:30:00,253.05,1904,6853,8757
2022/01/10,11:00:00,252.69,1959,6706,8665
2022/01/10,11:30:00,280.53,2049,6618,8667
2022/01/10,12:00:00,277.48,2046,6615,8661
2022/01/10,12:30:00,265.05,2063,6645,8708
2022/01/10,13:00:00,266.64,1952,6694,8646
2022/01/10,13:30:00,266.64,1879,6860,8739
2022/01/10,14:00:00,266.3,1734,7025,8759
2022/01/10,14:30:00,265.45,1586,7330,8916
2022/01/10,15:00:00,265.45,1326,7683,9009
2022/01/10,15:30:00,264.61,959,8175,9134
2022/01/10,16:00:00,262.57,625,8439,9064
2022/01/10,16:30:00,312.3,273,9073,9346
2022/01/10,17:00:00,468.72,107,9915,10022
2022/01/10,17:30:00,475.09,106,10547,10653
2022/01/10,18:00:00,475.09,107,10877,10984
2022/01/10,18:30:00,471.86,109,11038,11147
2022/01/10,19:00:00,478.47,111,11125,11236
2022/01/10,19:30:00,486.39,111,11138,11249
2022/01/10,20:00:00,486.39,112,11029,11141
2022/01/10,20:30:00,401.29,112,10903,11015
2022/01/10,21:00:00,468.74,111,10644,10755
2022/01/10,21:30:00,465.67,110,10308,10418
2022/01/10,22:00:00,471.88,49,9928,9977
2022/01/10,22:30:00,485.36,0,9533,9533
2022/01/10,23:00:00,486.39,0,9076,9076
2022/01/10,23:30:00,257.29,0,8492,8492
2022/01/11,00:00:00,252.69,0,7886,7886
2022/01/11,00:30:00,252.57,0,7464,7464
2022/01/11,01:00:00,252.69,0,7052,7052
2022/01/11,01:30:00,252.09,0,6787,6787
2022/01/11,02:00:00,252.09,0,6561,6561
2022/01/11,02:30:00,252.57,0,6559,6559
2022/01/11,03:00:00,252.21,0,6624,6624
2022/01/11,03:30:00,252.57,0,6590,6590
2022/01/11,04:00:00,252.33,0,6617,6617
2022/01/11,04:30:00,251.97,0,6761,6761
2022/01/11,05:00:00,252.33,0,6855,6855
2022/01/11,05:30:00,252.69,0,7138,7138
2022/01/11,06:00:00,252.45,0,7486,7486
2022/01/11,06:30:00,252.45,0,7895,7895
2022/01/11,07:00:00,244.61,0,8392,8392
2022/01/11,07:30:00,244.4,179,8655,8834
2022/01/11,08:00:00,250.67,526,8290,8816
2022/01/11,08:30:00,252.93,889,8000,8889
2022/01/11,09:00:00,253.17,1297,7605,8902
2022/01/11,09:30:00,252.81,1623,7410,9033
2022/01/11,10:00:00,252.45,1781,7149,8930
2022/01/11,10:30:00,253.05,1874,7119,8993
2022/01/11,11:00:00,252.69,1967,6913,8880
2022/01/11,11:30:00,252.81,2020,6788,8808
2022/01/11,12:00:00,252.81,2021,6717,8738
2022/01/11,12:30:00,252.81,2014,6705,8719
2022/01/11,13:00:00,252.57,1964,6770,8734
2022/01/11,13:30:00,252.57,1888,6920,8808
2022/01/11,14:00:00,252.81,1781,7056,8837
2022/01/11,14:30:00,252.57,1622,7325,8947
2022/01/11,15:00:00,252.69,1345,7689,9034
2022/01/11,15:30:00,325.12,1012,7992,9004
2022/01/11,16:00:00,327.08,664,8351,9015
2022/01/11,16:30:00,320.1,345,8901,9246
2022/01/11,17:00:00,322.15,94,9745,9839
2022/01/11,17:30:00,383.98,103,10480,10583
2022/01/11,18:00:00,379.65,105,10823,10928
2022/01/11,18:30:00,377.78,105,11062,11167
2022/01/11,19:00:00,379.75,106,11124,11230
2022/01/11,19:30:00,376.89,109,11149,11258
2022/01/11,20:00:00,379.75,109,11065,11174
2022/01/11,20:30:00,376.89,108,10931,11039
2022/01/11,21:00:00,376.89,79,10709,10788
2022/01/11,21:30:00,378.1,0,10445,10445
2022/01/11,22:00:00,376.89,0,9993,9993
2022/01/11,22:30:00,376.89,0,9610,9610
2022/01/11,23:00:00,252.33,0,9077,9077
2022/01/11,23:30:00,252.21,0,8504,8504
2022/01/12,00:00:00,252.33,0,7912,7912
2022/01/12,00:30:00,251.97,0,7483,7483
2022/01/12,01:00:00,252.33,0,7098,7098
2022/01/12,01:30:00,252.81,0,6988,6988
2022/01/12,02:00:00,251.86,0,6927,6927
2022/01/12,02:30:00,252.21,0,6742,6742
2022/01/12,03:00:00,252.33,0,6685,6685
2022/01/12,03:30:00,252.33,0,6703,6703
2022/01/12,04:00:00,251.5,0,6717,6717
2022/01/12,04:30:00,251.74,0,6863,6863
2022/01/12,05:00:00,251.97,0,6925,6925
2022/01/12,05:30:00,252.33,0,7137,7137
2022/01/12,06:00:00,252.57,0,7487,7487
2022/01/12,06:30:00,253.05,0,7990,7990
2022/01/12,07:00:00,252.33,0,8439,8439
2022/01/12,07:30:00,252.33,233,8552,8785
2022/01/12,08:00:00,252.33,585,8193,8778
2022/01/12,08:30:00,251.86,958,7851,8809
2022/01/12,09:00:00,252.33,1250,7700,8950
2022/01/12,09:30:00,252.81,1481,7577,9058
2022/01/12,10:00:00,252.09,1581,7409,8990
2022/01/12,10:30:00,252.21,1709,7244,8953
2022/01/12,11:00:00,252.21,1599,7252,8851
2022/01/12,11:30:00,252.33,1725,7036,8761
2022/01/12,12:00:00,252.33,1834,6931,8765
2022/01/12,12:30:00,252.57,1521,7207,8728
2022/01/12,13:00:00,252.33,1485,7202,8687
2022/01/12,13:30:00,252.33,1230,7521,8751
2022/01/12,14:00:00,252.93,952,7694,8646
2022/01/12,14:30:00,252.69,788,7898,8686
2022/01/12,15:00:00,252.09,722,8060,8782
2022/01/12,15:30:00,252.69,698,8361,9059
2022/01/12,16:00:00,252.45,400,8631,9031
2022/01/12,16:30:00,251.74,216,8885,9101
2022/01/12,17:00:00,262.17,103,9807,9910
2022/01/12,17:30:00,246.99,102,10447,10549
2022/01/12,18:00:00,262.43,55,10848,10903
2022/01/12,18:30:00,247.17,0,11075,11075
2022/01/12,19:00:00,385.81,0,11161,11161
2022/01/12,19:30:00,385.81,0,11159,11159
2022/01/12,20:00:00,385.81,0,11078,11078
2022/01/12,20:30:00,377.98,0,10935,10935
2022/01/12,21:00:00,372.57,0,10690,10690
2022/01/12,21:30:00,375.09,0,10341,10341
2022/01/12,22:00:00,352.77,0,9890,9890
2022/01/12,22:30:00,253.17,0,9485,9485
2022/01/12,23:00:00,253.17,0,8943,8943
2022/01/12,23:30:00,252.93,0,8368,8368
2022/01/13,00:00:00,252.93,0,7828,7828
2022/01/13,00:30:00,252.21,0,7386,7386
2022/01/13,01:00:00,252.69,0,7157,7157
2022/01/13,01:30:00,252.33,0,7017,7017
2022/01/13,02:00:00,252.45,0,6836,6836
2022/01/13,02:30:00,252.45,0,6665,6665
2022/01/13,03:00:00,251.86,0,6587,6587
2022/01/13,03:30:00,252.45,0,6589,6589
2022/01/13,04:00:00,252.69,1,6595,6596
2022/01/13,04:30:00,252.21,1,6733,6734
2022/01/13,05:00:00,252.21,1,6972,6973
2022/01/13,05:30:00,251.97,1,7292,7293
2022/01/13,06:00:00,252.45,1,7506,7507
2022/01/13,06:30:00,252.45,1,7846,7847
2022/01/13,07:00:00,252.45,0,8282,8282
2022/01/13,07:30:00,252.09,123,8639,8762
2022/01/13,08:00:00,251.97,291,8473,8764
2022/01/13,08:30:00,253.05,502,8512,9014
2022/01/13,09:00:00,252.45,623,8398,9021
2022/01/13,09:30:00,252.21,917,8154,9071
2022/01/13,10:00:00,252.57,1307,7819,9126
2022/01/13,10:30:00,252.45,1371,7715,9086
2022/01/13,11:00:00,251.86,1584,7421,9005
2022/01/13,11:30:00,252.21,1668,7205,8873
2022/01/13,12:00:00,252.33,1799,7097,8896
2022/01/13,12:30:00,252.69,1859,7056,8915
2022/01/13,13:00:00,252.09,1823,7183,9006
2022/01/13,13:30:00,252.45,1761,7332,9093
2022/01/13,14:00:00,252.69,1581,7562,9143
2022/01/13,14:30:00,252.45,1368,7773,9141
2022/01/13,15:00:00,251.86,1280,7807,9087
2022/01/13,15:30:00,252.33,928,8376,9304
2022/01/13,16:00:00,252.21,470,8928,9398
2022/01/13,16:30:00,252.21,280,9564,9844
2022/01/13,17:00:00,367.74,39,10281,10320
2022/01/13,17:30:00,399.83,7,10809,10816
2022/01/13,18:00:00,369.02,6,11051,11057
2022/01/13,18:30:00,347.26,6,11193,11199
2022/01/13,19:00:00,347.34,6,11185,11191
2022/01/13,19:30:00,348.14,9,11175,11184
2022/01/13,20:00:00,348.13,8,11017,11025
2022/01/13,20:30:00,348.67,6,10923,10929
2022/01/13,21:00:00,376.43,2,10655,10657
2022/01/13,21:30:00,252.69,15,10348,10363
2022/01/13,22:00:00,253.29,18,9910,9928
2022/01/13,22:30:00,252.93,11,9560,9571
2022/01/13,23:00:00,252.93,1,9092,9093
2022/01/13,23:30:00,253.17,2,8546,8548
2022/01/14,00:00:00,253.17,7,8048,8055
2022/01/14,00:30:00,252.93,11,7612,7623
2022/01/14,01:00:00,252.81,15,7195,7210
2022/01/14,01:30:00,252.81,11,7041,7052
2022/01/14,02:00:00,252.81,10,6803,6813
2022/01/14,02:30:00,252.93,15,6671,6686
2022/01/14,03:00:00,252.81,15,6690,6705
2022/01/14,03:30:00,252.81,12,6638,6650
2022/01/14,04:00:00,253.29,11,6622,6633
2022/01/14,04:30:00,252.93,7,6735,6742
2022/01/14,05:00:00,252.81,8,6819,6827
2022/01/14,05:30:00,253.41,7,7078,7085
2022/01/14,06:00:00,252.57,15,7292,7307
2022/01/14,06:30:00,252.21,10,7496,7506
2022/01/14,07:00:00,252.57,10,7721,7731
2022/01/14,07:30:00,252.21,197,8048,8245
2022/01/14,08:00:00,251.5,273,8291,8564
2022/01/14,08:30:00,252.21,341,8487,8828
2022/01/14,09:00:00,252.21,483,8833,9316
2022/01/14,09:30:00,252.33,549,8928,9477
2022/01/14,10:00:00,252.81,709,8951,9660
2022/01/14,10:30:00,252.21,771,9186,9957
2022/01/14,11:00:00,249.16,861,9504,10365
2022/01/14,11:30:00,246.01,719,9673,10392
2022/01/14,12:00:00,245.79,663,9821,10484
2022/01/14,12:30:00,381.5,649,9926,10575
2022/01/14,13:00:00,381.5,566,10094,10660
2022/01/14,13:30:00,378.81,491,10346,10837
2022/01/14,14:00:00,399.04,377,10457,10834
2022/01/14,14:30:00,405.36,378,10519,10897
2022/01/14,15:00:00,405.36,459,10685,11144
2022/01/14,15:30:00,402.16,289,10901,11190
2022/01/14,16:00:00,402.44,272,10950,11222
2022/01/14,16:30:00,399.51,221,10878,11099
2022/01/14,17:00:00,386.14,17,10907,10924
2022/01/14,17:30:00,334.62,2,11136,11138
2022/01/14,18:00:00,402.44,1,11122,11123
2022/01/14,18:30:00,335.32,1,10951,10952
2022/01/14,19:00:00,334.2,1,10734,10735
2022/01/14,19:30:00,356.99,1,10505,10506
2022/01/14,20:00:00,334.18,1,10260,10261
2022/01/14,20:30:00,314.67,1,10037,10038
2022/01/14,21:00:00,252.69,4,9868,9872
2022/01/14,21:30:00,252.69,3,9672,9675
2022/01/14,22:00:00,253.05,3,9386,9389
2022/01/14,22:30:00,253.05,1,9094,9095
2022/01/14,23:00:00,252.45,1,8738,8739
2022/01/14,23:30:00,252.33,3,8312,8315
2022/01/15,00:00:00,252.69,4,7905,7909
2022/01/15,00:30:00,253.05,7,7804,7811
2022/01/15,01:00:00,252.69,7,7505,7512
2022/01/15,01:30:00,252.45,5,7270,7275
2022/01/15,02:00:00,252.21,6,7094,7100
2022/01/15,02:30:00,253.05,5,6934,6939
2022/01/15,03:00:00,252.33,1,6861,6862
2022/01/15,03:30:00,252.69,2,6821,6823
2022/01/15,04:00:00,252.93,1,6797,6798
2022/01/15,04:30:00,252.93,2,6875,6877
2022/01/15,05:00:00,252.93,3,6957,6960
2022/01/15,05:30:00,253.17,11,7134,7145
2022/01/15,06:00:00,252.81,11,7206,7217
2022/01/15,06:30:00,252.57,6,7277,7283
2022/01/15,07:00:00,263.18,2,7357,7359
2022/01/15,07:30:00,252.81,52,7470,7522
2022/01/15,08:00:00,253.17,141,7564,7705
2022/01/15,08:30:00,252.33,166,7902,8068
2022/01/15,09:00:00,264.11,215,8076,8291
2022/01/15,09:30:00,254.02,196,8331,8527
2022/01/15,10:00:00,246.45,200,8659,8859
2022/01/15,10:30:00,245.79,233,8725,8958
2022/01/15,11:00:00,247.79,826,8644,9470
2022/01/15,11:30:00,248.13,815,8620,9435
2022/01/15,12:00:00,253.17,749,8550,9299
2022/01/15,12:30:00,249.39,700,8918,9618
2022/01/15,13:00:00,263.52,813,9029,9842
2022/01/15,13:30:00,263.44,762,8968,9730
2022/01/15,14:00:00,253.17,765,9023,9788
2022/01/15,14:30:00,253.17,627,9139,9766
2022/01/15,15:00:00,252.81,679,9298,9977
2022/01/15,15:30:00,252.33,414,9687,10101
2022/01/15,16:00:00,345.22,372,10003,10375
2022/01/15,16:30:00,385.46,237,10293,10530
2022/01/15,17:00:00,405.17,10,10781,10791
2022/01/15,17:30:00,399.25,8,11146,11154
2022/01/15,18:00:00,396.41,5,11646,11651
2022/01/15,18:30:00,405.17,4,11952,11956
2022/01/15,19:00:00,399.25,5,11906,11911
2022/01/15,19:30:00,402.17,5,11855,11860
2022/01/15,20:00:00,405.17,5,11740,11745
2022/01/15,20:30:00,402.17,5,11569,11574
2022/01/15,21:00:00,405.08,5,11367,11372
2022/01/15,21:30:00,398.74,3,11047,11050
2022/01/15,22:00:00,405.08,6,10626,10632
2022/01/15,22:30:00,338.85,7,10180,10187
2022/01/15,23:00:00,349.32,9,9634,9643
2022/01/15,23:30:00,263.69,9,9052,9061
2022/01/16,00:00:00,252.81,5,8467,8472
2022/01/16,00:30:00,252.81,5,7892,7897
2022/01/16,01:00:00,252.81,8,7725,7733
2022/01/16,01:30:00,252.57,14,7386,7400
2022/01/16,02:00:00,252.57,15,7126,7141
2022/01/16,02:30:00,253.17,7,6987,6994
2022/01/16,03:00:00,252.57,5,6900,6905
2022/01/16,03:30:00,252.57,4,6867,6871
2022/01/16,04:00:00,252.81,7,6872,6879
2022/01/16,04:30:00,252.57,8,7011,7019
2022/01/16,05:00:00,253.17,8,7237,7245
2022/01/16,05:30:00,252.81,4,7495,7499
2022/01/16,06:00:00,252.81,3,7846,7849
2022/01/16,06:30:00,252.81,3,8369,8372
2022/01/16,07:00:00,252.33,0,8858,8858
2022/01/16,07:30:00,252.81,24,9519,9543
2022/01/16,08:00:00,248.02,239,9817,10056
2022/01/16,08:30:00,245.04,424,10305,10729
2022/01/16,09:00:00,381.03,621,10458,11079
2022/01/16,09:30:00,381.03,713,10688,11401
2022/01/16,10:00:00,368.57,761,10856,11617
2022/01/16,10:30:00,339.56,666,11284,11950
2022/01/16,11:00:00,337.38,592,11455,12047
2022/01/16,11:30:00,337.36,513,11698,12211
2022/01/16,12:00:00,336.27,415,11735,12150
2022/01/16,12:30:00,336.27,447,11724,12171
2022/01/16,13:00:00,399.01,385,11719,12104
2022/01/16,13:30:00,402.13,340,11787,12127
2022/01/16,14:00:00,399.01,302,11898,12200
2022/01/16,14:30:00,402.13,237,12001,12238
2022/01/16,15:00:00,402.13,166,12002,12168
2022/01/16,15:30:00,399.01,126,12119,12245
2022/01/16,16:00:00,402.41,118,12129,12247
2022/01/16,16:30:00,1939.37,3,12419,12422
2022/01/16,17:00:00,1923.01,3,12767,12770
2022/01/16,17:30:00,2047.88,3,13150,13153
2022/01/16,18:00:00,2604.23,9,13280,13289
2022/01/16,18:30:00,2604.23,7,13354,13361
2022/01/16,19:00:00,2253.66,7,13289,13296
2022/01/16,19:30:00,2145.54,8,13215,13223
2022/01/16,20:00:00,2047.88,9,13070,13079
2022/01/16,20:30:00,406.67,6,12791,12797
2022/01/16,21:00:00,329.56,2,12515,12517
2022/01/16,21:30:00,321.6,2,12116,12118
2022/01/16,22:00:00,321.17,4,11582,11586
2022/01/16,22:30:00,322.79,7,11094,11101
2022/01/16,23:00:00,371.73,6,10371,10377
2022/01/16,23:30:00,249.96,7,9654,9661
2022/01/17,00:00:00,251.5,5,8952,8957
2022/01/17,00:30:00,251.86,4,8403,8407
2022/01/17,01:00:00,246.55,5,8285,8290
2022/01/17,01:30:00,246.2,5,7929,7934
2022/01/17,02:00:00,246.2,5,7677,7682
2022/01/17,02:30:00,245.85,5,7503,7508
2022/01/17,03:00:00,246.08,5,7391,7396
2022/01/17,03:30:00,245.26,4,7382,7386
2022/01/17,04:00:00,246.08,4,7424,7428
2022/01/17,04:30:00,246.31,4,7597,7601
2022/01/17,05:00:00,245.73,7,7823,7830
2022/01/17,05:30:00,246.31,7,8240,8247
2022/01/17,06:00:00,247.9,5,8579,8584
2022/01/17,06:30:00,247.23,3,9052,9055
2022/01/17,07:00:00,242.35,3,9519,9522
2022/01/17,07:30:00,241.48,238,9968,10206
2022/01/17,08:00:00,242.13,544,9854,10398
2022/01/17,08:30:00,245.5,953,9777,10730
2022/01/17,09:00:00,246.31,1378,9588,10966
2022/01/17,09:30:00,246.43,1611,9425,11036
2022/01/17,10:00:00,246.2,1760,9206,10966
2022/01/17,10:30:00,246.55,1852,9006,10858
2022/01/17,11:00:00,247.79,2012,8820,10832
2022/01/17,11:30:00,253.9,2101,8764,10865
2022/01/17,12:00:00,253.05,2104,8715,10819
2022/01/17,12:30:00,253.05,2101,8717,10818
2022/01/17,13:00:00,253.29,2061,8741,10802
2022/01/17,13:30:00,253.29,2013,8847,10860
2022/01/17,14:00:00,253.17,1852,9059,10911
2022/01/17,14:30:00,253.17,1651,9367,11018
2022/01/17,15:00:00,252.81,1496,9453,10949
2022/01/17,15:30:00,253.05,1193,9986,11179
2022/01/17,16:00:00,352.76,828,10538,11366
2022/01/17,16:30:00,366.86,419,11326,11745
2022/01/17,17:00:00,329.62,83,12254,12337
2022/01/17,17:30:00,330.01,104,13028,13132
2022/01/17,18:00:00,330.83,91,13450,13541
2022/01/17,18:30:00,1928.6,29,13782,13811
2022/01/17,19:00:00,2025.48,4,14034,14038
2022/01/17,19:30:00,2047.88,8,13981,13989
2022/01/17,20:00:00,2047.88,7,13936,13943
2022/01/17,20:30:00,2008.17,6,13721,13727
2022/01/17,21:00:00,405.76,4,13424,13428
2022/01/17,21:30:00,404.42,3,13090,13093
2022/01/17,22:00:00,371.7,1,12393,12394
2022/01/17,22:30:00,363.8,1,11878,11879
2022/01/17,23:00:00,244.52,0,11221,11221
2022/01/17,23:30:00,245.3,1,10392,10393
2022/01/18,00:00:00,245.3,1,9625,9626
2022/01/18,00:30:00,246.78,0,8915,8915
2022/01/18,01:00:00,249.96,4,8452,8456
2022/01/18,01:30:00,252.33,7,8010,8017
2022/01/18,02:00:00,252.21,7,7808,7815
2022/01/18,02:30:00,252.69,6,7721,7727
2022/01/18,03:00:00,252.57,9,7620,7629
2022/01/18,03:30:00,252.81,9,7624,7633
2022/01/18,04:00:00,252.81,12,7628,7640
2022/01/18,04:30:00,252.93,8,7792,7800
2022/01/18,05:00:00,249.48,15,8026,8041
2022/01/18,05:30:00,252.57,14,8433,8447
2022/01/18,06:00:00,252.57,13,8655,8668
2022/01/18,06:30:00,252.93,12,9220,9232
2022/01/18,07:00:00,252.81,11,9832,9843
2022/01/18,07:30:00,246.23,269,10363,10632
2022/01/18,08:00:00,246.12,699,10193,10892
2022/01/18,08:30:00,246.67,1098,10067,11165
2022/01/18,09:00:00,244.83,1440,9969,11409
2022/01/18,09:30:00,264.95,1725,9711,11436
2022/01/18,10:00:00,248.55,1917,9469,11386
2022/01/18,10:30:00,244.26,1994,9241,11235
2022/01/18,11:00:00,244.26,2063,9118,11181
2022/01/18,11:30:00,244.61,2096,8979,11075
2022/01/18,12:00:00,247.01,2112,8958,11070
2022/01/18,12:30:00,252.57,2031,8875,10906
2022/01/18,13:00:00,251.62,2046,8905,10951
2022/01/18,13:30:00,252.33,1972,8984,10956
2022/01/18,14:00:00,252.21,1859,9117,10976
2022/01/18,14:30:00,252.45,1737,9382,11119
2022/01/18,15:00:00,251.74,1540,9695,11235
2022/01/18,15:30:00,252.33,1183,10193,11376
2022/01/18,16:00:00,384.47,819,10434,11253
2022/01/18,16:30:00,313.05,436,11216,11652
2022/01/18,17:00:00,370.24,116,12147,12263
2022/01/18,17:30:00,333.91,147,13021,13168
2022/01/18,18:00:00,1939.37,151,13374,13525
2022/01/18,18:30:00,1928.6,152,13589,13741
2022/01/18,19:00:00,1986.76,155,13664,13819
2022/01/18,19:30:00,2078.4,180,13642,13822
2022/01/18,20:00:00,2030.57,175,13580,13755
2022/01/18,20:30:00,2030.57,172,13407,13579
2022/01/18,21:00:00,384.47,178,13132,13310
2022/01/18,21:30:00,323.02,178,12794,12972
2022/01/18,22:00:00,346.27,192,12170,12362
2022/01/18,22:30:00,362.19,210,11577,11787
2022/01/18,23:00:00,235.11,173,10918,11091
2022/01/18,23:30:00,235.37,132,10106,10238
2022/01/19,00:00:00,245.3,135,9421,9556
2022/01/19,00:30:00,251.97,141,8730,8871
2022/01/19,01:00:00,252.45,143,8539,8682
2022/01/19,01:30:00,252.93,133,8194,8327
2022/01/19,02:00:00,252.69,127,7938,8065
2022/01/19,02:30:00,252.81,138,7757,7895
2022/01/19,03:00:00,252.81,153,7643,7796
2022/01/19,03:30:00,252.81,152,7559,7711
2022/01/19,04:00:00,252.81,136,7586,7722
2022/01/19,04:30:00,252.45,117,7751,7868
2022/01/19,05:00:00,252.57,129,8020,8149
2022/01/19,05:30:00,253.17,120,8417,8537
2022/01/19,06:00:00,252.81,111,8857,8968
2022/01/19,06:30:00,253.17,104,9397,9501
2022/01/19,07:00:00,252.81,99,9993,10092
2022/01/19,07:30:00,252.33,130,10594,10724
2022/01/19,08:00:00,253.17,150,10957,11107
2022/01/19,08:30:00,252.95,282,11462,11744
2022/01/19,09:00:00,370.24,365,11658,12023
2022/01/19,09:30:00,305.8,442,11848,12290
2022/01/19,10:00:00,346.66,542,11820,12362
2022/01/19,10:30:00,334.58,733,11614,12347
2022/01/19,11:00:00,324.43,805,11491,12296
2022/01/19,11:30:00,324.43,1004,11336,12340
2022/01/19,12:00:00,325.78,964,11453,12417
2022/01/19,12:30:00,324.43,1102,11506,12608
2022/01/19,13:00:00,324.89,914,11710,12624
2022/01/19,13:30:00,325.24,916,11760,12676
2022/01/19,14:00:00,326.6,966,11882,12848
2022/01/19,14:30:00,326.6,862,12178,13040
2022/01/19,15:00:00,325.59,745,12392,13137
2022/01/19,15:30:00,324.44,522,12733,13255
2022/01/19,16:00:00,401.78,427,12927,13354
2022/01/19,16:30:00,1923.01,210,13353,13563
2022/01/19,17:00:00,2008.17,108,13754,13862
2022/01/19,17:30:00,2604.76,80,14244,14324
2022/01/19,18:00:00,2413.06,79,14514,14593
2022/01/19,18:30:00,3087.3,96,14607,14703
2022/01/19,19:00:00,3087.3,97,14573,14670
2022/01/19,19:30:00,3087.3,58,14490,14548
2022/01/19,20:00:00,3087.3,31,14329,14360
2022/01/19,20:30:00,2469.67,24,14059,14083
2022/01/19,21:00:00,337.95,34,13754,13788
2022/01/19,21:30:00,329.64,72,13252,13324
2022/01/19,22:00:00,328.58,56,12627,12683
2022/01/19,22:30:00,320.72,88,11861,11949
2022/01/19,23:00:00,366.98,94,11123,11217
2022/01/19,23:30:00,241.79,96,10335,10431
2022/01/20,00:00:00,244.78,103,9591,9694
2022/01/20,00:30:00,247.9,98,8953,9051
2022/01/20,01:00:00,253.05,97,8570,8667
2022/01/20,01:30:00,252.69,105,8371,8476
2022/01/20,02:00:00,252.33,105,8071,8176
2022/01/20,02:30:00,252.33,107,7876,7983
2022/01/20,03:00:00,252.33,104,7770,7874
2022/01/20,03:30:00,252.33,103,7733,7836
2022/01/20,04:00:00,252.09,103,7765,7868
2022/01/20,04:30:00,252.21,102,7899,8001
2022/01/20,05:00:00,252.57,103,8135,8238
2022/01/20,05:30:00,252.33,102,8554,8656
2022/01/20,06:00:00,252.21,97,8984,9081
2022/01/20,06:30:00,252.21,96,9524,9620
2022/01/20,07:00:00,252.21,93,10171,10264
2022/01/20,07:30:00,252.09,268,10420,10688
2022/01/20,08:00:00,251.74,465,10532,10997
2022/01/20,08:30:00,252.09,702,10616,11318
2022/01/20,09:00:00,316.64,959,10514,11473
2022/01/20,09:30:00,318.45,1023,10553,11576
2022/01/20,10:00:00,318.46,1078,10345,11423
2022/01/20,10:30:00,318.91,1299,10361,11660
2022/01/20,11:00:00,376.57,1307,10255,11562
2022/01/20,11:30:00,372.63,1471,10223,11694
2022/01/20,12:00:00,369.45,1198,10196,11394
2022/01/20,12:30:00,372.63,1240,10218,11458
2022/01/20,13:00:00,371.11,1113,10212,11325
2022/01/20,13:30:00,371.29,1117,10307,11424
2022/01/20,14:00:00,371.29,1097,10423,11520
2022/01/20,14:30:00,363.69,1206,10563,11769
2022/01/20,15:00:00,366.91,946,10741,11687
2022/01/20,15:30:00,368.54,671,11247,11918
2022/01/20,16:00:00,398.77,466,11615,12081
2022/01/20,16:30:00,398.77,306,12133,12439
2022/01/20,17:00:00,1843.78,85,12728,12813
2022/01/20,17:30:00,2469.67,105,13490,13595
2022/01/20,18:00:00,2469.67,90,13736,13826
2022/01/20,18:30:00,2488.41,79,13885,13964
2022/01/20,19:00:00,2488.41,69,13914,13983
2022/01/20,19:30:00,332.79,95,13802,13897
2022/01/20,20:00:00,330.83,85,13636,13721
2022/01/20,20:30:00,328.12,76,13414,13490
2022/01/20,21:00:00,379.15,77,13110,13187
2022/01/20,21:30:00,327.67,69,12747,12816
2022/01/20,22:00:00,327.06,55,12144,12199
2022/01/20,22:30:00,371.29,84,11639,11723
2022/01/20,23:00:00,239.69,77,11026,11103
2022/01/20,23:30:00,239.69,85,10365,10450
2022/01/21,00:00:00,245.58,77,9688,9765
2022/01/21,00:30:00,252.09,73,9088,9161
2022/01/21,01:00:00,253.05,80,8724,8804
2022/01/21,01:30:00,253.05,79,8468,8547
2022/01/21,02:00:00,253.05,55,8151,8206
2022/01/21,02:30:00,253.05,53,7913,7966
2022/01/21,03:00:00,253.05,46,7780,7826
2022/01/21,03:30:00,252.81,25,7695,7720
2022/01/21,04:00:00,252.57,25,7698,7723
2022/01/21,04:30:00,252.81,16,7803,7819
2022/01/21,05:00:00,252.57,3,7984,7987
2022/01/21,05:30:00,252.81,0,8266,8266
2022/01/21,06:00:00,252.57,1,8474,8475
2022/01/21,06:30:00,252.57,6,8738,8744
2022/01/21,07:00:00,252.57,5,9058,9063
2022/01/21,07:30:00,253.17,247,9332,9579
2022/01/21,08:00:00,252.57,659,9166,9825
2022/01/21,08:30:00,252.57,1097,8963,10060
2022/01/21,09:00:00,252.33,1384,8845,10229
2022/01/21,09:30:00,252.57,1582,8776,10358
2022/01/21,10:00:00,252.81,1761,8680,10441
2022/01/21,10:30:00,252.33,1921,8587,10508
2022/01/21,11:00:00,252.57,2038,8479,10517
2022/01/21,11:30:00,252.81,2090,8362,10452
2022/01/21,12:00:00,300.32,2118,8160,10278
2022/01/21,12:30:00,299.12,2109,7959,10068
2022/01/21,13:00:00,299.12,2062,7802,9864
2022/01/21,13:30:00,300.32,2005,7893,9898
2022/01/21,14:00:00,271.26,1892,8039,9931
2022/01/21,14:30:00,252.33,1735,8351,10086
2022/01/21,15:00:00,252.57,1579,8699,10278
2022/01/21,15:30:00,252.57,1210,9336,10546
2022/01/21,16:00:00,253.17,785,10072,10857
2022/01/21,16:30:00,367.36,379,10848,11227
2022/01/21,17:00:00,350.18,89,11233,11322
2022/01/21,17:30:00,343.03,108,11836,11944
2022/01/21,18:00:00,334.2,111,12020,12131
2022/01/21,18:30:00,334.15,121,11960,12081
2022/01/21,19:00:00,333.43,129,11782,11911
2022/01/21,19:30:00,333.56,137,11546,11683
2022/01/21,20:00:00,406.1,140,11331,11471
2022/01/21,20:30:00,330.5,142,11152,11294
2022/01/21,21:00:00,332.62,151,10911,11062
2022/01/21,21:30:00,333.7,153,10741,10894
2022/01/21,22:00:00,323.39,155,10410,10565
2022/01/21,22:30:00,361.3,115,10110,10225
2022/01/21,23:00:00,252.21,48,9704,9752
2022/01/21,23:30:00,252.57,43,9206,9249
2022/01/22,00:00:00,252.33,34,8726,8760
2022/01/22,00:30:00,252.33,37,8316,8353
2022/01/22,01:00:00,252.33,45,8076,8121
2022/01/22,01:30:00,252.21,31,7788,7819
2022/01/22,02:00:00,252.45,39,7551,7590
2022/01/22,02:30:00,252.21,37,7476,7513
2022/01/22,03:00:00,252.45,45,7364,7409
2022/01/22,03:30:00,252.33,44,7344,7388
2022/01/22,04:00:00,252.69,43,7327,7370
2022/01/22,04:30:00,252.21,27,7380,7407
2022/01/22,05:00:00,252.33,24,7505,7529
2022/01/22,05:30:00,252.33,22,7697,7719
2022/01/22,06:00:00,252.33,26,7618,7644
2022/01/22,06:30:00,252.21,31,7561,7592
2022/01/22,07:00:00,252.09,35,7584,7619
2022/01/22,07:30:00,252.45,274,7549,7823
2022/01/22,08:00:00,252.69,639,7419,8058
2022/01/22,08:30:00,252.45,1095,7407,8502
2022/01/22,09:00:00,253.17,1500,7244,8744
2022/01/22,09:30:00,252.09,1751,7116,8867
2022/01/22,10:00:00,252.33,1903,7007,8910
2022/01/22,10:30:00,252.45,2019,6976,8995
2022/01/22,11:00:00,252.33,2099,6817,8916
2022/01/22,11:30:00,252.69,2111,6685,8796
2022/01/22,12:00:00,252.81,2128,6602,8730
2022/01/22,12:30:00,251.86,2028,6808,8836
2022/01/22,13:00:00,252.33,1942,6835,8777
2022/01/22,13:30:00,252.45,1903,6858,8761
2022/01/22,14:00:00,252.57,1766,6852,8618
2022/01/22,14:30:00,252.69,1512,7086,8598
2022/01/22,15:00:00,252.57,1375,7434,8809
2022/01/22,15:30:00,251.86,1087,7840,8927
2022/01/22,16:00:00,247.01,738,8527,9265
2022/01/22,16:30:00,251.32,327,9399,9726
2022/01/22,17:00:00,251.32,94,10170,10264
2022/01/22,17:30:00,379.47,105,10998,11103
2022/01/22,18:00:00,379.47,113,11611,11724
2022/01/22,18:30:00,377.57,113,12024,12137
2022/01/22,19:00:00,379.47,109,12151,12260
2022/01/22,19:30:00,381.41,109,12169,12278
2022/01/22,20:00:00,381.41,113,12085,12198
2022/01/22,20:30:00,379,114,11976,12090
2022/01/22,21:00:00,377.45,120,11785,11905
2022/01/22,21:30:00,249.04,122,11541,11663
2022/01/22,22:00:00,251.32,97,11267,11364
2022/01/22,22:30:00,245.04,11,10832,10843
2022/01/22,23:00:00,244.26,18,10267,10285
2022/01/22,23:30:00,245.04,17,9537,9554
2022/01/23,00:00:00,245.5,22,8887,8909
2022/01/23,00:30:00,248.65,23,8431,8454
2022/01/23,01:00:00,253.17,29,8080,8109
2022/01/23,01:30:00,252.57,46,7755,7801
2022/01/23,02:00:00,300.32,55,7484,7539
2022/01/23,02:30:00,300.32,43,7277,7320
2022/01/23,03:00:00,300.32,37,7139,7176
2022/01/23,03:30:00,300.32,62,7089,7151
2022/01/23,04:00:00,300.32,64,7124,7188
2022/01/23,04:30:00,300.32,71,7256,7327
2022/01/23,05:00:00,252.81,60,7498,7558
2022/01/23,05:30:00,252.81,54,7929,7983
2022/01/23,06:00:00,252.81,58,8311,8369
2022/01/23,06:30:00,252.33,45,8976,9021
2022/01/23,07:00:00,252.33,54,9494,9548
2022/01/23,07:30:00,253.17,307,9679,9986
2022/01/23,08:00:00,329.46,742,9387,10129
2022/01/23,08:30:00,325.55,1160,9306,10466
2022/01/23,09:00:00,278.18,1509,9182,10691
2022/01/23,09:30:00,277.13,1653,9350,11003
2022/01/23,10:00:00,278.2,1850,9240,11090
2022/01/23,10:30:00,279.08,1925,9198,11123
2022/01/23,11:00:00,279.1,1995,9227,11222
2022/01/23,11:30:00,279.05,2025,9301,11326
2022/01/23,12:00:00,280.16,2057,9484,11541
2022/01/23,12:30:00,376.77,1968,9747,11715
2022/01/23,13:00:00,369.77,1889,10040,11929
2022/01/23,13:30:00,332.48,1667,10343,12010
2022/01/23,14:00:00,332.48,1548,10863,12411
2022/01/23,14:30:00,405.03,1170,11374,12544
2022/01/23,15:00:00,405.03,962,11696,12658
2022/01/23,15:30:00,395.69,692,12025,12717
2022/01/23,16:00:00,328.49,531,12205,12736
2022/01/23,16:30:00,334.65,471,12595,13066
2022/01/23,17:00:00,338.2,247,13004,13251
2022/01/23,17:30:00,1928.6,227,13524,13751
2022/01/23,18:00:00,3087.3,232,13846,14078
2022/01/23,18:30:00,3087.3,234,13879,14113
2022/01/23,19:00:00,3087.3,235,13816,14051
2022/01/23,19:30:00,2008.17,152,13782,13934
2022/01/23,20:00:00,2030.57,91,13644,13735
2022/01/23,20:30:00,331.65,71,13404,13475
2022/01/23,21:00:00,331.15,83,13027,13110
2022/01/23,21:30:00,385.03,64,12577,12641
2022/01/23,22:00:00,335.46,69,11822,11891
2022/01/23,22:30:00,347.42,67,11288,11355
2022/01/23,23:00:00,250.67,75,10580,10655
2022/01/23,23:30:00,251.26,57,9765,9822
2022/01/24,00:00:00,250.91,44,9108,9152
2022/01/24,00:30:00,251.38,46,8522,8568
2022/01/24,01:00:00,250.79,42,8041,8083
2022/01/24,01:30:00,251.03,48,7997,8045
2022/01/24,02:00:00,300.32,58,7752,7810
2022/01/24,02:30:00,300.32,45,7581,7626
2022/01/24,03:00:00,300.32,62,7471,7533
2022/01/24,03:30:00,300.32,59,7426,7485
2022/01/24,04:00:00,300.32,73,7407,7480
2022/01/24,04:30:00,300.32,89,7572,7661
2022/01/24,05:00:00,300.32,78,7838,7916
2022/01/24,05:30:00,300.32,47,8305,8352
2022/01/24,06:00:00,250.56,47,8459,8506
2022/01/24,06:30:00,250.91,49,9099,9148
2022/01/24,07:00:00,249.74,35,9806,9841
2022/01/24,07:30:00,248.7,293,10491,10784
2022/01/24,08:00:00,368.93,525,10530,11055
2022/01/24,08:30:00,373.33,824,10702,11526
2022/01/24,09:00:00,328.96,1023,11023,12046
2022/01/24,09:30:00,328.96,1060,11258,12318
2022/01/24,10:00:00,328.97,1236,11201,12437
2022/01/24,10:30:00,328.97,1329,11204,12533
2022/01/24,11:00:00,331.43,1224,11166,12390
2022/01/24,11:30:00,330.19,1174,11190,12364
2022/01/24,12:00:00,330.2,1111,11326,12437
2022/01/24,12:30:00,331.43,1098,11432,12530
2022/01/24,13:00:00,330.95,1252,11460,12712
2022/01/24,13:30:00,331.52,1258,11594,12852
2022/01/24,14:00:00,330.32,1039,11859,12898
2022/01/24,14:30:00,327.85,1047,11940,12987
2022/01/24,15:00:00,327.58,963,12101,13064
2022/01/24,15:30:00,327.69,883,12176,13059
2022/01/24,16:00:00,329.3,689,12364,13053
2022/01/24,16:30:00,331.69,344,12857,13201
2022/01/24,17:00:00,2001.68,162,13238,13400
2022/01/24,17:30:00,2071.28,111,13887,13998
2022/01/24,18:00:00,2469.67,90,14047,14137
2022/01/24,18:30:00,2469.67,106,14138,14244
2022/01/24,19:00:00,2469.67,105,14118,14223
2022/01/24,19:30:00,2060.06,77,14061,14138
2022/01/24,20:00:00,2060.06,53,13866,13919
2022/01/24,20:30:00,1928.6,45,13661,13706
2022/01/24,21:00:00,329.44,44,13293,13337
2022/01/24,21:30:00,329.26,44,12949,12993
2022/01/24,22:00:00,324.81,44,12312,12356
2022/01/24,22:30:00,385.71,35,11848,11883
2022/01/24,23:00:00,322.54,33,11101,11134
2022/01/24,23:30:00,345.95,33,10286,10319
2022/01/25,00:00:00,249.12,33,9571,9604
2022/01/25,00:30:00,252.33,33,9076,9109
2022/01/25,01:00:00,252.81,33,8513,8546
2022/01/25,01:30:00,252.81,33,8306,8339
2022/01/25,02:00:00,255.31,41,8082,8123
2022/01/25,02:30:00,279.8,41,7895,7936
2022/01/25,03:00:00,279.41,39,7810,7849
2022/01/25,03:30:00,279.37,39,7761,7800
2022/01/25,04:00:00,255.27,39,7774,7813
2022/01/25,04:30:00,252.45,41,7956,7997
2022/01/25,05:00:00,252.45,44,8215,8259
2022/01/25,05:30:00,252.45,51,8630,8681
2022/01/25,06:00:00,252.69,45,9072,9117
2022/01/25,06:30:00,252.45,41,9708,9749
2022/01/25,07:00:00,251.5,27,10205,10232
2022/01/25,07:30:00,245.04,296,10531,10827
2022/01/25,08:00:00,266.56,632,10132,10764
2022/01/25,08:30:00,367.47,1047,9891,10938
2022/01/25,09:00:00,312.65,1417,9582,10999
2022/01/25,09:30:00,313.06,1717,9278,10995
2022/01/25,10:00:00,314.36,1890,9140,11030
2022/01/25,10:30:00,317.12,1975,8943,10918
2022/01/25,11:00:00,317.12,2035,8828,10863
2022/01/25,11:30:00,317.13,2036,8695,10731
2022/01/25,12:00:00,318.28,2059,8603,10662
2022/01/25,12:30:00,317.31,2036,8523,10559
2022/01/25,13:00:00,318.51,2066,8568,10634
2022/01/25,13:30:00,320.71,1938,8778,10716
2022/01/25,14:00:00,320.71,1725,8875,10600
2022/01/25,14:30:00,319.88,1545,9176,10721
2022/01/25,15:00:00,369.14,1373,9500,10873
2022/01/25,15:30:00,333.15,971,10014,10985
2022/01/25,16:00:00,334.47,699,10417,11116
2022/01/25,16:30:00,335.9,403,11160,11563
2022/01/25,17:00:00,334.96,110,11932,12042
2022/01/25,17:30:00,334.14,148,12812,12960
2022/01/25,18:00:00,334.13,150,13194,13344
2022/01/25,18:30:00,332.4,150,13501,13651
2022/01/25,19:00:00,332.14,152,13583,13735
2022/01/25,19:30:00,345.56,157,13548,13705
2022/01/25,20:00:00,332.59,165,13480,13645
2022/01/25,20:30:00,333.72,157,13309,13466
2022/01/25,21:00:00,331.99,164,13056,13220
2022/01/25,21:30:00,335.1,142,12745,12887
2022/01/25,22:00:00,371.43,111,12253,12364
2022/01/25,22:30:00,367.72,58,11726,11784
2022/01/25,23:00:00,268.5,52,11054,11106
2022/01/25,23:30:00,245.04,58,10266,10324
2022/01/26,00:00:00,271.79,63,9543,9606
2022/01/26,00:30:00,300.32,74,8917,8991
2022/01/26,01:00:00,300.32,67,8403,8470
2022/01/26,01:30:00,289.42,65,8340,8405
2022/01/26,02:00:00,300.32,65,7995,8060
2022/01/26,02:30:00,300.32,65,7807,7872
2022/01/26,03:00:00,300.32,45,7690,7735
2022/01/26,03:30:00,300.32,49,7675,7724
2022/01/26,04:00:00,271.49,57,7703,7760
2022/01/26,04:30:00,252.57,56,7885,7941
2022/01/26,05:00:00,252.45,57,8063,8120
2022/01/26,05:30:00,252.69,77,8548,8625
2022/01/26,06:00:00,253.29,49,8936,8985
2022/01/26,06:30:00,253.05,48,9576,9624
2022/01/26,07:00:00,351.55,51,9956,10007
2022/01/26,07:30:00,389.77,297,10447,10744
2022/01/26,08:00:00,365.43,724,10411,11135
2022/01/26,08:30:00,389.77,1114,10421,11535
2022/01/26,09:00:00,389.77,1242,10425,11667
2022/01/26,09:30:00,389.77,1410,10402,11812
2022/01/26,10:00:00,389.77,1641,10199,11840
2022/01/26,10:30:00,369.66,1705,10271,11976
2022/01/26,11:00:00,370.74,1782,10359,12141
2022/01/26,11:30:00,358.09,1563,10621,12184
2022/01/26,12:00:00,364.46,1516,10786,12302
2022/01/26,12:30:00,365.47,1375,10955,12330
2022/01/26,13:00:00,356.13,1005,11400,12405
2022/01/26,13:30:00,358.29,898,11686,12584
2022/01/26,14:00:00,355.98,813,11755,12568
2022/01/26,14:30:00,343.82,756,11982,12738
2022/01/26,15:00:00,348.6,611,12289,12900
2022/01/26,15:30:00,343.49,454,12772,13226
2022/01/26,16:00:00,386.69,416,13043,13459
2022/01/26,16:30:00,1928.6,386,13375,13761
2022/01/26,17:00:00,2047.88,120,13878,13998
2022/01/26,17:30:00,1672.6,136,14286,14422
2022/01/26,18:00:00,2803.11,137,14575,14712
2022/01/26,18:30:00,2901.81,97,14689,14786
2022/01/26,19:00:00,2901.81,67,14631,14698
2022/01/26,19:30:00,2469.67,79,14509,14588
2022/01/26,20:00:00,3087.16,114,14281,14395
2022/01/26,20:30:00,2071.28,106,14030,14136
2022/01/26,21:00:00,2047.88,90,13699,13789
2022/01/26,21:30:00,347.12,110,13186,13296
2022/01/26,22:00:00,325.58,129,12548,12677
2022/01/26,22:30:00,377.21,56,11866,11922
2022/01/26,23:00:00,244.41,97,11150,11247
2022/01/26,23:30:00,242.43,74,10476,10550
2022/01/27,00:00:00,243.05,73,9657,9730
2022/01/27,00:30:00,243.57,90,9023,9113
2022/01/27,01:00:00,252.33,88,8510,8598
2022/01/27,01:30:00,279.47,105,8326,8431
2022/01/27,02:00:00,279.8,96,8146,8242
2022/01/27,02:30:00,279.45,51,7986,8037
2022/01/27,03:00:00,300.32,89,7850,7939
2022/01/27,03:30:00,300.32,59,7825,7884
2022/01/27,04:00:00,279.8,108,7829,7937
2022/01/27,04:30:00,300.32,97,7921,8018
2022/01/27,05:00:00,252.33,96,8221,8317
2022/01/27,05:30:00,252.69,109,8555,8664
2022/01/27,06:00:00,252.45,94,8659,8753
2022/01/27,06:30:00,252.33,86,9190,9276
2022/01/27,07:00:00,252.81,79,9866,9945
2022/01/27,07:30:00,248.29,334,10524,10858
2022/01/27,08:00:00,244.46,492,10712,11204
2022/01/27,08:30:00,244.85,518,11157,11675
2022/01/27,09:00:00,244.85,612,11247,11859
2022/01/27,09:30:00,326.7,935,11572,12507
2022/01/27,10:00:00,325.96,903,11498,12401
2022/01/27,10:30:00,325.35,993,11460,12453
2022/01/27,11:00:00,327.42,937,11690,12627
2022/01/27,11:30:00,327.71,1082,11675,12757
2022/01/27,12:00:00,327.91,984,11555,12539
2022/01/27,12:30:00,328.01,1078,11617,12695
2022/01/27,13:00:00,328.11,920,11651,12571
2022/01/27,13:30:00,328.01,1152,11603,12755
2022/01/27,14:00:00,328.25,724,11817,12541
2022/01/27,14:30:00,327.19,847,11772,12619
2022/01/27,15:00:00,328.53,665,11811,12476
2022/01/27,15:30:00,333.6,482,12109,12591
2022/01/27,16:00:00,376.88,380,12249,12629
2022/01/27,16:30:00,331.63,365,12632,12997
2022/01/27,17:00:00,1944.52,115,13193,13308
2022/01/27,17:30:00,2071.28,107,13691,13798
2022/01/27,18:00:00,2047.88,117,13814,13931
2022/01/27,18:30:00,2071.28,76,14035,14111
2022/01/27,19:00:00,1934.06,66,14119,14185
2022/01/27,19:30:00,1704.81,75,14065,14140
2022/01/27,20:00:00,1947.57,75,13896,13971
2022/01/27,20:30:00,345.39,66,13658,13724
2022/01/27,21:00:00,365.88,75,13294,13369
2022/01/27,21:30:00,405.81,60,12888,12948
2022/01/27,22:00:00,384.91,39,12460,12499
2022/01/27,22:30:00,244.93,41,11936,11977
2022/01/27,23:00:00,300.32,16,11343,11359
2022/01/27,23:30:00,253.17,10,10641,10651
2022/01/28,00:00:00,253.17,25,9947,9972
2022/01/28,00:30:00,255.6,21,9249,9270
2022/01/28,01:00:00,262.65,31,8728,8759
2022/01/28,01:30:00,255.63,16,8383,8399
2022/01/28,02:00:00,279.45,23,8226,8249
2022/01/28,02:30:00,279.41,15,8151,8166
2022/01/28,03:00:00,279.39,29,7970,7999
2022/01/28,03:30:00,279.39,22,7893,7915
2022/01/28,04:00:00,279.8,35,7845,7880
2022/01/28,04:30:00,270.48,44,7925,7969
2022/01/28,05:00:00,252.81,39,8106,8145
2022/01/28,05:30:00,252.81,29,8405,8434
2022/01/28,06:00:00,252.57,61,8604,8665
2022/01/28,06:30:00,252.57,46,8940,8986
2022/01/28,07:00:00,252.81,48,9367,9415
2022/01/28,07:30:00,252.81,243,9749,9992
2022/01/28,08:00:00,249.36,474,9793,10267
2022/01/28,08:30:00,249.6,748,9959,10707
2022/01/28,09:00:00,249.12,974,10134,11108
2022/01/28,09:30:00,249.48,1209,10141,11350
2022/01/28,10:00:00,353.03,1488,10220,11708
2022/01/28,10:30:00,349.84,1526,10424,11950
2022/01/28,11:00:00,337.44,1555,10712,12267
2022/01/28,11:30:00,401.53,1619,10867,12486
2022/01/28,12:00:00,396.87,1662,10860,12522
2022/01/28,12:30:00,396.87,1517,11184,12701
2022/01/28,13:00:00,403.14,1295,11664,12959
2022/01/28,13:30:00,401.53,1292,11820,13112
2022/01/28,14:00:00,396.87,1197,12019,13216
2022/01/28,14:30:00,396.87,1072,12081,13153
2022/01/28,15:00:00,394.62,897,12234,13131
2022/01/28,15:30:00,399.17,584,12608,13192
2022/01/28,16:00:00,403.14,563,12854,13417
2022/01/28,16:30:00,369.11,347,13059,13406
2022/01/28,17:00:00,403.14,73,12945,13018
2022/01/28,17:30:00,397.39,58,13113,13171
2022/01/28,18:00:00,373.8,63,13069,13132
2022/01/28,18:30:00,399.54,50,12916,12966
2022/01/28,19:00:00,399.54,39,12659,12698
2022/01/28,19:30:00,327.69,38,12337,12375
2022/01/28,20:00:00,389.93,38,12066,12104
2022/01/28,20:30:00,326.7,27,11877,11904
2022/01/28,21:00:00,328.59,30,11659,11689
2022/01/28,21:30:00,371.43,18,11486,11504
2022/01/28,22:00:00,380.87,30,11175,11205
2022/01/28,22:30:00,249.16,9,10775,10784
2022/01/28,23:00:00,248.7,11,10340,10351
2022/01/28,23:30:00,247.45,14,9808,9822
2022/01/29,00:00:00,246.23,14,9301,9315
2022/01/29,00:30:00,251.74,16,8785,8801
2022/01/29,01:00:00,252.21,10,8691,8701
2022/01/29,01:30:00,252.45,9,8389,8398
2022/01/29,02:00:00,252.33,9,8129,8138
2022/01/29,02:30:00,252.21,17,7915,7932
2022/01/29,03:00:00,252.45,3,7783,7786
2022/01/29,03:30:00,255.24,9,7701,7710
2022/01/29,04:00:00,255.31,9,7649,7658
2022/01/29,04:30:00,252.69,13,7720,7733
2022/01/29,05:00:00,252.57,5,7827,7832
2022/01/29,05:30:00,252.33,7,8037,8044
2022/01/29,06:00:00,252.45,11,8097,8108
2022/01/29,06:30:00,260.06,3,8249,8252
2022/01/29,07:00:00,252.69,3,8289,8292
2022/01/29,07:30:00,252.21,236,8419,8655
2022/01/29,08:00:00,252.21,503,8514,9017
2022/01/29,08:30:00,252.33,833,8546,9379
2022/01/29,09:00:00,252.33,1115,8643,9758
2022/01/29,09:30:00,249.96,1369,8718,10087
2022/01/29,10:00:00,249.36,1619,8693,10312
2022/01/29,10:30:00,249.36,1712,8848,10560
2022/01/29,11:00:00,249.6,1782,8796,10578
2022/01/29,11:30:00,253.17,1634,8913,10547
2022/01/29,12:00:00,253.17,1488,8960,10448
2022/01/29,12:30:00,252.81,1319,9126,10445
2022/01/29,13:00:00,252.93,1416,8774,10190
2022/01/29,13:30:00,252.93,1546,8770,10316
2022/01/29,14:00:00,252.57,1504,8822,10326
2022/01/29,14:30:00,251.97,1391,8982,10373
2022/01/29,15:00:00,370.32,1307,9095,10402
2022/01/29,15:30:00,363.2,1087,9590,10677
2022/01/29,16:00:00,338.27,810,9970,10780
2022/01/29,16:30:00,338.67,446,10536,10982
2022/01/29,17:00:00,378.68,92,11009,11101
2022/01/29,17:30:00,385.14,88,11684,11772
2022/01/29,18:00:00,383.84,102,12122,12224
2022/01/29,18:30:00,385.14,102,12590,12692
2022/01/29,19:00:00,385.14,102,12696,12798
2022/01/29,19:30:00,360.19,102,12695,12797
2022/01/29,20:00:00,369.84,103,12642,12745
2022/01/29,20:30:00,378.49,103,12530,12633
2022/01/29,21:00:00,346.68,102,12318,12420
2022/01/29,21:30:00,342.24,106,12069,12175
2022/01/29,22:00:00,340.15,48,11722,11770
2022/01/29,22:30:00,385.14,1,11316,11317
2022/01/29,23:00:00,250.91,3,10740,10743
2022/01/29,23:30:00,252.33,2,10025,10027
2022/01/30,00:00:00,251.97,3,9297,9300
2022/01/30,00:30:00,251.86,5,8683,8688
2022/01/30,01:00:00,278.88,9,8327,8336
2022/01/30,01:30:00,279.39,13,8109,8122
2022/01/30,02:00:00,300.32,33,7811,7844
2022/01/30,02:30:00,300.32,31,7598,7629
2022/01/30,03:00:00,300.32,27,7477,7504
2022/01/30,03:30:00,300.32,32,7426,7458
2022/01/30,04:00:00,300.32,25,7465,7490
2022/01/30,04:30:00,300.32,35,7602,7637
2022/01/30,05:00:00,252.15,31,7850,7881
2022/01/30,05:30:00,253.17,32,8284,8316
2022/01/30,06:00:00,252.45,33,8571,8604
2022/01/30,06:30:00,250.32,43,9117,9160
2022/01/30,07:00:00,252.69,43,9864,9907
2022/01/30,07:30:00,252.69,328,10052,10380
2022/01/30,08:00:00,249.51,713,9604,10317
2022/01/30,08:30:00,300.32,1119,9384,10503
2022/01/30,09:00:00,300.32,1473,9123,10596
2022/01/30,09:30:00,300.32,1782,8836,10618
2022/01/30,10:00:00,299.23,1919,8701,10620
2022/01/30,10:30:00,300.32,2005,8520,10525
2022/01/30,11:00:00,300.32,2088,8306,10394
2022/01/30,11:30:00,300.32,2112,8158,10270
2022/01/30,12:00:00,300.32,2121,7890,10011
2022/01/30,12:30:00,300.32,2098,7672,9770
2022/01/30,13:00:00,300.32,2095,7718,9813
2022/01/30,13:30:00,300.32,1985,7766,9751
2022/01/30,14:00:00,300.32,1910,7911,9821
2022/01/30,14:30:00,300.32,1751,8170,9921
2022/01/30,15:00:00,300.32,1570,8479,10049
2022/01/30,15:30:00,300.32,1254,8929,10183
2022/01/30,16:00:00,360.78,896,9333,10229
2022/01/30,16:30:00,350.64,524,10056,10580
2022/01/30,17:00:00,348.6,320,10890,11210
2022/01/30,17:30:00,347.99,100,11900,12000
2022/01/30,18:00:00,347.39,111,12491,12602
2022/01/30,18:30:00,346.69,110,12845,12955
2022/01/30,19:00:00,346.09,111,12997,13108
2022/01/30,19:30:00,345.69,110,13081,13191
2022/01/30,20:00:00,345.68,110,13046,13156
2022/01/30,20:30:00,345.68,112,12843,12955
2022/01/30,21:00:00,344.6,113,12587,12700
2022/01/30,21:30:00,397.14,121,12253,12374
2022/01/30,22:00:00,336.44,127,11606,11733
2022/01/30,22:30:00,336.44,129,11184,11313
2022/01/30,23:00:00,385.17,83,10509,10592
2022/01/30,23:30:00,252.45,19,9847,9866
2022/01/31,00:00:00,252.69,21,9069,9090
2022/01/31,00:30:00,252.45,20,8493,8513
2022/01/31,01:00:00,252.81,18,8011,8029
2022/01/31,01:30:00,252.09,36,7894,7930
2022/01/31,02:00:00,252.45,34,7674,7708
2022/01/31,02:30:00,279.48,33,7487,7520
2022/01/31,03:00:00,252.69,32,7398,7430
2022/01/31,03:30:00,252.69,30,7364,7394
2022/01/31,04:00:00,252.45,34,7381,7415
2022/01/31,04:30:00,252.57,38,7580,7618
2022/01/31,05:00:00,252.57,42,7804,7846
2022/01/31,05:30:00,252.45,47,8223,8270
2022/01/31,06:00:00,252.93,34,8377,8411
2022/01/31,06:30:00,252.93,39,9012,9051
2022/01/31,07:00:00,246.34,30,9729,9759
2022/01/31,07:30:00,252.93,274,10105,10379
2022/01/31,08:00:00,252.57,450,9961,10411
2022/01/31,08:30:00,252.57,575,10022,10597
2022/01/31,09:00:00,252.57,934,9828,10762
2022/01/31,09:30:00,252.81,1034,9596,10630
2022/01/31,10:00:00,252.69,957,9808,10765
2022/01/31,10:30:00,252.69,1233,9457,10690
2022/01/31,11:00:00,261.37,1461,9284,10745
2022/01/31,11:30:00,274.84,1635,9117,10752
2022/01/31,12:00:00,300.32,1912,8848,10760
2022/01/31,12:30:00,300.32,1999,8870,10869
2022/01/31,13:00:00,282.56,1844,9004,10848
2022/01/31,13:30:00,283.74,1547,9344,10891
2022/01/31,14:00:00,274.98,1217,9390,10607
2022/01/31,14:30:00,252.69,911,9831,10742
2022/01/31,15:00:00,300.32,695,10031,10726
2022/01/31,15:30:00,300.32,539,10295,10834
2022/01/31,16:00:00,258.81,431,10576,11007
2022/01/31,16:30:00,253.05,162,11180,11342
2022/01/31,17:00:00,332.59,1,11843,11844
2022/01/31,17:30:00,384.1,0,12661,12661
2022/01/31,18:00:00,347.71,0,13029,13029
2022/01/31,18:30:00,348.88,0,13325,13325
2022/01/31,19:00:00,348.1,0,13422,13422
2022/01/31,19:30:00,349.24,2,13416,13418
2022/01/31,20:00:00,346.94,5,13288,13293
2022/01/31,20:30:00,346.94,4,13096,13100
2022/01/31,21:00:00,406.26,5,12796,12801
2022/01/31,21:30:00,346.56,9,12332,12341
2022/01/31,22:00:00,348.53,11,11791,11802
2022/01/31,22:30:00,380.16,1,11313,11314
2022/01/31,23:00:00,245.61,4,10590,10594
2022/01/31,23:30:00,252.69,5,9782,9787
2022/02/01,00:00:00,252.57,13,9116,9129
2022/02/01,00:30:00,252.57,11,8633,8644
2022/02/01,01:00:00,263.53,12,8166,8178
2022/02/01,01:30:00,252.69,7,7927,7934
2022/02/01,02:00:00,263.53,11,7715,7726
2022/02/01,02:30:00,263.6,20,7526,7546
2022/02/01,03:00:00,263.63,22,7411,7433
2022/02/01,03:30:00,263.69,13,7339,7352
2022/02/01,04:00:00,263.69,16,7396,7412
2022/02/01,04:30:00,246.43,18,7509,7527
2022/02/01,05:00:00,245.26,8,7823,7831
2022/02/01,05:30:00,245.61,8,8261,8269
2022/02/01,06:00:00,252.69,7,8569,8576
2022/02/01,06:30:00,252.21,6,9049,9055
2022/02/01,07:00:00,246.56,7,9721,9728
2022/02/01,07:30:00,248.13,215,10154,10369
2022/02/01,08:00:00,244.83,540,9805,10345
2022/02/01,08:30:00,246.56,945,9624,10569
2022/02/01,09:00:00,252.69,1213,9554,10767
2022/02/01,09:30:00,252.93,1404,9578,10982
2022/02/01,10:00:00,252.69,1606,9519,11125
2022/02/01,10:30:00,252.93,1765,9441,11206
2022/02/01,11:00:00,253.76,1845,9407,11252
2022/02/01,11:30:00,252.69,1962,9365,11327
2022/02/01,12:00:00,252.81,1882,9434,11316
2022/02/01,12:30:00,252.81,1905,9496,11401
2022/02/01,13:00:00,252.93,1876,9198,11074
2022/02/01,13:30:00,252.81,1814,9360,11174
2022/02/01,14:00:00,252.81,1757,9481,11238
2022/02/01,14:30:00,252.81,1661,9667,11328
2022/02/01,15:00:00,252.69,1464,9821,11285
2022/02/01,15:30:00,252.45,1292,9993,11285
2022/02/01,16:00:00,252.33,948,10242,11190
2022/02/01,16:30:00,377.14,485,10681,11166
2022/02/01,17:00:00,390.3,388,11388,11776
2022/02/01,17:30:00,397.86,101,12136,12237
2022/02/01,18:00:00,403.62,102,12590,12692
2022/02/01,18:30:00,368.32,102,12820,12922
2022/02/01,19:00:00,362.05,102,12943,13045
2022/02/01,19:30:00,387.62,102,12948,13050
2022/02/01,20:00:00,372.77,102,12901,13003
2022/02/01,20:30:00,397.92,102,12712,12814
2022/02/01,21:00:00,345.75,102,12430,12532
2022/02/01,21:30:00,344.24,96,12010,12106
2022/02/01,22:00:00,385.46,40,11528,11568
2022/02/01,22:30:00,381.78,3,11107,11110
2022/02/01,23:00:00,251.74,6,10422,10428
2022/02/01,23:30:00,252.57,10,9745,9755
2022/02/02,00:00:00,268.95,2,9049,9051
2022/02/02,00:30:00,269.23,2,8442,8444
2022/02/02,01:00:00,269.8,2,7991,7993
2022/02/02,01:30:00,270.09,2,7771,7773
2022/02/02,02:00:00,269.8,0,7494,7494
2022/02/02,02:30:00,269.23,27,7479,7506
2022/02/02,03:00:00,269.23,31,7359,7390
2022/02/02,03:30:00,269.23,40,7299,7339
2022/02/02,04:00:00,269.51,47,7372,7419
2022/02/02,04:30:00,269.51,58,7491,7549
2022/02/02,05:00:00,357.56,54,7777,7831
2022/02/02,05:30:00,367.1,58,8190,8248
2022/02/02,06:00:00,384.79,55,8599,8654
2022/02/02,06:30:00,336.66,58,8948,9006
2022/02/02,07:00:00,353.81,73,9457,9530
2022/02/02,07:30:00,385.51,374,9611,9985
2022/02/02,08:00:00,384.94,808,9038,9846
2022/02/02,08:30:00,385.51,1280,8611,9891
2022/02/02,09:00:00,390.34,1643,8224,9867
2022/02/02,09:30:00,262.62,1808,7874,9682
2022/02/02,10:00:00,269.8,1957,7684,9641
2022/02/02,10:30:00,269.23,2050,7457,9507
2022/02/02,11:00:00,269.51,2142,7373,9515
2022/02/02,11:30:00,268.95,2209,7201,9410
2022/02/02,12:00:00,269.23,2106,7179,9285
2022/02/02,12:30:00,269.23,1929,7250,9179
2022/02/02,13:00:00,269.51,1754,7439,9193
2022/02/02,13:30:00,269.8,1606,7447,9053
2022/02/02,14:00:00,268.95,1485,7658,9143
2022/02/02,14:30:00,268.95,1254,8136,9390
2022/02/02,15:00:00,268.95,995,8520,9515
2022/02/02,15:30:00,269.23,803,8775,9578
2022/02/02,16:00:00,268.95,598,9046,9644
2022/02/02,16:30:00,269.51,443,9588,10031
2022/02/02,17:00:00,358.25,201,10192,10393
2022/02/02,17:30:00,464.39,204,10998,11202
2022/02/02,18:00:00,469.93,188,11530,11718
2022/02/02,18:30:00,472.85,134,11864,11998
2022/02/02,19:00:00,470.06,55,12036,12091
2022/02/02,19:30:00,464.56,63,12062,12125
2022/02/02,20:00:00,456.02,76,11978,12054
2022/02/02,20:30:00,400.95,85,11796,11881
2022/02/02,21:00:00,403.73,80,11567,11647
2022/02/02,21:30:00,329.46,86,11253,11339
2022/02/02,22:00:00,268.12,79,10771,10850
2022/02/02,22:30:00,268.69,74,10306,10380
2022/02/02,23:00:00,268.69,71,9757,9828
2022/02/02,23:30:00,268.69,68,9065,9133
2022/02/03,00:00:00,266.85,76,8465,8541
2022/02/03,00:30:00,266.85,79,7958,8037
2022/02/03,01:00:00,266.6,80,7494,7574
2022/02/03,01:30:00,269.8,57,7517,7574
2022/02/03,02:00:00,269.23,52,7267,7319
2022/02/03,02:30:00,269.8,53,7088,7141
2022/02/03,03:00:00,269.51,53,7028,7081
2022/02/03,03:30:00,269.8,53,6964,7017
2022/02/03,04:00:00,269.8,55,6982,7037
2022/02/03,04:30:00,269.8,60,7155,7215
2022/02/03,05:00:00,269.8,63,7427,7490
2022/02/03,05:30:00,269.8,82,7796,7878
2022/02/03,06:00:00,269.51,73,8134,8207
2022/02/03,06:30:00,269.8,67,8658,8725
2022/02/03,07:00:00,383.89,77,9024,9101
2022/02/03,07:30:00,406.82,370,9135,9505
2022/02/03,08:00:00,269.51,739,8535,9274
2022/02/03,08:30:00,269.8,1190,8216,9406
2022/02/03,09:00:00,268.95,1586,7837,9423
2022/02/03,09:30:00,270.38,1770,7560,9330
2022/02/03,10:00:00,269.51,1914,7266,9180
2022/02/03,10:30:00,269.51,2023,7094,9117
2022/02/03,11:00:00,269.51,2125,6884,9009
2022/02/03,11:30:00,270.09,2165,7044,9209
2022/02/03,12:00:00,269.8,2153,6978,9131
2022/02/03,12:30:00,269.8,2091,6977,9068
2022/02/03,13:00:00,269.51,2080,6953,9033
2022/02/03,13:30:00,269.23,2042,6970,9012
2022/02/03,14:00:00,269.51,1797,7164,8961
2022/02/03,14:30:00,270.38,1408,7313,8721
2022/02/03,15:00:00,269.51,884,7993,8877
2022/02/03,15:30:00,269.51,749,8395,9144
2022/02/03,16:00:00,270.38,556,8903,9459
2022/02/03,16:30:00,269.51,419,9454,9873
2022/02/03,17:00:00,414.86,752,10060,10812
2022/02/03,17:30:00,472.8,124,10787,10911
2022/02/03,18:00:00,486.22,128,11163,11291
2022/02/03,18:30:00,486.22,119,11410,11529
2022/02/03,19:00:00,486.22,124,11474,11598
2022/02/03,19:30:00,472.91,127,11456,11583
2022/02/03,20:00:00,486.22,147,11344,11491
2022/02/03,20:30:00,486.22,126,11209,11335
2022/02/03,21:00:00,472.91,84,11018,11102
2022/02/03,21:30:00,473.23,15,10739,10754
2022/02/03,22:00:00,400.39,25,10343,10368
2022/02/03,22:30:00,400.33,44,10045,10089
2022/02/03,23:00:00,381.84,63,9577,9640
2022/02/03,23:30:00,270.09,107,8971,9078
2022/02/04,00:00:00,269.23,64,8486,8550
2022/02/04,00:30:00,269.23,53,7994,8047
2022/02/04,01:00:00,269.8,55,7544,7599
2022/02/04,01:30:00,269.51,42,7221,7263
2022/02/04,02:00:00,270.09,35,7167,7202
2022/02/04,02:30:00,269.23,24,7141,7165
2022/02/04,03:00:00,269.8,51,6976,7027
2022/02/04,03:30:00,269.23,69,6882,6951
2022/02/04,04:00:00,268.69,73,6897,6970
2022/02/04,04:30:00,269.51,44,7008,7052
2022/02/04,05:00:00,269.23,56,7192,7248
2022/02/04,05:30:00,269.8,49,7458,7507
2022/02/04,06:00:00,269.8,60,7639,7699
2022/02/04,06:30:00,270.09,71,7902,7973
2022/02/04,07:00:00,269.8,64,8237,8301
2022/02/04,07:30:00,269.51,254,8604,8858
2022/02/04,08:00:00,270.09,468,8537,9005
2022/02/04,08:30:00,269.8,731,8381,9112
2022/02/04,09:00:00,270.09,1143,8333,9476
2022/02/04,09:30:00,269.51,1419,8434,9853
2022/02/04,10:00:00,270.38,1525,8628,10153
2022/02/04,10:30:00,269.51,1504,8844,10348
2022/02/04,11:00:00,270.09,1453,9138,10591
2022/02/04,11:30:00,269.23,1454,9245,10699
2022/02/04,12:00:00,368.32,1361,9282,10643
2022/02/04,12:30:00,329.8,1116,9441,10557
2022/02/04,13:00:00,326.06,814,9587,10401
2022/02/04,13:30:00,342.42,631,9955,10586
2022/02/04,14:00:00,341.06,636,10034,10670
2022/02/04,14:30:00,341.43,640,10318,10958
2022/02/04,15:00:00,475.45,647,10435,11082
2022/02/04,15:30:00,486.31,515,10563,11078
2022/02/04,16:00:00,486.31,450,10833,11283
2022/02/04,16:30:00,463.53,365,11223,11588
2022/02/04,17:00:00,405.51,227,11377,11604
2022/02/04,17:30:00,486.31,89,11567,11656
2022/02/04,18:00:00,486.31,111,11557,11668
2022/02/04,18:30:00,402.19,115,11444,11559
2022/02/04,19:00:00,354.73,120,11118,11238
2022/02/04,19:30:00,346.12,109,10837,10946
2022/02/04,20:00:00,347.24,72,10659,10731
2022/02/04,20:30:00,398.06,51,10539,10590
2022/02/04,21:00:00,398.06,31,10443,10474
2022/02/04,21:30:00,398.06,11,10256,10267
2022/02/04,22:00:00,331.73,18,9943,9961
2022/02/04,22:30:00,397.47,21,9673,9694
2022/02/04,23:00:00,270.09,15,9271,9286
2022/02/04,23:30:00,269.8,23,8771,8794
2022/02/05,00:00:00,269.51,17,8313,8330
2022/02/05,00:30:00,269.8,33,7910,7943
2022/02/05,01:00:00,264.46,29,7533,7562
2022/02/05,01:30:00,269.51,24,7392,7416
2022/02/05,02:00:00,268.67,14,7355,7369
2022/02/05,02:30:00,269.51,11,7178,7189
2022/02/05,03:00:00,270.38,13,7080,7093
2022/02/05,03:30:00,269.51,10,7007,7017
2022/02/05,04:00:00,268.67,16,7007,7023
2022/02/05,04:30:00,269.8,4,7088,7092
2022/02/05,05:00:00,269.51,11,7161,7172
2022/02/05,05:30:00,269.8,20,7321,7341
2022/02/05,06:00:00,269.8,10,7410,7420
2022/02/05,06:30:00,270.38,6,7459,7465
2022/02/05,07:00:00,270.09,11,7593,7604
2022/02/05,07:30:00,269.8,157,7839,7996
2022/02/05,08:00:00,269.8,451,7786,8237
2022/02/05,08:30:00,270.09,717,7910,8627
2022/02/05,09:00:00,269.8,1051,7944,8995
2022/02/05,09:30:00,269.8,1236,7934,9170
2022/02/05,10:00:00,269.51,1174,8152,9326
2022/02/05,10:30:00,269.8,1259,8185,9444
2022/02/05,11:00:00,269.51,1095,8335,9430
2022/02/05,11:30:00,269.8,1248,8372,9620
2022/02/05,12:00:00,269.51,1184,8326,9510
2022/02/05,12:30:00,270.09,933,8481,9414
2022/02/05,13:00:00,269.23,925,8552,9477
2022/02/05,13:30:00,269.8,878,8617,9495
2022/02/05,14:00:00,269.51,844,8652,9496
2022/02/05,14:30:00,269.8,836,8694,9530
2022/02/05,15:00:00,269.51,747,8835,9582
2022/02/05,15:30:00,268.67,714,9138,9852
2022/02/05,16:00:00,269.23,628,9453,10081
2022/02/05,16:30:00,403.02,377,9954,10331
2022/02/05,17:00:00,406.6,34,10370,10404
2022/02/05,17:30:00,406.6,23,10892,10915
2022/02/05,18:00:00,466.42,19,11264,11283
2022/02/05,18:30:00,463.59,21,11702,11723
2022/02/05,19:00:00,472.41,18,11777,11795
2022/02/05,19:30:00,478.77,25,11737,11762
2022/02/05,20:00:00,466.42,24,11626,11650
2022/02/05,20:30:00,466.42,22,11463,11485
2022/02/05,21:00:00,406.6,36,11200,11236
2022/02/05,21:30:00,400.71,24,10969,10993
2022/02/05,22:00:00,406.6,28,10622,10650
2022/02/05,22:30:00,267.87,36,10223,10259
2022/02/05,23:00:00,268.4,41,9746,9787
2022/02/05,23:30:00,267.61,51,9142,9193
2022/02/06,00:00:00,267.35,60,8553,8613
2022/02/06,00:30:00,267.35,79,7931,8010
2022/02/06,01:00:00,267.35,65,7476,7541
2022/02/06,01:30:00,267.61,67,7217,7284
2022/02/06,02:00:00,268.4,47,7117,7164
2022/02/06,02:30:00,268.4,39,6969,7008
2022/02/06,03:00:00,268.13,30,6866,6896
2022/02/06,03:30:00,268.95,30,6826,6856
2022/02/06,04:00:00,268.95,15,6847,6862
2022/02/06,04:30:00,268.67,18,6981,6999
2022/02/06,05:00:00,268.67,29,7277,7306
2022/02/06,05:30:00,268.67,13,7669,7682
2022/02/06,06:00:00,269.23,16,8041,8057
2022/02/06,06:30:00,269.51,37,8563,8600
2022/02/06,07:00:00,406.62,77,8981,9058
2022/02/06,07:30:00,399.56,291,9275,9566
2022/02/06,08:00:00,269.51,639,9004,9643
2022/02/06,08:30:00,267.61,839,8961,9800
2022/02/06,09:00:00,268.4,888,8871,9759
2022/02/06,09:30:00,270.09,1151,8790,9941
2022/02/06,10:00:00,269.23,1368,8572,9940
2022/02/06,10:30:00,268.4,1517,8322,9839
2022/02/06,11:00:00,268.4,1744,8262,10006
2022/02/06,11:30:00,267.1,1791,8374,10165
2022/02/06,12:00:00,268.95,1824,8378,10202
2022/02/06,12:30:00,267.87,1845,8585,10430
2022/02/06,13:00:00,268.4,1600,8950,10550
2022/02/06,13:30:00,268.95,1656,8693,10349
2022/02/06,14:00:00,268.4,1574,8944,10518
2022/02/06,14:30:00,268.67,1550,9153,10703
2022/02/06,15:00:00,268.4,1552,9282,10834
2022/02/06,15:30:00,268.67,1351,9534,10885
2022/02/06,16:00:00,269.51,1103,9754,10857
2022/02/06,16:30:00,406.62,630,10292,10922
2022/02/06,17:00:00,406.62,483,10924,11407
2022/02/06,17:30:00,397.71,128,11622,11750
2022/02/06,18:00:00,403.38,129,12043,12172
2022/02/06,18:30:00,397.71,133,12332,12465
2022/02/06,19:00:00,397.71,141,12346,12487
2022/02/06,19:30:00,406.62,139,12324,12463
2022/02/06,20:00:00,406.62,144,12221,12365
2022/02/06,20:30:00,397.71,144,12033,12177
2022/02/06,21:00:00,385.93,134,11742,11876
2022/02/06,21:30:00,385.88,87,11420,11507
2022/02/06,22:00:00,386.98,51,10921,10972
2022/02/06,22:30:00,386.95,62,10488,10550
2022/02/06,23:00:00,269.23,55,9857,9912
2022/02/06,23:30:00,270.09,57,9221,9278
2022/02/07,00:00:00,269.51,51,8591,8642
2022/02/07,00:30:00,269.51,60,7995,8055
2022/02/07,01:00:00,270.38,48,7482,7530
2022/02/07,01:30:00,269.51,62,7209,7271
2022/02/07,02:00:00,270.09,44,6963,7007
2022/02/07,02:30:00,270.09,42,6817,6859
2022/02/07,03:00:00,270.09,41,6711,6752
2022/02/07,03:30:00,270.38,46,6705,6751
2022/02/07,04:00:00,269.8,37,6746,6783
2022/02/07,04:30:00,269.8,18,6889,6907
2022/02/07,05:00:00,269.8,13,7188,7201
2022/02/07,05:30:00,265.36,20,7515,7535
2022/02/07,06:00:00,269.8,14,7922,7936
2022/02/07,06:30:00,268.95,14,8436,8450
2022/02/07,07:00:00,270.09,20,8988,9008
2022/02/07,07:30:00,270.09,309,9232,9541
2022/02/07,08:00:00,269.8,749,8838,9587
2022/02/07,08:30:00,269.8,1231,8580,9811
2022/02/07,09:00:00,269.8,1580,8302,9882
2022/02/07,09:30:00,270.38,1811,8116,9927
2022/02/07,10:00:00,270.09,1987,7933,9920
2022/02/07,10:30:00,269.8,2122,7790,9912
2022/02/07,11:00:00,269.51,2178,7663,9841
2022/02/07,11:30:00,270.09,2192,7532,9724
2022/02/07,12:00:00,269.23,2198,7505,9703
2022/02/07,12:30:00,269.8,2221,7397,9618
2022/02/07,13:00:00,269.8,2110,7544,9654
2022/02/07,13:30:00,269.8,2119,7621,9740
2022/02/07,14:00:00,270.09,2027,7663,9690
2022/02/07,14:30:00,269.8,1875,7787,9662
2022/02/07,15:00:00,269.8,1662,7946,9608
2022/02/07,15:30:00,269.8,1418,8304,9722
2022/02/07,16:00:00,269.8,1066,8620,9686
2022/02/07,16:30:00,407,636,9115,9751
2022/02/07,17:00:00,407,114,9878,9992
2022/02/07,17:30:00,466.17,99,10589,10688
2022/02/07,18:00:00,478.44,100,11211,11311
2022/02/07,18:30:00,486.03,101,11487,11588
2022/02/07,19:00:00,478.44,100,11585,11685
2022/02/07,19:30:00,478.44,99,11655,11754
2022/02/07,20:00:00,466.11,98,11627,11725
2022/02/07,20:30:00,478.44,97,11468,11565
2022/02/07,21:00:00,407,95,11275,11370
2022/02/07,21:30:00,407,54,11025,11079
2022/02/07,22:00:00,407,13,10550,10563
2022/02/07,22:30:00,270.38,1,10257,10258
2022/02/07,23:00:00,269.8,1,9642,9643
2022/02/07,23:30:00,269.8,1,8999,9000
2022/02/08,00:00:00,269.8,1,8396,8397
2022/02/08,00:30:00,270.38,1,7852,7853
2022/02/08,01:00:00,269.8,5,7401,7406
2022/02/08,01:30:00,269.23,3,7102,7105
2022/02/08,02:00:00,270.09,1,6990,6991
2022/02/08,02:30:00,269.51,2,6897,6899
2022/02/08,03:00:00,270.09,1,6824,6825
2022/02/08,03:30:00,269.51,2,6731,6733
2022/02/08,04:00:00,269.8,2,6782,6784
2022/02/08,04:30:00,269.8,2,6967,6969
2022/02/08,05:00:00,269.23,2,7256,7258
2022/02/08,05:30:00,270.38,4,7650,7654
2022/02/08,06:00:00,272.56,4,7979,7983
2022/02/08,06:30:00,272.88,5,8478,8483
2022/02/08,07:00:00,273.22,23,8835,8858
2022/02/08,07:30:00,270.38,440,8921,9361
2022/02/08,08:00:00,269.8,880,8397,9277
2022/02/08,08:30:00,269.8,1366,8097,9463
2022/02/08,09:00:00,269.51,1772,7738,9510
2022/02/08,09:30:00,269.8,1993,7380,9373
2022/02/08,10:00:00,269.8,2121,7104,9225
2022/02/08,10:30:00,269.51,2251,6821,9072
2022/02/08,11:00:00,269.8,2340,6627,8967
2022/02/08,11:30:00,269.51,2360,6520,8880
2022/02/08,12:00:00,270.38,2385,6346,8731
2022/02/08,12:30:00,269.51,2379,6293,8672
2022/02/08,13:00:00,269.8,2354,6305,8659
2022/02/08,13:30:00,269.23,2277,6368,8645
2022/02/08,14:00:00,269.51,2165,6478,8643
2022/02/08,14:30:00,269.51,2037,6650,8687
2022/02/08,15:00:00,269.23,1824,6932,8756
2022/02/08,15:30:00,269.51,1554,7285,8839
2022/02/08,16:00:00,269.51,1194,7657,8851
2022/02/08,16:30:00,269.23,777,8162,8939
2022/02/08,17:00:00,406.83,370,8846,9216
2022/02/08,17:30:00,452.55,107,9686,9793
2022/02/08,18:00:00,413.93,107,10372,10479
2022/02/08,18:30:00,413.91,107,10761,10868
2022/02/08,19:00:00,411.44,108,10950,11058
2022/02/08,19:30:00,409.03,108,11030,11138
2022/02/08,20:00:00,406.83,108,11039,11147
2022/02/08,20:30:00,390.31,108,10910,11018
2022/02/08,21:00:00,390.31,108,10730,10838
2022/02/08,21:30:00,385.95,108,10448,10556
2022/02/08,22:00:00,269.8,107,10049,10156
2022/02/08,22:30:00,377.64,35,9732,9767
2022/02/08,23:00:00,272.88,0,9246,9246
2022/02/08,23:30:00,267.1,0,8698,8698
2022/02/09,00:00:00,269.51,0,8160,8160
2022/02/09,00:30:00,268.69,0,7680,7680
2022/02/09,01:00:00,268.69,0,7419,7419
2022/02/09,01:30:00,268.41,0,7043,7043
2022/02/09,02:00:00,268.41,0,6887,6887
2022/02/09,02:30:00,268.99,0,6745,6745
2022/02/09,03:00:00,268.41,0,6699,6699
2022/02/09,03:30:00,268.69,0,6626,6626
2022/02/09,04:00:00,268.69,1,6685,6686
2022/02/09,04:30:00,268.69,1,6850,6851
2022/02/09,05:00:00,268.99,0,7081,7081
2022/02/09,05:30:00,268.99,0,7485,7485
2022/02/09,06:00:00,268.41,0,7736,7736
2022/02/09,06:30:00,268.99,0,8117,8117
2022/02/09,07:00:00,268.69,18,8559,8577
2022/02/09,07:30:00,268.69,409,8612,9021
2022/02/09,08:00:00,268.69,882,8074,8956
2022/02/09,08:30:00,268.41,1319,7768,9087
2022/02/09,09:00:00,268.12,1688,7372,9060
2022/02/09,09:30:00,268.41,1899,7118,9017
2022/02/09,10:00:00,268.41,2085,6847,8932
2022/02/09,10:30:00,268.69,2200,6664,8864
2022/02/09,11:00:00,268.41,2306,6521,8827
2022/02/09,11:30:00,268.41,2327,6466,8793
2022/02/09,12:00:00,268.99,2295,6642,8937
2022/02/09,12:30:00,268.12,2148,6894,9042
2022/02/09,13:00:00,268.12,2008,7154,9162
2022/02/09,13:30:00,267.85,1755,7668,9423
2022/02/09,14:00:00,265.6,1487,8190,9677
2022/02/09,14:30:00,264.91,1286,8624,9910
2022/02/09,15:00:00,265.84,1152,9006,10158
2022/02/09,15:30:00,270.09,985,9277,10262
2022/02/09,16:00:00,270.68,873,9407,10280
2022/02/09,16:30:00,390.33,601,9926,10527
2022/02/09,17:00:00,390.33,499,10504,11003
2022/02/09,17:30:00,475.88,214,11186,11400
2022/02/09,18:00:00,475.88,217,11682,11899
2022/02/09,18:30:00,479.03,211,11884,12095
2022/02/09,19:00:00,472.88,199,11992,12191
2022/02/09,19:30:00,472.88,214,11974,12188
2022/02/09,20:00:00,486.37,184,11874,12058
2022/02/09,20:30:00,348.55,159,11702,11861
2022/02/09,21:00:00,403.8,155,11404,11559
2022/02/09,21:30:00,347.03,74,11145,11219
2022/02/09,22:00:00,390.33,66,10731,10797
2022/02/09,22:30:00,383.04,72,10277,10349
2022/02/09,23:00:00,267.85,53,9754,9807
2022/02/09,23:30:00,279.16,81,9036,9117
2022/02/10,00:00:00,270.09,74,8452,8526
2022/02/10,00:30:00,270.38,73,7881,7954
2022/02/10,01:00:00,268.12,63,7503,7566
2022/02/10,01:30:00,270.38,87,7300,7387
2022/02/10,02:00:00,267.85,100,7071,7171
2022/02/10,02:30:00,267.85,85,7065,7150
2022/02/10,03:00:00,270.38,99,6974,7073
2022/02/10,03:30:00,270.38,101,6944,7045
2022/02/10,04:00:00,267.85,79,7001,7080
2022/02/10,04:30:00,270.38,81,7155,7236
2022/02/10,05:00:00,270.09,87,7391,7478
2022/02/10,05:30:00,267.57,90,7836,7926
2022/02/10,06:00:00,267.3,69,8002,8071
2022/02/10,06:30:00,270.38,56,8471,8527
2022/02/10,07:00:00,270.38,59,9144,9203
2022/02/10,07:30:00,269.8,277,9731,10008
2022/02/10,08:00:00,270.38,519,9735,10254
2022/02/10,08:30:00,262.4,773,9897,10670
2022/02/10,09:00:00,270.09,746,10071,10817
2022/02/10,09:30:00,270.38,800,10044,10844
2022/02/10,10:00:00,262.34,676,10183,10859
2022/02/10,10:30:00,270.09,891,10160,11051
2022/02/10,11:00:00,270.98,854,10280,11134
2022/02/10,11:30:00,270.68,1019,10085,11104
2022/02/10,12:00:00,270.38,898,10093,10991
2022/02/10,12:30:00,270.98,894,10045,10939
2022/02/10,13:00:00,270.68,1013,10053,11066
2022/02/10,13:30:00,270.98,971,10124,11095
2022/02/10,14:00:00,270.09,933,10177,11110
2022/02/10,14:30:00,329.95,849,10279,11128
2022/02/10,15:00:00,469.59,773,10366,11139
2022/02/10,15:30:00,486.25,510,10501,11011
2022/02/10,16:00:00,486.25,317,10762,11079
2022/02/10,16:30:00,478.79,223,11059,11282
2022/02/10,17:00:00,463.63,18,11533,11551
2022/02/10,17:30:00,406.53,16,12174,12190
2022/02/10,18:00:00,406.53,10,12561,12571
2022/02/10,18:30:00,400.81,12,12730,12742
2022/02/10,19:00:00,406.53,19,12703,12722
2022/02/10,19:30:00,406.53,12,12645,12657
2022/02/10,20:00:00,440.41,6,12475,12481
2022/02/10,20:30:00,406.53,4,12240,12244
2022/02/10,21:00:00,406.53,12,11917,11929
2022/02/10,21:30:00,390.18,12,11492,11504
2022/02/10,22:00:00,386.92,10,11027,11037
2022/02/10,22:30:00,269.51,83,10619,10702
2022/02/10,23:00:00,269.8,89,10079,10168
2022/02/10,23:30:00,269.8,48,9493,9541
2022/02/11,00:00:00,269.8,27,8913,8940
2022/02/11,00:30:00,268.95,30,8370,8400
2022/02/11,01:00:00,269.51,77,7834,7911
2022/02/11,01:30:00,269.8,63,7521,7584
2022/02/11,02:00:00,269.8,58,7356,7414
2022/02/11,02:30:00,269.8,71,7273,7344
2022/02/11,03:00:00,270.09,53,7157,7210
2022/02/11,03:30:00,270.09,41,7089,7130
2022/02/11,04:00:00,270.09,12,7082,7094
2022/02/11,04:30:00,269.23,1,7231,7232
2022/02/11,05:00:00,268.12,5,7410,7415
2022/02/11,05:30:00,269.23,29,7647,7676
2022/02/11,06:00:00,269.51,21,7749,7770
2022/02/11,06:30:00,269.23,16,7913,7929
2022/02/11,07:00:00,270.09,14,8365,8379
2022/02/11,07:30:00,269.8,55,8646,8701
2022/02/11,08:00:00,270.38,374,8514,8888
2022/02/11,08:30:00,269.23,469,8433,8902
2022/02/11,09:00:00,268.41,705,8235,8940
2022/02/11,09:30:00,268.67,936,8071,9007
2022/02/11,10:00:00,268.41,1164,7912,9076
2022/02/11,10:30:00,268.69,1460,7794,9254
2022/02/11,11:00:00,268.41,1737,7810,9547
2022/02/11,11:30:00,268.69,1776,8050,9826
2022/02/11,12:00:00,268.67,1601,8027,9628
2022/02/11,12:30:00,268.99,1649,8129,9778
2022/02/11,13:00:00,268.69,1669,8013,9682
2022/02/11,13:30:00,268.41,1672,8062,9734
2022/02/11,14:00:00,268.99,1660,8017,9677
2022/02/11,14:30:00,268.67,1750,7904,9654
2022/02/11,15:00:00,268.41,1543,8186,9729
2022/02/11,15:30:00,269.51,1273,8602,9875
2022/02/11,16:00:00,406.52,1003,8841,9844
2022/02/11,16:30:00,406.52,537,9514,10051
2022/02/11,17:00:00,400.8,265,9996,10261
2022/02/11,17:30:00,406.52,34,10444,10478
2022/02/11,18:00:00,406.52,37,10794,10831
2022/02/11,18:30:00,406.52,37,10789,10826
2022/02/11,19:00:00,403.11,32,10598,10630
2022/02/11,19:30:00,405.52,28,10384,10412
2022/02/11,20:00:00,400.77,0,10243,10243
2022/02/11,20:30:00,403.11,0,10127,10127
2022/02/11,21:00:00,384.55,0,9977,9977
2022/02/11,21:30:00,384.48,0,9825,9825
2022/02/11,22:00:00,390.17,0,9604,9604
2022/02/11,22:30:00,268.69,0,9295,9295
2022/02/11,23:00:00,268.13,0,8975,8975
2022/02/11,23:30:00,268.95,0,8538,8538
2022/02/12,00:00:00,268.95,0,8130,8130
2022/02/12,00:30:00,268.69,0,7721,7721
2022/02/12,01:00:00,270.38,0,7334,7334
2022/02/12,01:30:00,270.38,0,7083,7083
2022/02/12,02:00:00,270.38,0,7027,7027
2022/02/12,02:30:00,268.41,0,6888,6888
2022/02/12,03:00:00,268.69,0,6913,6913
2022/02/12,03:30:00,268.69,0,6846,6846
2022/02/12,04:00:00,268.41,0,6826,6826
2022/02/12,04:30:00,268.41,0,6903,6903
2022/02/12,05:00:00,268.12,0,7033,7033
2022/02/12,05:30:00,270.38,0,7170,7170
2022/02/12,06:00:00,270.09,0,7309,7309
2022/02/12,06:30:00,268.99,0,7028,7028
2022/02/12,07:00:00,270.38,24,7055,7079
2022/02/12,07:30:00,268.41,440,7009,7449
2022/02/12,08:00:00,268.99,891,6851,7742
2022/02/12,08:30:00,268.69,1389,6604,7993
2022/02/12,09:00:00,268.69,1739,6443,8182
2022/02/12,09:30:00,268.69,2000,6167,8167
2022/02/12,10:00:00,268.69,2148,6031,8179
2022/02/12,10:30:00,268.41,2277,5853,8130
2022/02/12,11:00:00,268.69,2325,5771,8096
2022/02/12,11:30:00,268.69,2383,5589,7972
2022/02/12,12:00:00,268.69,2410,5516,7926
2022/02/12,12:30:00,268.12,2380,5443,7823
2022/02/12,13:00:00,268.69,2327,5250,7577
2022/02/12,13:30:00,268.99,2210,5209,7419
2022/02/12,14:00:00,268.69,2116,5186,7302
2022/02/12,14:30:00,268.41,2067,5340,7407
2022/02/12,15:00:00,268.69,1857,5597,7454
2022/02/12,15:30:00,268.41,1616,6109,7725
2022/02/12,16:00:00,268.41,1273,6710,7983
2022/02/12,16:30:00,268.41,803,7391,8194
2022/02/12,17:00:00,403.35,403,8224,8627
2022/02/12,17:30:00,403.35,107,9044,9151
2022/02/12,18:00:00,398.72,108,9815,9923
2022/02/12,18:30:00,403.35,107,10348,10455
2022/02/12,19:00:00,403.35,107,10561,10668
2022/02/12,19:30:00,403.35,107,10670,10777
2022/02/12,20:00:00,398.72,107,10672,10779
2022/02/12,20:30:00,398.72,107,10606,10713
2022/02/12,21:00:00,403.35,106,10477,10583
2022/02/12,21:30:00,403.35,76,10349,10425
2022/02/12,22:00:00,381.67,0,10120,10120
2022/02/12,22:30:00,385.34,1,9744,9745
2022/02/12,23:00:00,270.09,1,9269,9270
2022/02/12,23:30:00,269.8,1,8680,8681
2022/02/13,00:00:00,269.8,1,8150,8151
2022/02/13,00:30:00,270.38,1,7642,7643
2022/02/13,01:00:00,269.8,1,7357,7358
2022/02/13,01:30:00,269.51,1,7142,7143
2022/02/13,02:00:00,269.8,1,6947,6948
2022/02/13,02:30:00,270.09,1,6782,6783
2022/02/13,03:00:00,269.8,0,6670,6670
2022/02/13,03:30:00,270.09,0,6624,6624
2022/02/13,04:00:00,269.8,0,6693,6693
2022/02/13,04:30:00,269.8,0,6831,6831
2022/02/13,05:00:00,269.8,0,7101,7101
2022/02/13,05:30:00,270.09,0,7452,7452
2022/02/13,06:00:00,269.8,0,7868,7868
2022/02/13,06:30:00,269.8,0,8405,8405
2022/02/13,07:00:00,269.8,29,8639,8668
2022/02/13,07:30:00,270.09,536,8526,9062
2022/02/13,08:00:00,269.8,998,7937,8935
2022/02/13,08:30:00,269.8,1484,7550,9034
2022/02/13,09:00:00,269.8,1846,7223,9069
2022/02/13,09:30:00,269.51,2063,6930,8993
2022/02/13,10:00:00,270.09,2200,6672,8872
2022/02/13,10:30:00,268.67,2295,6596,8891
2022/02/13,11:00:00,270.09,2353,6458,8811
2022/02/13,11:30:00,269.51,2419,6332,8751
2022/02/13,12:00:00,269.51,2409,6199,8608
2022/02/13,12:30:00,268.69,2390,6186,8576
2022/02/13,13:00:00,268.69,2357,6195,8552
2022/02/13,13:30:00,268.95,2279,6244,8523
2022/02/13,14:00:00,268.4,2204,6359,8563
2022/02/13,14:30:00,268.99,2084,6425,8509
2022/02/13,15:00:00,269.28,1870,6648,8518
2022/02/13,15:30:00,268.69,1606,7016,8622
2022/02/13,16:00:00,268.41,1228,7471,8699
2022/02/13,16:30:00,268.41,801,8102,8903
2022/02/13,17:00:00,384.51,407,8852,9259
2022/02/13,17:30:00,372.53,107,9714,9821
2022/02/13,18:00:00,403.53,114,10476,10590
2022/02/13,18:30:00,403.54,118,10858,10976
2022/02/13,19:00:00,401.19,115,11055,11170
2022/02/13,19:30:00,398.91,116,11138,11254
2022/02/13,20:00:00,398.91,117,11128,11245
2022/02/13,20:30:00,401.19,117,10994,11111
2022/02/13,21:00:00,403.54,115,10792,10907
2022/02/13,21:30:00,390.27,115,10525,10640
2022/02/13,22:00:00,385.44,78,10062,10140
2022/02/13,22:30:00,381.67,51,9743,9794
2022/02/13,23:00:00,268.69,18,9246,9264
2022/02/13,23:30:00,268.69,20,8632,8652
2022/02/14,00:00:00,268.13,32,8065,8097
2022/02/14,00:30:00,268.41,36,7822,7858
2022/02/14,01:00:00,268.95,43,7396,7439
2022/02/14,01:30:00,268.95,48,7074,7122
2022/02/14,02:00:00,268.69,54,6901,6955
2022/02/14,02:30:00,269.23,76,6685,6761
2022/02/14,03:00:00,268.41,77,6620,6697
2022/02/14,03:30:00,268.95,67,6588,6655
2022/02/14,04:00:00,268.95,79,6653,6732
2022/02/14,04:30:00,268.95,87,6750,6837
2022/02/14,05:00:00,268.69,86,7066,7152
2022/02/14,05:30:00,268.69,84,7241,7325
2022/02/14,06:00:00,269.51,80,7530,7610
2022/02/14,06:30:00,269.8,48,8023,8071
2022/02/14,07:00:00,269.51,58,8678,8736
2022/02/14,07:30:00,268.69,258,9003,9261
2022/02/14,08:00:00,268.67,479,8677,9156
2022/02/14,08:30:00,268.13,615,8508,9123
2022/02/14,09:00:00,268.4,870,8208,9078
2022/02/14,09:30:00,268.4,1198,7854,9052
2022/02/14,10:00:00,268.95,1380,7699,9079
2022/02/14,10:30:00,268.67,1492,7779,9271
2022/02/14,11:00:00,267.87,1437,7817,9254
2022/02/14,11:30:00,268.67,1477,7879,9356
2022/02/14,12:00:00,268.67,1659,7652,9311
2022/02/14,12:30:00,269.23,1605,7589,9194
2022/02/14,13:00:00,269.51,1615,7628,9243
2022/02/14,13:30:00,496.99,1527,7727,9254
2022/02/14,14:00:00,496.99,1445,7712,9157
2022/02/14,14:30:00,496.91,1433,7697,9130
2022/02/14,15:00:00,496.84,1584,7745,9329
2022/02/14,15:30:00,338.77,1388,7907,9295
2022/02/14,16:00:00,388.88,1009,8305,9314
2022/02/14,16:30:00,388.88,782,8774,9556
2022/02/14,17:00:00,388.88,407,9450,9857
2022/02/14,17:30:00,383.02,161,10143,10304
2022/02/14,18:00:00,404.12,153,10771,10924
2022/02/14,18:30:00,398.43,155,11134,11289
2022/02/14,19:00:00,398.43,155,11231,11386
2022/02/14,19:30:00,384.61,93,11282,11375
2022/02/14,20:00:00,404.12,62,11260,11322
2022/02/14,20:30:00,404.12,57,11103,11160
2022/02/14,21:00:00,383.36,57,10839,10896
2022/02/14,21:30:00,326.4,51,10487,10538
2022/02/14,22:00:00,383.3,44,10027,10071
2022/02/14,22:30:00,268.12,22,9705,9727
2022/02/14,23:00:00,268.41,12,9119,9131
2022/02/14,23:30:00,268.12,14,8579,8593
2022/02/15,00:00:00,267.85,6,8061,8067
2022/02/15,00:30:00,268.12,18,7576,7594
2022/02/15,01:00:00,270.09,29,7150,7179
2022/02/15,01:30:00,268.99,38,7159,7197
2022/02/15,02:00:00,268.67,25,6962,6987
2022/02/15,02:30:00,268.13,18,6784,6802
2022/02/15,03:00:00,268.4,10,6768,6778
2022/02/15,03:30:00,268.13,18,6723,6741
2022/02/15,04:00:00,267.61,21,6763,6784
2022/02/15,04:30:00,268.67,27,6842,6869
2022/02/15,05:00:00,267.87,21,7027,7048
2022/02/15,05:30:00,268.67,31,7163,7194
2022/02/15,06:00:00,267.61,14,7540,7554
2022/02/15,06:30:00,269.51,12,8025,8037
2022/02/15,07:00:00,268.13,142,8526,8668
2022/02/15,07:30:00,267.87,355,8663,9018
2022/02/15,08:00:00,268.67,671,8328,8999
2022/02/15,08:30:00,268.67,1143,7906,9049
2022/02/15,09:00:00,267.61,1618,7663,9281
2022/02/15,09:30:00,267.61,1657,7396,9053
2022/02/15,10:00:00,267.61,1885,7215,9100
2022/02/15,10:30:00,267.61,1924,7226,9150
2022/02/15,11:00:00,267.87,1901,7212,9113
2022/02/15,11:30:00,267.61,1889,7137,9026
2022/02/15,12:00:00,267.87,1810,7116,8926
2022/02/15,12:30:00,267.61,1931,7072,9003
2022/02/15,13:00:00,267.61,1859,7224,9083
2022/02/15,13:30:00,267.61,1797,7281,9078
2022/02/15,14:00:00,267.1,1840,7298,9138
2022/02/15,14:30:00,267.87,1622,7351,8973
2022/02/15,15:00:00,267.87,1434,7518,8952
2022/02/15,15:30:00,267.87,1281,7806,9087
2022/02/15,16:00:00,268.95,1008,8202,9210
2022/02/15,16:30:00,267.61,675,8785,9460
2022/02/15,17:00:00,267.87,316,9420,9736
2022/02/15,17:30:00,398.32,27,10220,10247
2022/02/15,18:00:00,398.32,22,10787,10809
2022/02/15,18:30:00,396.3,26,11066,11092
2022/02/15,19:00:00,404.03,22,11132,11154
2022/02/15,19:30:00,396.3,21,11155,11176
2022/02/15,20:00:00,398.32,25,11099,11124
2022/02/15,20:30:00,396.27,24,10935,10959
2022/02/15,21:00:00,377.95,20,10710,10730
2022/02/15,21:30:00,385.61,17,10370,10387
2022/02/15,22:00:00,270.09,18,9968,9986
2022/02/15,22:30:00,269.8,13,9624,9637
2022/02/15,23:00:00,270.09,13,9085,9098
2022/02/15,23:30:00,270.09,19,8468,8487
2022/02/16,00:00:00,270.09,15,7992,8007
2022/02/16,00:30:00,269.51,20,7473,7493
2022/02/16,01:00:00,269.51,29,7050,7079
2022/02/16,01:30:00,270.38,25,7050,7075
2022/02/16,02:00:00,269.51,24,6863,6887
2022/02/16,02:30:00,269.8,20,6710,6730
2022/02/16,03:00:00,269.8,25,6639,6664
2022/02/16,03:30:00,269.23,27,6608,6635
2022/02/16,04:00:00,270.09,34,6638,6672
2022/02/16,04:30:00,270.09,34,6802,6836
2022/02/16,05:00:00,269.51,24,7047,7071
2022/02/16,05:30:00,269.23,19,7240,7259
2022/02/16,06:00:00,270.09,13,7506,7519
2022/02/16,06:30:00,269.8,10,7963,7973
2022/02/16,07:00:00,269.8,250,8518,8768
2022/02/16,07:30:00,269.8,271,8621,8892
2022/02/16,08:00:00,268.67,591,8132,8723
2022/02/16,08:30:00,269.8,896,7807,8703
2022/02/16,09:00:00,269.8,1274,7341,8615
2022/02/16,09:30:00,269.8,1746,7083,8829
2022/02/16,10:00:00,269.8,1932,7046,8978
2022/02/16,10:30:00,269.8,2097,6942,9039
2022/02/16,11:00:00,269.8,2006,6905,8911
2022/02/16,11:30:00,269.23,1983,6846,8829
2022/02/16,12:00:00,270.09,2203,6672,8875
2022/02/16,12:30:00,269.8,1995,6810,8805
2022/02/16,13:00:00,269.51,1999,6853,8852
2022/02/16,13:30:00,270.09,1998,6878,8876
2022/02/16,14:00:00,269.8,1933,6967,8900
2022/02/16,14:30:00,269.51,1784,7128,8912
2022/02/16,15:00:00,269.8,1687,7328,9015
2022/02/16,15:30:00,269.8,1474,7680,9154
2022/02/16,16:00:00,269.8,1138,7919,9057
2022/02/16,16:30:00,269.8,695,8364,9059
2022/02/16,17:00:00,385.59,590,8986,9576
2022/02/16,17:30:00,390.43,130,9784,9914
2022/02/16,18:00:00,396.22,134,10447,10581
2022/02/16,18:30:00,403.28,131,10769,10900
2022/02/16,19:00:00,406.96,130,10861,10991
2022/02/16,19:30:00,406.96,127,10929,11056
2022/02/16,20:00:00,406.96,119,10921,11040
2022/02/16,20:30:00,398.3,108,10777,10885
2022/02/16,21:00:00,384.73,8,10657,10665
2022/02/16,21:30:00,390.43,8,10359,10367
2022/02/16,22:00:00,269.23,14,9945,9959
2022/02/16,22:30:00,269.8,6,9534,9540
2022/02/16,23:00:00,381.44,2,9071,9073
2022/02/16,23:30:00,268.4,0,8482,8482
2022/02/17,00:00:00,268.67,0,7961,7961
2022/02/17,00:30:00,270.09,0,7473,7473
2022/02/17,01:00:00,268.41,0,7047,7047
2022/02/17,01:30:00,268.67,0,6790,6790
2022/02/17,02:00:00,269.51,0,6733,6733
2022/02/17,02:30:00,268.67,0,6750,6750
2022/02/17,03:00:00,268.95,4,6664,6669
2022/02/17,03:30:00,268.69,1,6663,6664
2022/02/17,04:00:00,268.99,1,6714,6715
2022/02/17,04:30:00,268.41,0,6862,6862
2022/02/17,05:00:00,268.41,1,6970,6971
2022/02/17,05:30:00,268.69,7,7186,7193
2022/02/17,06:00:00,396.31,19,7560,7579
2022/02/17,06:30:00,403.76,30,8000,8030
2022/02/17,07:00:00,268.69,45,8527,8572
2022/02/17,07:30:00,268.95,350,8671,9021
2022/02/17,08:00:00,268.69,625,8326,8950
2022/02/17,08:30:00,269.51,807,8129,8936
2022/02/17,09:00:00,268.95,1144,7768,8913
2022/02/17,09:30:00,269.23,1533,7335,8868
2022/02/17,10:00:00,269.8,1737,7024,8762
2022/02/17,10:30:00,269.23,1803,6884,8687
2022/02/17,11:00:00,268.69,1687,7122,8809
2022/02/17,11:30:00,268.99,1668,7093,8761
2022/02/17,12:00:00,268.69,1781,7025,8806
2022/02/17,12:30:00,268.41,1784,7013,8796
2022/02/17,13:00:00,268.41,1594,7006,8601
2022/02/17,13:30:00,268.12,1374,7324,8698
2022/02/17,14:00:00,268.69,1144,7477,8621
2022/02/17,14:30:00,268.69,984,7820,8805
2022/02/17,15:00:00,268.69,842,8150,8992
2022/02/17,15:30:00,268.69,585,8529,9114
2022/02/17,16:00:00,268.69,457,8769,9226
2022/02/17,16:30:00,274.58,361,9172,9533
2022/02/17,17:00:00,403.33,597,9777,10374
2022/02/17,17:30:00,407.01,1,10455,10457
2022/02/17,18:00:00,403.76,1,10876,10877
2022/02/17,18:30:00,403.76,0,11075,11075
2022/02/17,19:00:00,403.76,0,11064,11064
2022/02/17,19:30:00,407.01,0,10999,10999
2022/02/17,20:00:00,407.01,0,10919,10919
2022/02/17,20:30:00,407.01,0,10728,10728
2022/02/17,21:00:00,407.01,0,10468,10468
2022/02/17,21:30:00,403.33,0,10145,10145
2022/02/17,22:00:00,388.43,0,9751,9751
2022/02/17,22:30:00,388.43,0,9417,9417
2022/02/17,23:00:00,269.51,0,8995,8995
2022/02/17,23:30:00,270.09,0,8508,8508
2022/02/18,00:00:00,269.51,0,8020,8020
2022/02/18,00:30:00,268.12,0,7589,7589
2022/02/18,01:00:00,270.09,0,7213,7213
2022/02/18,01:30:00,269.51,0,6888,6888
2022/02/18,02:00:00,269.8,0,6936,6936
2022/02/18,02:30:00,269.23,0,6772,6772
2022/02/18,03:00:00,269.23,0,6646,6646
2022/02/18,03:30:00,269.23,0,6602,6602
2022/02/18,04:00:00,269.23,0,6607,6607
2022/02/18,04:30:00,269.51,0,6704,6704
2022/02/18,05:00:00,268.12,0,6866,6866
2022/02/18,05:30:00,268.12,0,6994,6994
2022/02/18,06:00:00,268.12,0,7164,7164
2022/02/18,06:30:00,268.12,0,7234,7234
2022/02/18,07:00:00,268.12,102,7359,7461
2022/02/18,07:30:00,268.12,302,7571,7873
2022/02/18,08:00:00,268.41,692,7354,8046
2022/02/18,08:30:00,267.85,1192,7038,8230
2022/02/18,09:00:00,268.12,1491,6747,8238
2022/02/18,09:30:00,268.41,1734,6524,8258
2022/02/18,10:00:00,268.12,2031,6266,8297
2022/02/18,10:30:00,265.13,2173,6106,8279
2022/02/18,11:00:00,270.38,2231,5977,8208
2022/02/18,11:30:00,267.03,2264,5919,8183
2022/02/18,12:00:00,267.57,2272,5846,8118
2022/02/18,12:30:00,268.12,2299,5766,8065
2022/02/18,13:00:00,270.09,2214,5769,7983
2022/02/18,13:30:00,267.57,2182,5825,8007
2022/02/18,14:00:00,270.38,2032,6013,8045
2022/02/18,14:30:00,270.09,1709,6184,7893
2022/02/18,15:00:00,268.41,1505,6488,7993
2022/02/18,15:30:00,267.57,1309,6808,8117
2022/02/18,16:00:00,267.3,903,7440,8343
2022/02/18,16:30:00,270.38,525,8116,8641
2022/02/18,17:00:00,267.3,303,8773,9076
2022/02/18,17:30:00,390.53,12,9239,9251
2022/02/18,18:00:00,383.83,14,9675,9689
2022/02/18,18:30:00,386.27,11,9780,9791
2022/02/18,19:00:00,379.78,8,9594,9602
2022/02/18,19:30:00,385.69,7,9449,9456
2022/02/18,20:00:00,390.53,2,9233,9235
2022/02/18,20:30:00,390.53,1,9019,9020
2022/02/18,21:00:00,383.51,0,8892,8892
2022/02/18,21:30:00,386.58,15,8714,8729
2022/02/18,22:00:00,267.3,37,8543,8580
2022/02/18,22:30:00,267.57,38,8280,8318
2022/02/18,23:00:00,267.3,43,7935,7978
2022/02/18,23:30:00,267.3,36,7648,7684
2022/02/19,00:00:00,270.38,35,7203,7238
2022/02/19,00:30:00,270.38,43,6896,6939
2022/02/19,01:00:00,268.99,34,6623,6657
2022/02/19,01:30:00,267.57,36,6388,6424
2022/02/19,02:00:00,267.03,38,6373,6411
2022/02/19,02:30:00,267.85,35,6401,6436
2022/02/19,03:00:00,266.51,43,6308,6351
2022/02/19,03:30:00,267.57,41,6263,6304
2022/02/19,04:00:00,270.38,42,6247,6289
2022/02/19,04:30:00,266.08,30,6311,6341
2022/02/19,05:00:00,267.3,31,6408,6439
2022/02/19,05:30:00,267.57,34,6551,6585
2022/02/19,06:00:00,267.57,12,6500,6512
2022/02/19,06:30:00,270.38,23,6330,6353
2022/02/19,07:00:00,267.3,12,6391,6403
2022/02/19,07:30:00,270.38,205,6469,6674
2022/02/19,08:00:00,267.03,400,6473,6873
2022/02/19,08:30:00,270.09,426,6683,7109
2022/02/19,09:00:00,270.38,466,6832,7298
2022/02/19,09:30:00,266.51,430,7089,7519
2022/02/19,10:00:00,266.51,438,7214,7652
2022/02/19,10:30:00,267.03,493,7273,7766
2022/02/19,11:00:00,266.77,549,7336,7885
2022/02/19,11:30:00,270.38,484,7383,7867
2022/02/19,12:00:00,267.3,448,7457,7905
2022/02/19,12:30:00,266.77,515,7593,8108
2022/02/19,13:00:00,268.12,591,7652,8243
2022/02/19,13:30:00,268.69,830,7770,8600
2022/02/19,14:00:00,270.38,1109,7824,8933
2022/02/19,14:30:00,270.38,1100,7924,9024
2022/02/19,15:00:00,267.3,1045,7940,8985
2022/02/19,15:30:00,267.57,959,8005,8964
2022/02/19,16:00:00,266.51,686,8251,8937
2022/02/19,16:30:00,267.85,493,8534,9027
2022/02/19,17:00:00,267.03,359,8922,9281
2022/02/19,17:30:00,384.68,48,9438,9486
2022/02/19,18:00:00,385.56,47,9858,9905
2022/02/19,18:30:00,385.56,21,10395,10416
2022/02/19,19:00:00,378.46,8,10635,10643
2022/02/19,19:30:00,382.62,8,10681,10689
2022/02/19,20:00:00,387.41,9,10610,10619
2022/02/19,20:30:00,385.56,17,10482,10499
2022/02/19,21:00:00,390.4,15,10314,10329
2022/02/19,21:30:00,390.4,11,10107,10118
2022/02/19,22:00:00,377.73,27,9687,9714
2022/02/19,22:30:00,386.36,24,9336,9360
2022/02/19,23:00:00,369.61,16,8879,8895
2022/02/19,23:30:00,270.09,7,8357,8364
2022/02/20,00:00:00,270.09,5,7836,7841
2022/02/20,00:30:00,269.8,6,7360,7366
2022/02/20,01:00:00,269.23,17,6947,6964
2022/02/20,01:30:00,268.95,24,6642,6666
2022/02/20,02:00:00,269.8,23,6644,6667
2022/02/20,02:30:00,268.95,30,6499,6529
2022/02/20,03:00:00,268.4,34,6424,6458
2022/02/20,03:30:00,268.67,33,6332,6365
2022/02/20,04:00:00,268.67,50,6431,6481
2022/02/20,04:30:00,268.41,49,6571,6620
2022/02/20,05:00:00,268.67,44,6836,6880
2022/02/20,05:30:00,269.23,42,7066,7108
2022/02/20,06:00:00,382.62,44,7410,7454
2022/02/20,06:30:00,317,35,7764,7799
2022/02/20,07:00:00,317,39,8457,8496
2022/02/20,07:30:00,358.34,352,8681,9033
2022/02/20,08:00:00,317.3,621,8335,8956
2022/02/20,08:30:00,318.25,912,8272,9184
2022/02/20,09:00:00,372.1,948,8221,9169
2022/02/20,09:30:00,370.55,1057,8088,9145
2022/02/20,10:00:00,379.01,1155,7976,9131
2022/02/20,10:30:00,380.74,1283,8081,9364
2022/02/20,11:00:00,379,1412,7872,9284
2022/02/20,11:30:00,268.95,1506,7693,9199
2022/02/20,12:00:00,269.51,1538,7581,9119
2022/02/20,12:30:00,270.09,1606,7513,9119
2022/02/20,13:00:00,270.09,1578,7596,9174
2022/02/20,13:30:00,269.8,1508,7747,9255
2022/02/20,14:00:00,268.67,1499,7788,9287
2022/02/20,14:30:00,268.69,1298,7893,9191
2022/02/20,15:00:00,268.95,1240,8013,9253
2022/02/20,15:30:00,268.4,1002,8095,9097
2022/02/20,16:00:00,268.95,826,8347,9173
2022/02/20,16:30:00,268.13,602,8672,9274
2022/02/20,17:00:00,353.94,385,9190,9575
2022/02/20,17:30:00,390.38,87,9838,9925
2022/02/20,18:00:00,370.56,71,10569,10640
2022/02/20,18:30:00,390.38,64,10954,11018
2022/02/20,19:00:00,382.52,56,11025,11081
2022/02/20,19:30:00,352.45,65,11078,11143
2022/02/20,20:00:00,347.74,62,11007,11069
2022/02/20,20:30:00,390.38,36,10873,10909
2022/02/20,21:00:00,381.9,35,10612,10647
2022/02/20,21:30:00,374.85,44,10284,10328
2022/02/20,22:00:00,372.51,49,9793,9842
2022/02/20,22:30:00,268.4,53,9498,9551
2022/02/20,23:00:00,269.51,46,8895,8941
2022/02/20,23:30:00,269.23,61,8342,8403
2022/02/21,00:00:00,268.67,71,7740,7811
2022/02/21,00:30:00,268.95,90,7278,7368
2022/02/21,01:00:00,269.8,110,6898,7008
2022/02/21,01:30:00,269.8,109,6925,7034
2022/02/21,02:00:00,269.8,93,6741,6834
2022/02/21,02:30:00,269.8,99,6572,6671
2022/02/21,03:00:00,269.23,111,6519,6630
2022/02/21,03:30:00,269.51,102,6520,6622
2022/02/21,04:00:00,269.23,100,6569,6669
2022/02/21,04:30:00,268.95,96,6687,6783
2022/02/21,05:00:00,269.51,101,6933,7034
2022/02/21,05:30:00,269.51,94,7202,7296
2022/02/21,06:00:00,270.09,100,7411,7511
2022/02/21,06:30:00,269.8,91,7885,7976
2022/02/21,07:00:00,268.4,230,8379,8609
2022/02/21,07:30:00,268.95,454,8452,8906
2022/02/21,08:00:00,268.67,712,8113,8825
2022/02/21,08:30:00,268.95,1077,7881,8958
2022/02/21,09:00:00,269.8,1492,7591,9083
2022/02/21,09:30:00,269.8,1739,7364,9103
2022/02/21,10:00:00,270.09,1986,7237,9223
2022/02/21,10:30:00,270.38,2127,7119,9246
2022/02/21,11:00:00,269.51,2079,6995,9074
2022/02/21,11:30:00,270.09,2203,6835,9038
2022/02/21,12:00:00,269.8,2210,6741,8951
2022/02/21,12:30:00,269.8,2184,6582,8766
2022/02/21,13:00:00,269.8,2133,6587,8720
2022/02/21,13:30:00,267.87,2036,6638,8674
2022/02/21,14:00:00,268.12,2019,6766,8785
2022/02/21,14:30:00,267.87,1957,6733,8690
2022/02/21,15:00:00,267.85,1688,6856,8544
2022/02/21,15:30:00,267.85,1484,7157,8641
2022/02/21,16:00:00,268.69,1212,7492,8704
2022/02/21,16:30:00,267.87,762,8055,8817
2022/02/21,17:00:00,268.13,359,8683,9042
2022/02/21,17:30:00,267.87,140,9340,9480
2022/02/21,18:00:00,353.88,154,10039,10193
2022/02/21,18:30:00,390.48,161,10403,10564
2022/02/21,19:00:00,385.64,154,10543,10697
2022/02/21,19:30:00,354.14,140,10618,10758
2022/02/21,20:00:00,383.78,149,10533,10682
2022/02/21,20:30:00,352.85,128,10428,10556
2022/02/21,21:00:00,384.65,120,10200,10320
2022/02/21,21:30:00,390.48,114,9938,10052
2022/02/21,22:00:00,268.13,114,9501,9615
2022/02/21,22:30:00,267.87,118,9221,9339
2022/02/21,23:00:00,267.87,85,8695,8780
2022/02/21,23:30:00,268.13,18,8208,8226
2022/02/22,00:00:00,268.4,9,7707,7716
2022/02/22,00:30:00,268.13,9,7260,7269
2022/02/22,01:00:00,269.23,12,6843,6855
2022/02/22,01:30:00,268.13,12,6906,6918
2022/02/22,02:00:00,268.12,21,6704,6725
2022/02/22,02:30:00,268.12,16,6573,6589
2022/02/22,03:00:00,267.57,17,6489,6506
2022/02/22,03:30:00,268.41,14,6451,6465
2022/02/22,04:00:00,268.41,9,6461,6470
2022/02/22,04:30:00,268.12,7,6697,6704
2022/02/22,05:00:00,267.85,5,6928,6933
2022/02/22,05:30:00,267.61,2,7070,7072
2022/02/22,06:00:00,267.1,0,7371,7371
2022/02/22,06:30:00,268.99,0,7829,7829
2022/02/22,07:00:00,267.3,159,8278,8437
2022/02/22,07:30:00,270.09,540,8089,8629
2022/02/22,08:00:00,268.69,996,7396,8392
2022/02/22,08:30:00,268.13,1288,7345,8633
2022/02/22,09:00:00,269.23,1671,6941,8612
2022/02/22,09:30:00,268.4,1808,6694,8502
2022/02/22,10:00:00,269.51,2009,6489,8498
2022/02/22,10:30:00,269.58,2047,6533,8580
2022/02/22,11:00:00,269.23,2048,6465,8513
2022/02/22,11:30:00,267.61,2116,6406,8522
2022/02/22,12:00:00,268.95,2123,6303,8426
2022/02/22,12:30:00,269.23,2136,6272,8408
2022/02/22,13:00:00,269.8,1983,6323,8306
2022/02/22,13:30:00,269.8,2148,6345,8493
2022/02/22,14:00:00,269.51,2127,6406,8533
2022/02/22,14:30:00,268.41,2018,6681,8699
2022/02/22,15:00:00,269.23,1728,6812,8540
2022/02/22,15:30:00,268.67,1342,7093,8435
2022/02/22,16:00:00,268.67,1037,7338,8375
2022/02/22,16:30:00,268.95,682,7725,8407
2022/02/22,17:00:00,470.87,440,8257,8697
2022/02/22,17:30:00,461.69,98,8934,9032
2022/02/22,18:00:00,444.5,96,9688,9784
2022/02/22,18:30:00,441.82,101,10049,10150
2022/02/22,19:00:00,440.94,108,10161,10269
2022/02/22,19:30:00,440.94,105,10228,10333
2022/02/22,20:00:00,440.94,105,10193,10298
2022/02/22,20:30:00,438.36,105,10078,10183
2022/02/22,21:00:00,439.78,105,9857,9962
2022/02/22,21:30:00,447.31,105,9582,9687
2022/02/22,22:00:00,433.29,105,9120,9225
2022/02/22,22:30:00,427.76,104,8848,8952
2022/02/22,23:00:00,428.06,104,8400,8504
2022/02/22,23:30:00,269.23,48,8001,8049
2022/02/23,00:00:00,269.8,0,7550,7550
2022/02/23,00:30:00,269.8,1,7073,7074
2022/02/23,01:00:00,269.23,1,6788,6789
2022/02/23,01:30:00,269.23,15,6650,6665
2022/02/23,02:00:00,270.09,23,6438,6461
2022/02/23,02:30:00,268.41,39,6379,6418
2022/02/23,03:00:00,268.99,47,6337,6384
2022/02/23,03:30:00,270.09,45,6308,6353
2022/02/23,04:00:00,270.38,29,6343,6372
2022/02/23,04:30:00,269.23,22,6538,6560
2022/02/23,05:00:00,268.95,23,6614,6637
2022/02/23,05:30:00,267.87,28,6842,6870
2022/02/23,06:00:00,270.38,24,7095,7119
2022/02/23,06:30:00,269.8,36,7547,7583
2022/02/23,07:00:00,268.95,243,7788,8031
2022/02/23,07:30:00,269.8,610,7624,8234
2022/02/23,08:00:00,269.51,1081,7008,8089
2022/02/23,08:30:00,269.8,1591,6654,8245
2022/02/23,09:00:00,268.95,1886,6357,8243
2022/02/23,09:30:00,268.41,2072,6052,8124
2022/02/23,10:00:00,269.51,2198,5975,8173
2022/02/23,10:30:00,269.8,2322,5773,8095
2022/02/23,11:00:00,269.23,2207,5848,8055
2022/02/23,11:30:00,268.69,2150,5775,7925
2022/02/23,12:00:00,268.69,2245,5743,7988
2022/02/23,12:30:00,270.38,2203,5775,7978
2022/02/23,13:00:00,268.95,2212,5858,8070
2022/02/23,13:30:00,269.23,2022,6004,8026
2022/02/23,14:00:00,269.8,2007,6076,8083
2022/02/23,14:30:00,268.69,1934,6117,8051
2022/02/23,15:00:00,268.95,1784,6099,7883
2022/02/23,15:30:00,270.38,1618,6331,7949
2022/02/23,16:00:00,268.4,1289,6616,7905
2022/02/23,16:30:00,268.95,876,7061,7937
2022/02/23,17:00:00,270.09,549,7602,8151
2022/02/23,17:30:00,268.95,183,8178,8361
2022/02/23,18:00:00,268.69,189,8821,9010
2022/02/23,18:30:00,268.69,186,9118,9304
2022/02/23,19:00:00,268.99,191,9180,9371
2022/02/23,19:30:00,268.41,200,9228,9428
2022/02/23,20:00:00,268.41,211,9170,9381
2022/02/23,20:30:00,268.99,206,9035,9241
2022/02/23,21:00:00,269.23,209,8890,9099
2022/02/23,21:30:00,268.99,218,8644,8862
2022/02/23,22:00:00,269.8,169,8387,8556
2022/02/23,22:30:00,269.23,169,8076,8245
2022/02/23,23:00:00,268.95,124,7733,7857
2022/02/23,23:30:00,269.23,54,7370,7424
2022/02/24,00:00:00,268.95,45,6999,7044
2022/02/24,00:30:00,269.23,57,6607,6664
2022/02/24,01:00:00,269.51,58,6297,6355
2022/02/24,01:30:00,269.8,54,6073,6127
2022/02/24,02:00:00,269.51,52,5884,5936
2022/02/24,02:30:00,269.23,54,6060,6114
2022/02/24,03:00:00,268.69,41,6022,6063
2022/02/24,03:30:00,269.23,36,5869,5905
2022/02/24,04:00:00,269.23,35,5937,5972
2022/02/24,04:30:00,269.51,39,5901,5940
2022/02/24,05:00:00,268.69,43,6186,6229
2022/02/24,05:30:00,269.51,41,6497,6538
2022/02/24,06:00:00,269.23,53,6769,6822
2022/02/24,06:30:00,268.95,51,7149,7200
2022/02/24,07:00:00,269.51,72,7584,7656
2022/02/24,07:30:00,269.23,320,7788,8108
2022/02/24,08:00:00,269.8,532,7672,8204
2022/02/24,08:30:00,269.51,780,7581,8361
2022/02/24,09:00:00,269.51,1048,7301,8349
2022/02/24,09:30:00,269.51,1424,7159,8583
2022/02/24,10:00:00,269.8,1577,7213,8790
2022/02/24,10:30:00,269.23,1724,7198,8922
2022/02/24,11:00:00,269.8,1715,7213,8928
2022/02/24,11:30:00,269.51,1837,7304,9141
2022/02/24,12:00:00,268.67,1742,7383,9125
2022/02/24,12:30:00,269.51,1655,7326,8981
2022/02/24,13:00:00,268.95,1708,7408,9116
2022/02/24,13:30:00,269.23,1601,7528,9129
2022/02/24,14:00:00,269.51,1457,7809,9266
2022/02/24,14:30:00,269.51,1289,7984,9273
2022/02/24,15:00:00,269.51,1292,8005,9297
2022/02/24,15:30:00,269.8,1332,7884,9216
2022/02/24,16:00:00,269.8,1079,7754,8833
2022/02/24,16:30:00,269.8,735,8071,8806
2022/02/24,17:00:00,269.23,380,8562,8942
2022/02/24,17:30:00,269.51,114,9152,9266
2022/02/24,18:00:00,326.71,139,9787,9926
2022/02/24,18:30:00,326.55,146,10051,10197
2022/02/24,19:00:00,327.64,46,10206,10252
2022/02/24,19:30:00,268.69,22,10221,10243
2022/02/24,20:00:00,268.69,18,10151,10169
2022/02/24,20:30:00,268.69,54,10020,10074
2022/02/24,21:00:00,268.69,58,9810,9868
2022/02/24,21:30:00,268.69,65,9535,9600
2022/02/24,22:00:00,268.69,28,9218,9246
2022/02/24,22:30:00,268.69,27,8947,8974
2022/02/24,23:00:00,268.69,20,8573,8593
2022/02/24,23:30:00,270.38,32,8133,8165
2022/02/25,00:00:00,270.38,39,7641,7680
2022/02/25,00:30:00,270.09,39,7191,7230
2022/02/25,01:00:00,270.38,30,6842,6872
2022/02/25,01:30:00,270.38,30,6578,6608
2022/02/25,02:00:00,268.69,24,6523,6547
2022/02/25,02:30:00,268.69,33,6375,6408
2022/02/25,03:00:00,268.69,32,6414,6446
2022/02/25,03:30:00,268.41,39,6318,6357
2022/02/25,04:00:00,268.69,40,6364,6404
2022/02/25,04:30:00,268.99,63,6448,6511
2022/02/25,05:00:00,268.69,46,6612,6658
2022/02/25,05:30:00,268.12,54,6690,6744
2022/02/25,06:00:00,268.69,48,6822,6870
2022/02/25,06:30:00,270.38,57,6845,6902
2022/02/25,07:00:00,268.69,302,7197,7499
2022/02/25,07:30:00,268.69,517,7479,7996
2022/02/25,08:00:00,268.41,560,7508,8068
2022/02/25,08:30:00,269.8,1168,7504,8672
2022/02/25,09:00:00,269.23,1391,7629,9020
2022/02/25,09:30:00,268.95,1064,8230,9294
2022/02/25,10:00:00,269.23,920,8786,9706
2022/02/25,10:30:00,268.41,876,8997,9873
2022/02/25,11:00:00,268.69,859,9186,10045
2022/02/25,11:30:00,268.69,1139,9036,10175
2022/02/25,12:00:00,268.67,1612,8743,10355
2022/02/25,12:30:00,269.23,1583,8783,10366
2022/02/25,13:00:00,268.95,1580,8810,10390
2022/02/25,13:30:00,268.95,1600,8918,10518
2022/02/25,14:00:00,268.69,1580,9041,10621
2022/02/25,14:30:00,403.99,1376,9067,10443
2022/02/25,15:00:00,403.99,1219,9230,10449
2022/02/25,15:30:00,359.12,814,9510,10324
2022/02/25,16:00:00,329.44,620,9706,10326
2022/02/25,16:30:00,331,617,10030,10647
2022/02/25,17:00:00,333.13,325,10247,10572
2022/02/25,17:30:00,333.07,83,10210,10293
2022/02/25,18:00:00,386.4,87,10422,10509
2022/02/25,18:30:00,402.52,78,10367,10445
2022/02/25,19:00:00,269.23,76,10106,10182
2022/02/25,19:30:00,268.41,61,9858,9919
2022/02/25,20:00:00,269.8,79,9584,9663
2022/02/25,20:30:00,268.95,74,9482,9556
2022/02/25,21:00:00,268.99,76,9294,9370
2022/02/25,21:30:00,270.09,61,9181,9242
2022/02/25,22:00:00,270.38,74,8848,8922
2022/02/25,22:30:00,270.38,63,8581,8644
2022/02/25,23:00:00,270.38,79,8213,8292
2022/02/25,23:30:00,268.69,75,7823,7898
2022/02/26,00:00:00,269.8,72,7449,7521
2022/02/26,00:30:00,270.09,67,7095,7162
2022/02/26,01:00:00,270.38,73,6799,6872
2022/02/26,01:30:00,270.38,77,6681,6758
2022/02/26,02:00:00,270.09,75,6542,6617
2022/02/26,02:30:00,270.38,73,6370,6443
2022/02/26,03:00:00,268.41,70,6384,6454
2022/02/26,03:30:00,268.69,82,6389,6471
2022/02/26,04:00:00,268.69,76,6395,6471
2022/02/26,04:30:00,268.12,58,6493,6551
2022/02/26,05:00:00,270.09,62,6587,6649
2022/02/26,05:30:00,268.41,59,6623,6682
2022/02/26,06:00:00,268.41,74,6625,6699
2022/02/26,06:30:00,268.99,64,6647,6711
2022/02/26,07:00:00,270.38,97,6684,6781
2022/02/26,07:30:00,268.99,326,6693,7019
2022/02/26,08:00:00,269.23,422,6890,7312
2022/02/26,08:30:00,269.28,522,7050,7572
2022/02/26,09:00:00,269.23,599,7165,7764
2022/02/26,09:30:00,269.23,684,7373,8057
2022/02/26,10:00:00,268.95,854,7434,8288
2022/02/26,10:30:00,269.51,862,7432,8294
2022/02/26,11:00:00,268.95,935,7575,8510
2022/02/26,11:30:00,268.95,879,7750,8629
2022/02/26,12:00:00,268.95,886,7798,8684
2022/02/26,12:30:00,268.67,810,8002,8812
2022/02/26,13:00:00,269.51,846,7936,8782
2022/02/26,13:30:00,268.69,896,7935,8831
2022/02/26,14:00:00,268.99,914,7877,8791
2022/02/26,14:30:00,269.23,809,7965,8774
2022/02/26,15:00:00,268.99,776,7937,8713
2022/02/26,15:30:00,326.7,718,8199,8917
2022/02/26,16:00:00,326.7,637,8346,8983
2022/02/26,16:30:00,321.13,508,8683,9191
2022/02/26,17:00:00,312.01,502,8834,9336
2022/02/26,17:30:00,400.68,54,9262,9316
2022/02/26,18:00:00,367.89,38,9871,9909
2022/02/26,18:30:00,367.61,33,10255,10288
2022/02/26,19:00:00,337.85,29,10476,10505
2022/02/26,19:30:00,384.24,28,10503,10531
2022/02/26,20:00:00,400.68,4,10452,10456
2022/02/26,20:30:00,398.22,3,10331,10334
2022/02/26,21:00:00,398.22,5,10146,10151
2022/02/26,21:30:00,398.47,10,9899,9909
2022/02/26,22:00:00,380.7,10,9611,9621
2022/02/26,22:30:00,268.99,13,9216,9229
2022/02/26,23:00:00,268.99,10,8749,8759
2022/02/26,23:30:00,268.69,11,8190,8201
2022/02/27,00:00:00,268.4,12,7684,7696
2022/02/27,00:30:00,268.69,21,7237,7258
2022/02/27,01:00:00,268.99,27,6806,6833
2022/02/27,01:30:00,269.51,20,6655,6675
2022/02/27,02:00:00,268.99,16,6525,6541
2022/02/27,02:30:00,268.69,8,6389,6397
2022/02/27,03:00:00,268.99,7,6293,6300
2022/02/27,03:30:00,268.69,5,6286,6291
2022/02/27,04:00:00,268.69,4,6314,6318
2022/02/27,04:30:00,268.99,3,6477,6480
2022/02/27,05:00:00,268.41,1,6766,6767
2022/02/27,05:30:00,268.69,1,7092,7093
2022/02/27,06:00:00,268.69,1,7347,7348
2022/02/27,06:30:00,406.9,0,7856,7856
2022/02/27,07:00:00,403.42,249,8133,8382
2022/02/27,07:30:00,403.42,595,8126,8721
2022/02/27,08:00:00,268.69,1031,7601,8632
2022/02/27,08:30:00,268.69,1356,7327,8683
2022/02/27,09:00:00,268.41,1590,7050,8640
2022/02/27,09:30:00,268.99,1762,6921,8683
2022/02/27,10:00:00,268.99,1943,6713,8656
2022/02/27,10:30:00,268.69,2106,6616,8722
2022/02/27,11:00:00,268.41,2188,6461,8649
2022/02/27,11:30:00,268.69,2145,6384,8529
2022/02/27,12:00:00,268.69,2145,6250,8395
2022/02/27,12:30:00,268.69,2324,6231,8555
2022/02/27,13:00:00,269.28,2203,6271,8474
2022/02/27,13:30:00,268.69,2186,6225,8411
2022/02/27,14:00:00,268.41,2108,6289,8397
2022/02/27,14:30:00,268.99,1908,6574,8482
2022/02/27,15:00:00,268.69,1878,6735,8613
2022/02/27,15:30:00,268.41,1317,7181,8498
2022/02/27,16:00:00,268.13,1196,7400,8596
2022/02/27,16:30:00,268.67,657,8052,8709
2022/02/27,17:00:00,268.4,491,8497,8988
2022/02/27,17:30:00,382.94,87,9211,9298
2022/02/27,18:00:00,338.33,104,10019,10123
2022/02/27,18:30:00,337.93,106,10394,10500
2022/02/27,19:00:00,332.52,106,10533,10639
2022/02/27,19:30:00,332.44,106,10605,10711
2022/02/27,20:00:00,331.25,106,10539,10645
2022/02/27,20:30:00,398.23,106,10409,10515
2022/02/27,21:00:00,268.69,105,10223,10328
2022/02/27,21:30:00,268.41,104,9975,10079
2022/02/27,22:00:00,268.69,70,9611,9681
2022/02/27,22:30:00,268.99,1,9294,9295
2022/02/27,23:00:00,268.41,0,8819,8819
2022/02/27,23:30:00,268.69,1,8314,8315
2022/02/28,00:00:00,268.12,1,7745,7746
2022/02/28,00:30:00,268.41,0,7222,7222
2022/02/28,01:00:00,268.41,1,6894,6895
2022/02/28,01:30:00,268.12,1,6571,6572
2022/02/28,02:00:00,268.69,1,6520,6521
2022/02/28,02:30:00,268.69,1,6505,6506
2022/02/28,03:00:00,268.69,0,6483,6483
2022/02/28,03:30:00,268.69,0,6468,6468
2022/02/28,04:00:00,268.95,0,6480,6480
2022/02/28,04:30:00,268.67,0,6620,6620
2022/02/28,05:00:00,268.95,0,6878,6878
2022/02/28,05:30:00,268.13,0,6979,6979
2022/02/28,06:00:00,394.07,0,7215,7215
2022/02/28,06:30:00,407.04,0,7501,7501
2022/02/28,07:00:00,300.32,180,7728,7908
2022/02/28,07:30:00,268.95,557,7644,8201
2022/02/28,08:00:00,269.23,900,7178,8078
2022/02/28,08:30:00,268.69,1352,6860,8212
2022/02/28,09:00:00,268.69,1653,6524,8177
2022/02/28,09:30:00,268.13,1906,6313,8219
2022/02/28,10:00:00,268.41,2053,6144,8197
2022/02/28,10:30:00,268.4,2265,5977,8242
2022/02/28,11:00:00,269.23,2300,6019,8319
2022/02/28,11:30:00,268.41,2343,6030,8373
2022/02/28,12:00:00,268.12,2332,5960,8292
2022/02/28,12:30:00,268.69,2356,5917,8273
2022/02/28,13:00:00,268.41,2308,5920,8228
2022/02/28,13:30:00,268.69,2295,5964,8259
2022/02/28,14:00:00,268.12,2190,6066,8256
2022/02/28,14:30:00,268.69,2099,6284,8383
2022/02/28,15:00:00,268.41,1764,6526,8290
2022/02/28,15:30:00,323.07,1437,6820,8257
2022/02/28,16:00:00,321.83,1160,7047,8207
2022/02/28,16:30:00,313.95,810,7645,8455
2022/02/28,17:00:00,400.86,451,8251,8702
2022/02/28,17:30:00,407.04,121,8997,9118
2022/02/28,18:00:00,407.04,123,9797,9920
2022/02/28,18:30:00,345.92,119,10223,10342
2022/02/28,19:00:00,386.23,121,10353,10474
2022/02/28,19:30:00,350.99,119,10415,10534
2022/02/28,20:00:00,355.52,115,10366,10481
2022/02/28,20:30:00,386.23,118,10252,10370
2022/02/28,21:00:00,383.69,117,10060,10177
2022/02/28,21:30:00,268.12,116,9788,9904
2022/02/28,22:00:00,268.69,88,9406,9494
2022/02/28,22:30:00,268.69,5,9158,9163
2022/02/28,23:00:00,268.69,5,8659,8664
2022/02/28,23:30:00,268.99,7,8133,8140
2022/03/01,00:00:00,268.69,6,7636,7642
2022/03/01,00:30:00,268.41,4,7164,7168
2022/03/01,01:00:00,268.69,6,6787,6793
2022/03/01,01:30:00,269.23,5,6531,6536
2022/03/01,02:00:00,268.69,8,6351,6359
2022/03/01,02:30:00,268.41,8,6372,6380
2022/03/01,03:00:00,268.41,6,6277,6283
2022/03/01,03:30:00,268.41,8,6218,6226
2022/03/01,04:00:00,268.41,11,6270,6281
2022/03/01,04:30:00,268.41,9,6386,6395
2022/03/01,05:00:00,267.85,9,6554,6563
2022/03/01,05:30:00,268.41,9,6855,6864
2022/03/01,06:00:00,407.15,12,7135,7147
2022/03/01,06:30:00,292.56,9,7534,7543
2022/03/01,07:00:00,397.23,163,7901,8064
2022/03/01,07:30:00,400.05,499,7819,8318
2022/03/01,08:00:00,406.01,861,7346,8207
2022/03/01,08:30:00,268.41,1246,6850,8096
2022/03/01,09:00:00,266.77,1448,6546,7994
2022/03/01,09:30:00,268.69,1726,6324,8050
2022/03/01,10:00:00,268.41,1987,5907,7894
2022/03/01,10:30:00,268.99,2166,5952,8118
2022/03/01,11:00:00,268.41,2092,5750,7842
2022/03/01,11:30:00,268.99,2158,5687,7845
2022/03/01,12:00:00,268.69,2149,5814,7963
2022/03/01,12:30:00,268.41,2079,5870,7949
2022/03/01,13:00:00,268.99,2220,5835,8055
2022/03/01,13:30:00,268.99,2147,6000,8147
2022/03/01,14:00:00,268.69,2068,6155,8223
2022/03/01,14:30:00,268.99,1867,6405,8272
2022/03/01,15:00:00,268.99,1608,6682,8290
2022/03/01,15:30:00,268.41,1272,6946,8218
2022/03/01,16:00:00,268.99,1027,7228,8255
2022/03/01,16:30:00,268.12,681,7859,8540
2022/03/01,17:00:00,268.41,376,8393,8769
2022/03/01,17:30:00,269.28,141,9027,9168
2022/03/01,18:00:00,403.47,125,9766,9891
2022/03/01,18:30:00,403.47,40,10124,10164
2022/03/01,19:00:00,398.47,37,10204,10241
2022/03/01,19:30:00,398.47,34,10252,10286
2022/03/01,20:00:00,400.94,34,10177,10211
2022/03/01,20:30:00,398.22,34,10068,10102
2022/03/01,21:00:00,268.12,35,9869,9904
2022/03/01,21:30:00,268.69,34,9597,9631
2022/03/01,22:00:00,268.41,38,9300,9338
2022/03/01,22:30:00,267.85,41,8939,8980
2022/03/01,23:00:00,268.69,33,8469,8502
2022/03/01,23:30:00,268.99,28,7920,7948
2022/03/02,00:00:00,337.86,33,7416,7449
2022/03/02,00:30:00,337.86,18,7005,7023
2022/03/02,01:00:00,338.21,17,6794,6811
2022/03/02,01:30:00,338.21,11,6582,6593
2022/03/02,02:00:00,337.86,11,6364,6375
2022/03/02,02:30:00,337.51,9,6283,6292
2022/03/02,03:00:00,337.86,1,6182,6183
2022/03/02,03:30:00,338.57,0,6172,6172
2022/03/02,04:00:00,338.21,2,6229,6231
2022/03/02,04:30:00,338.21,2,6370,6372
2022/03/02,05:00:00,338.21,1,6633,6634
2022/03/02,05:30:00,338.93,5,6779,6784
2022/03/02,06:00:00,337.86,7,6951,6958
2022/03/02,06:30:00,337.86,10,7342,7352
2022/03/02,07:00:00,338.21,135,7718,7853
2022/03/02,07:30:00,338.21,452,7687,8139
2022/03/02,08:00:00,338.21,665,7325,7990
2022/03/02,08:30:00,337.86,908,7287,8195
2022/03/02,09:00:00,337.86,1255,6883,8138
2022/03/02,09:30:00,337.51,1587,6677,8264
2022/03/02,10:00:00,338.21,1764,6304,8068
2022/03/02,10:30:00,335.51,2115,5997,8112
2022/03/02,11:00:00,337.16,2196,5773,7969
2022/03/02,11:30:00,338.21,2194,5825,8019
2022/03/02,12:00:00,337.51,1928,5857,7785
2022/03/02,12:30:00,337.51,1908,6149,8057
2022/03/02,13:00:00,337.16,1694,6452,8146
2022/03/02,13:30:00,338.21,1603,6653,8256
2022/03/02,14:00:00,337.86,1423,6903,8326
2022/03/02,14:30:00,338.21,1337,6926,8263
2022/03/02,15:00:00,337.51,1094,7110,8204
2022/03/02,15:30:00,337.16,1059,7082,8141
2022/03/02,16:00:00,336.82,1027,7222,8249
2022/03/02,16:30:00,338.21,806,7715,8521
2022/03/02,17:00:00,337.51,475,8170,8645
2022/03/02,17:30:00,325.74,126,8740,8866
2022/03/02,18:00:00,396.75,132,9256,9388
2022/03/02,18:30:00,400.91,140,9474,9614
2022/03/02,19:00:00,396.75,56,9613,9669
2022/03/02,19:30:00,398.81,49,9601,9650
2022/03/02,20:00:00,398.81,54,9523,9577
2022/03/02,20:30:00,393.94,53,9363,9416
2022/03/02,21:00:00,329.05,56,9196,9252
2022/03/02,21:30:00,334.27,57,8942,8999
2022/03/02,22:00:00,337.86,49,8606,8655
2022/03/02,22:30:00,337.51,40,8341,8381
2022/03/02,23:00:00,338.57,43,7956,7999
2022/03/02,23:30:00,338.21,20,7533,7553
2022/03/03,00:00:00,337.86,10,7083,7093
2022/03/03,00:30:00,337.86,6,6682,6688
2022/03/03,01:00:00,338.21,5,6709,6714
2022/03/03,01:30:00,337.86,2,6473,6475
2022/03/03,02:00:00,338.21,4,6310,6314
2022/03/03,02:30:00,338.21,3,6210,6213
2022/03/03,03:00:00,337.86,9,6149,6158
2022/03/03,03:30:00,337.86,17,6144,6161
2022/03/03,04:00:00,338.21,29,6157,6186
2022/03/03,04:30:00,338.57,19,6309,6328
2022/03/03,05:00:00,338.21,22,6578,6600
2022/03/03,05:30:00,337.86,62,6727,6789
2022/03/03,06:00:00,337.86,52,6879,6931
2022/03/03,06:30:00,337.86,83,7126,7209
2022/03/03,07:00:00,338.21,189,7581,7770
2022/03/03,07:30:00,338.21,256,7767,8023
2022/03/03,08:00:00,336.49,568,7420,7988
2022/03/03,08:30:00,336.49,987,7302,8289
2022/03/03,09:00:00,337.51,1013,7384,8397
2022/03/03,09:30:00,333.97,1215,7553,8768
2022/03/03,10:00:00,337.86,1183,7548,8731
2022/03/03,10:30:00,336.49,1408,7360,8768
2022/03/03,11:00:00,338.21,1631,7495,9126
2022/03/03,11:30:00,335.83,1655,7703,9358
2022/03/03,12:00:00,336.49,1664,7320,8984
2022/03/03,12:30:00,336.49,1936,7087,9023
2022/03/03,13:00:00,337.16,2016,7255,9271
2022/03/03,13:30:00,337.86,1927,7319,9246
2022/03/03,14:00:00,336.82,1726,7594,9320
2022/03/03,14:30:00,337.51,1415,7763,9178
2022/03/03,15:00:00,337.51,1322,8040,9362
2022/03/03,15:30:00,337.51,1043,8277,9320
2022/03/03,16:00:00,400.59,761,8547,9308
2022/03/03,16:30:00,404.39,577,9072,9649
2022/03/03,17:00:00,349.19,318,9587,9905
2022/03/03,17:30:00,347.47,78,10179,10257
2022/03/03,18:00:00,348.3,76,10799,10875
2022/03/03,18:30:00,348.26,73,11033,11106
2022/03/03,19:00:00,348.21,60,11062,11122
2022/03/03,19:30:00,360.57,52,11031,11083
2022/03/03,20:00:00,370.12,51,10878,10929
2022/03/03,20:30:00,406.34,52,10655,10707
2022/03/03,21:00:00,406.34,50,10408,10458
2022/03/03,21:30:00,338.21,53,10116,10169
2022/03/03,22:00:00,337.86,56,9731,9787
2022/03/03,22:30:00,337.86,57,9367,9424
2022/03/03,23:00:00,337.86,56,8871,8927
2022/03/03,23:30:00,337.86,55,8340,8395
2022/03/04,00:00:00,338.21,57,7843,7900
2022/03/04,00:30:00,337.86,56,7379,7435
2022/03/04,01:00:00,337.51,56,7011,7067
2022/03/04,01:30:00,338.21,52,6704,6756
2022/03/04,02:00:00,338.21,51,6613,6664
2022/03/04,02:30:00,338.21,55,6478,6533
2022/03/04,03:00:00,337.86,51,6340,6391
2022/03/04,03:30:00,338.21,48,6293,6341
2022/03/04,04:00:00,338.21,48,6278,6326
2022/03/04,04:30:00,338.21,46,6405,6451
2022/03/04,05:00:00,338.57,43,6564,6607
2022/03/04,05:30:00,337.86,43,6642,6685
2022/03/04,06:00:00,337.86,45,6693,6738
2022/03/04,06:30:00,337.86,45,6813,6858
2022/03/04,07:00:00,337.86,237,6949,7186
2022/03/04,07:30:00,338.21,609,6926,7535
2022/03/04,08:00:00,337.86,965,6682,7647
2022/03/04,08:30:00,337.51,1329,6455,7784
2022/03/04,09:00:00,337.86,1508,6320,7828
2022/03/04,09:30:00,337.51,1636,6430,8066
2022/03/04,10:00:00,337.86,1648,6492,8140
2022/03/04,10:30:00,337.86,1696,6564,8260
2022/03/04,11:00:00,338.21,1752,6610,8362
2022/03/04,11:30:00,337.86,1544,6797,8341
2022/03/04,12:00:00,338.21,1527,6811,8338
2022/03/04,12:30:00,336.82,1550,6991,8541
2022/03/04,13:00:00,336.49,1583,7028,8611
2022/03/04,13:30:00,336.16,1447,7062,8509
2022/03/04,14:00:00,337.16,1614,6966,8580
2022/03/04,14:30:00,335.83,1657,7041,8698
2022/03/04,15:00:00,334.27,1493,7239,8732
2022/03/04,15:30:00,336.16,1288,7363,8651
2022/03/04,16:00:00,336.16,1046,7749,8795
2022/03/04,16:30:00,335.83,757,8205,8962
2022/03/04,17:00:00,336.16,436,8715,9151
2022/03/04,17:30:00,336.16,90,9046,9136
2022/03/04,18:00:00,336.16,38,9453,9491
2022/03/04,18:30:00,336.16,30,9613,9643
2022/03/04,19:00:00,336.16,28,9449,9477
2022/03/04,19:30:00,336.49,27,9244,9271
2022/03/04,20:00:00,336.16,36,8989,9025
2022/03/04,20:30:00,335.83,37,8886,8923
2022/03/04,21:00:00,336.49,37,8746,8783
2022/03/04,21:30:00,335.83,36,8635,8671
2022/03/04,22:00:00,335.51,36,8409,8445
2022/03/04,22:30:00,336.49,51,8222,8273
2022/03/04,23:00:00,335.83,48,7885,7933
2022/03/04,23:30:00,336.16,45,7511,7556
2022/03/05,00:00:00,336.16,48,7170,7218
2022/03/05,00:30:00,335.83,53,6821,6874
2022/03/05,01:00:00,336.16,43,6598,6641
2022/03/05,01:30:00,336.49,38,6383,6421
2022/03/05,02:00:00,336.16,35,6171,6206
2022/03/05,02:30:00,337.51,37,6104,6141
2022/03/05,03:00:00,336.16,42,6128,6170
2022/03/05,03:30:00,335.51,46,6088,6134
2022/03/05,04:00:00,336.16,36,6086,6122
2022/03/05,04:30:00,335.83,33,6200,6233
2022/03/05,05:00:00,336.16,16,6197,6213
2022/03/05,05:30:00,336.16,26,6272,6298
2022/03/05,06:00:00,336.49,13,6308,6321
2022/03/05,06:30:00,336.82,1,6478,6479
2022/03/05,07:00:00,334.88,157,6487,6644
2022/03/05,07:30:00,334.88,519,6249,6768
2022/03/05,08:00:00,334.88,847,6054,6901
2022/03/05,08:30:00,335.19,1154,5885,7039
2022/03/05,09:00:00,336.16,1422,5662,7084
2022/03/05,09:30:00,335.51,1840,5435,7275
2022/03/05,10:00:00,334.27,2032,5345,7377
2022/03/05,10:30:00,334.57,2227,5214,7441
2022/03/05,11:00:00,335.51,2322,5135,7457
2022/03/05,11:30:00,335.51,2335,5006,7341
2022/03/05,12:00:00,334.57,2322,4924,7246
2022/03/05,12:30:00,335.19,2314,4884,7198
2022/03/05,13:00:00,334.88,2320,4831,7151
2022/03/05,13:30:00,335.19,2306,4836,7142
2022/03/05,14:00:00,335.51,2179,4902,7081
2022/03/05,14:30:00,335.19,2041,5006,7047
2022/03/05,15:00:00,334.88,1812,5310,7122
2022/03/05,15:30:00,333.97,1439,5690,7129
2022/03/05,16:00:00,334.88,1096,6191,7287
2022/03/05,16:30:00,335.51,765,6876,7641
2022/03/05,17:00:00,334.88,418,7210,7628
2022/03/05,17:30:00,334.27,52,7909,7961
2022/03/05,18:00:00,368.6,5,8763,8768
2022/03/05,18:30:00,357.97,18,9281,9299
2022/03/05,19:00:00,353.44,30,9633,9663
2022/03/05,19:30:00,352,37,9671,9708
2022/03/05,20:00:00,357.82,32,9610,9642
2022/03/05,20:30:00,397.99,38,9581,9619
2022/03/05,21:00:00,397.99,42,9394,9436
2022/03/05,21:30:00,364.2,49,9302,9351
2022/03/05,22:00:00,407.02,45,8920,8965
2022/03/05,22:30:00,395.12,54,8617,8671
2022/03/05,23:00:00,395.12,75,8226,8301
2022/03/05,23:30:00,334.88,75,7810,7885
2022/03/06,00:00:00,335.19,76,7336,7412
2022/03/06,00:30:00,335.51,77,6872,6949
2022/03/06,01:00:00,335.19,76,6503,6579
2022/03/06,01:30:00,335.51,73,6234,6307
2022/03/06,02:00:00,335.19,73,6028,6101
2022/03/06,02:30:00,337.51,66,6035,6101
2022/03/06,03:00:00,337.51,74,5933,6007
2022/03/06,03:30:00,338.21,74,5910,5984
2022/03/06,04:00:00,337.51,74,5946,6020
2022/03/06,04:30:00,335.19,74,5988,6062
2022/03/06,05:00:00,335.19,74,6211,6285
2022/03/06,05:30:00,335.19,74,6507,6581
2022/03/06,06:00:00,335.51,74,6706,6780
2022/03/06,06:30:00,335.19,76,7120,7196
2022/03/06,07:00:00,334.88,227,7515,7742
2022/03/06,07:30:00,334.88,465,7804,8269
2022/03/06,08:00:00,335.19,591,7540,8131
2022/03/06,08:30:00,336.49,873,7205,8078
2022/03/06,09:00:00,335.19,1020,6969,7989
2022/03/06,09:30:00,333.67,1381,7179,8560
2022/03/06,10:00:00,334.88,1327,7234,8561
2022/03/06,10:30:00,335.51,1756,6583,8339
2022/03/06,11:00:00,334.57,1878,6481,8359
2022/03/06,11:30:00,336.49,1722,6847,8569
2022/03/06,12:00:00,335.83,1547,6802,8349
2022/03/06,12:30:00,335.19,1703,6766,8469
2022/03/06,13:00:00,334.88,1757,6721,8478
2022/03/06,13:30:00,335.51,1721,6950,8671
2022/03/06,14:00:00,334.27,1628,6943,8571
2022/03/06,14:30:00,335.51,1510,7015,8525
2022/03/06,15:00:00,335.51,1195,7243,8438
2022/03/06,15:30:00,335.51,905,7480,8385
2022/03/06,16:00:00,336.16,696,7626,8322
2022/03/06,16:30:00,335.83,522,8004,8526
2022/03/06,17:00:00,335.83,355,8377,8732
2022/03/06,17:30:00,335.51,142,8680,8822
2022/03/06,18:00:00,357.97,138,9295,9433
2022/03/06,18:30:00,401.48,111,9665,9776
2022/03/06,19:00:00,404.02,70,9794,9864
2022/03/06,19:30:00,338.21,11,9872,9883
2022/03/06,20:00:00,337.86,4,9809,9813
2022/03/06,20:30:00,337.86,1,9694,9695
2022/03/06,21:00:00,337.86,0,9517,9517
2022/03/06,21:30:00,338.21,3,9283,9286
2022/03/06,22:00:00,337.86,5,8934,8939
2022/03/06,22:30:00,337.51,3,8677,8680
2022/03/06,23:00:00,337.86,2,8226,8228
2022/03/06,23:30:00,337.86,3,7726,7729
2022/03/07,00:00:00,336.82,3,7223,7226
2022/03/07,00:30:00,337.86,11,6842,6853
2022/03/07,01:00:00,337.51,13,6466,6479
2022/03/07,01:30:00,338.21,14,6288,6302
2022/03/07,02:00:00,329.05,21,6228,6249
2022/03/07,02:30:00,338.93,23,6112,6135
2022/03/07,03:00:00,338.93,19,6036,6055
2022/03/07,03:30:00,338.93,17,6033,6050
2022/03/07,04:00:00,338.93,15,6105,6120
2022/03/07,04:30:00,329.05,26,6366,6392
2022/03/07,05:00:00,338.57,38,6634,6672
2022/03/07,05:30:00,328.49,38,6935,6973
2022/03/07,06:00:00,338.93,49,6922,6971
2022/03/07,06:30:00,338.57,32,7308,7340
2022/03/07,07:00:00,338.57,196,7595,7791
2022/03/07,07:30:00,338.93,526,7474,8000
2022/03/07,08:00:00,338.57,793,7278,8071
2022/03/07,08:30:00,338.93,1084,6979,8063
2022/03/07,09:00:00,336.16,1225,6712,7937
2022/03/07,09:30:00,338.21,1421,6445,7866
2022/03/07,10:00:00,336.16,1635,6187,7822
2022/03/07,10:30:00,336.49,1762,6073,7835
2022/03/07,11:00:00,336.82,1912,6051,7963
2022/03/07,11:30:00,338.21,1939,5802,7741
2022/03/07,12:00:00,336.49,1979,5562,7541
2022/03/07,12:30:00,336.49,2108,5522,7630
2022/03/07,13:00:00,337.86,2137,5471,7608
2022/03/07,13:30:00,336.49,2070,5688,7758
2022/03/07,14:00:00,336.16,1947,5801,7748
2022/03/07,14:30:00,337.16,1886,6031,7917
2022/03/07,15:00:00,335.83,1680,6250,7930
2022/03/07,15:30:00,336.49,1208,6654,7862
2022/03/07,16:00:00,336.49,909,7042,7951
2022/03/07,16:30:00,336.49,562,7596,8158
2022/03/07,17:00:00,336.49,321,8106,8427
2022/03/07,17:30:00,397.23,79,8676,8755
2022/03/07,18:00:00,397.23,47,9402,9449
2022/03/07,18:30:00,397.23,51,9803,9854
2022/03/07,19:00:00,397.23,44,9929,9973
2022/03/07,19:30:00,399.29,32,9937,9969
2022/03/07,20:00:00,397.23,42,9919,9961
2022/03/07,20:30:00,397.23,44,9793,9837
2022/03/07,21:00:00,401.37,39,9623,9662
2022/03/07,21:30:00,337.51,61,9376,9437
2022/03/07,22:00:00,337.51,72,9030,9102
2022/03/07,22:30:00,337.86,67,8691,8758
2022/03/07,23:00:00,337.51,69,8177,8246
2022/03/07,23:30:00,337.51,73,7721,7794
2022/03/08,00:00:00,337.86,59,7278,7337
2022/03/08,00:30:00,337.51,53,6879,6932
2022/03/08,01:00:00,338.21,45,6553,6598
2022/03/08,01:30:00,338.21,49,6448,6497
2022/03/08,02:00:00,337.86,30,6435,6465
2022/03/08,02:30:00,337.86,27,6336,6363
2022/03/08,03:00:00,337.51,26,6294,6320
2022/03/08,03:30:00,337.86,32,6245,6277
2022/03/08,04:00:00,337.51,41,6252,6293
2022/03/08,04:30:00,337.86,38,6288,6326
2022/03/08,05:00:00,337.86,31,6492,6523
2022/03/08,05:30:00,337.51,23,6721,6744
2022/03/08,06:00:00,337.86,25,6792,6817
2022/03/08,06:30:00,337.86,37,7124,7161
2022/03/08,07:00:00,338.21,212,7422,7634
2022/03/08,07:30:00,337.51,537,7488,8025
2022/03/08,08:00:00,337.51,764,7139,7903
2022/03/08,08:30:00,338.21,1026,6797,7823
2022/03/08,09:00:00,336.16,1201,6729,7930
2022/03/08,09:30:00,334.88,1277,6716,7993
2022/03/08,10:00:00,335.51,1518,6377,7895
2022/03/08,10:30:00,333.67,1517,6274,7791
2022/03/08,11:00:00,337.86,1560,6200,7760
2022/03/08,11:30:00,337.16,1602,6352,7954
2022/03/08,12:00:00,335.51,1580,6405,7985
2022/03/08,12:30:00,334.88,1482,6496,7978
2022/03/08,13:00:00,335.19,1317,6542,7859
2022/03/08,13:30:00,336.82,1326,6518,7844
2022/03/08,14:00:00,335.51,1535,6458,7993
2022/03/08,14:30:00,335.51,1276,6672,7948
2022/03/08,15:00:00,334.88,1342,6795,8137
2022/03/08,15:30:00,335.51,1303,6889,8192
2022/03/08,16:00:00,335.19,1048,7200,8248
2022/03/08,16:30:00,335.19,782,7444,8226
2022/03/08,17:00:00,334.88,428,7964,8392
2022/03/08,17:30:00,396.78,59,8613,8672
2022/03/08,18:00:00,396.78,0,9359,9359
2022/03/08,18:30:00,396.78,1,9741,9742
2022/03/08,19:00:00,396.78,1,9826,9827
2022/03/08,19:30:00,396.78,1,9818,9819
2022/03/08,20:00:00,403.06,2,9775,9777
2022/03/08,20:30:00,398.81,7,9692,9699
2022/03/08,21:00:00,398.81,5,9553,9558
2022/03/08,21:30:00,400.91,3,9351,9354
2022/03/08,22:00:00,398.22,2,9047,9049
2022/03/08,22:30:00,335.51,11,8783,8794
2022/03/08,23:00:00,335.19,4,8333,8337
2022/03/08,23:30:00,335.19,2,7819,7821
2022/03/09,00:00:00,335.83,2,7351,7353
2022/03/09,00:30:00,335.51,2,6965,6967
2022/03/09,01:00:00,333.97,2,6600,6602
2022/03/09,01:30:00,337.86,2,6541,6543
2022/03/09,02:00:00,335.19,2,6465,6467
2022/03/09,02:30:00,335.19,2,6327,6329
2022/03/09,03:00:00,335.19,2,6304,6306
2022/03/09,03:30:00,335.19,5,6269,6274
2022/03/09,04:00:00,335.51,3,6334,6337
2022/03/09,04:30:00,335.51,2,6498,6500
2022/03/09,05:00:00,331.22,2,6600,6602
2022/03/09,05:30:00,335.51,0,6757,6757
2022/03/09,06:00:00,336.82,0,6831,6831
2022/03/09,06:30:00,335.51,6,7290,7296
2022/03/09,07:00:00,335.51,179,7653,7832
2022/03/09,07:30:00,335.19,462,7836,8298
2022/03/09,08:00:00,335.19,697,7444,8141
2022/03/09,08:30:00,334.57,974,7379,8353
2022/03/09,09:00:00,334.88,1258,7139,8397
2022/03/09,09:30:00,333.67,1758,6789,8547
2022/03/09,10:00:00,332.82,1965,6500,8465
2022/03/09,10:30:00,337.51,2105,6441,8546
2022/03/09,11:00:00,337.51,2203,6314,8517
2022/03/09,11:30:00,337.16,2196,6540,8736
2022/03/09,12:00:00,337.16,2208,6299,8507
2022/03/09,12:30:00,337.86,2198,6252,8450
2022/03/09,13:00:00,337.51,2185,6321,8506
2022/03/09,13:30:00,336.16,2155,6472,8627
2022/03/09,14:00:00,336.49,2072,6667,8739
2022/03/09,14:30:00,327.69,1782,6961,8743
2022/03/09,15:00:00,329.05,1352,7428,8780
2022/03/09,15:30:00,398.39,974,7947,8921
2022/03/09,16:00:00,398.7,705,8380,9085
2022/03/09,16:30:00,396.76,405,8816,9221
2022/03/09,17:00:00,398.98,274,9102,9376
2022/03/09,17:30:00,396.95,99,9472,9571
2022/03/09,18:00:00,396.95,89,10073,10162
2022/03/09,18:30:00,2149.76,1,10412,10413
2022/03/09,19:00:00,2225.69,1,10410,10411
2022/03/09,19:30:00,2045.14,1,10374,10375
2022/03/09,20:00:00,2155.84,1,10258,10259
2022/03/09,20:30:00,2250.32,1,10138,10139
2022/03/09,21:00:00,2250.32,1,9931,9932
2022/03/09,21:30:00,396.95,3,9648,9651
2022/03/09,22:00:00,396.15,3,9228,9231
2022/03/09,22:30:00,396.15,3,8913,8916
2022/03/09,23:00:00,398.41,3,8437,8440
2022/03/09,23:30:00,391.73,4,7955,7959
2022/03/10,00:00:00,337.51,4,7471,7475
2022/03/10,00:30:00,337.86,5,7021,7026
2022/03/10,01:00:00,337.86,6,6688,6694
2022/03/10,01:30:00,337.86,6,6555,6561
2022/03/10,02:00:00,338.57,6,6388,6394
2022/03/10,02:30:00,338.21,6,6428,6434
2022/03/10,03:00:00,337.86,5,6369,6374
2022/03/10,03:30:00,337.86,6,6363,6369
2022/03/10,04:00:00,337.86,6,6389,6395
2022/03/10,04:30:00,337.86,7,6586,6593
2022/03/10,05:00:00,337.86,7,6678,6685
2022/03/10,05:30:00,337.86,10,6857,6867
2022/03/10,06:00:00,337.86,7,6969,6976
2022/03/10,06:30:00,338.21,17,7341,7358
2022/03/10,07:00:00,337.51,207,7626,7833
2022/03/10,07:30:00,337.51,677,7752,8429
2022/03/10,08:00:00,337.86,1023,7457,8480
2022/03/10,08:30:00,337.51,1340,7433,8773
2022/03/10,09:00:00,338.21,1591,7234,8825
2022/03/10,09:30:00,337.51,1698,7310,9008
2022/03/10,10:00:00,337.51,1800,7136,8936
2022/03/10,10:30:00,337.16,1893,7115,9008
2022/03/10,11:00:00,337.51,1846,6894,8740
2022/03/10,11:30:00,337.51,1750,6855,8605
2022/03/10,12:00:00,337.51,1763,6865,8628
2022/03/10,12:30:00,337.86,1671,7029,8700
2022/03/10,13:00:00,337.51,1625,7194,8819
2022/03/10,13:30:00,337.51,1625,7275,8900
2022/03/10,14:00:00,337.86,1570,7280,8850
2022/03/10,14:30:00,338.21,1253,7633,8886
2022/03/10,15:00:00,337.86,1309,7789,9098
2022/03/10,15:30:00,336.49,1065,8144,9209
2022/03/10,16:00:00,336.16,757,8317,9074
2022/03/10,16:30:00,398.61,597,8680,9277
2022/03/10,17:00:00,344.26,428,9136,9564
2022/03/10,17:30:00,369.09,11,9713,9724
2022/03/10,18:00:00,340.21,8,10408,10416
2022/03/10,18:30:00,340.07,6,10755,10761
2022/03/10,19:00:00,338.87,4,10876,10880
2022/03/10,19:30:00,338.65,12,10892,10904
2022/03/10,20:00:00,370.82,13,10816,10829
2022/03/10,20:30:00,332.11,13,10692,10705
2022/03/10,21:00:00,332.08,13,10434,10447
2022/03/10,21:30:00,400.81,17,10190,10207
2022/03/10,22:00:00,400.44,15,9786,9801
2022/03/10,22:30:00,337.86,17,9450,9467
2022/03/10,23:00:00,337.51,16,8971,8987
2022/03/10,23:30:00,338.21,16,8497,8513
2022/03/11,00:00:00,337.86,14,7978,7992
2022/03/11,00:30:00,337.51,17,7530,7547
2022/03/11,01:00:00,338.21,17,7163,7180
2022/03/11,01:30:00,338.21,14,6884,6898
2022/03/11,02:00:00,338.21,10,6807,6817
2022/03/11,02:30:00,337.86,17,6786,6803
2022/03/11,03:00:00,337.86,17,6666,6683
2022/03/11,03:30:00,338.21,17,6641,6658
2022/03/11,04:00:00,338.21,16,6631,6647
2022/03/11,04:30:00,337.86,16,6772,6788
2022/03/11,05:00:00,338.21,13,6951,6964
2022/03/11,05:30:00,338.21,12,7116,7128
2022/03/11,06:00:00,337.86,12,7151,7163
2022/03/11,06:30:00,338.93,24,7441,7465
2022/03/11,07:00:00,338.21,215,7782,7997
2022/03/11,07:30:00,337.51,571,7986,8557
2022/03/11,08:00:00,338.57,580,8211,8791
2022/03/11,08:30:00,338.21,759,8506,9265
2022/03/11,09:00:00,337.86,850,8579,9429
2022/03/11,09:30:00,337.51,861,8867,9728
2022/03/11,10:00:00,337.86,974,8915,9889
2022/03/11,10:30:00,338.21,1043,8949,9992
2022/03/11,11:00:00,337.86,1167,8751,9918
2022/03/11,11:30:00,336.16,1246,8810,10056
2022/03/11,12:00:00,338.57,1358,8712,10070
2022/03/11,12:30:00,337.86,1341,8779,10120
2022/03/11,13:00:00,338.57,1289,8736,10025
2022/03/11,13:30:00,338.57,1394,8899,10293
2022/03/11,14:00:00,338.21,1301,8929,10230
2022/03/11,14:30:00,337.51,1232,9081,10313
2022/03/11,15:00:00,338.21,945,9463,10408
2022/03/11,15:30:00,396.28,937,9730,10667
2022/03/11,16:00:00,332.54,817,10062,10879
2022/03/11,16:30:00,324.11,544,10666,11210
2022/03/11,17:00:00,323.35,297,10923,11220
2022/03/11,17:30:00,324.93,38,11038,11076
2022/03/11,18:00:00,330.24,39,11197,11236
2022/03/11,18:30:00,329.31,40,11234,11274
2022/03/11,19:00:00,400.07,38,10988,11026
2022/03/11,19:30:00,397.9,36,10697,10733
2022/03/11,20:00:00,395.77,36,10374,10410
2022/03/11,20:30:00,397.52,36,10247,10283
2022/03/11,21:00:00,397.52,23,10051,10074
2022/03/11,21:30:00,338.21,10,9861,9871
2022/03/11,22:00:00,338.21,13,9581,9594
2022/03/11,22:30:00,338.21,12,9271,9283
2022/03/11,23:00:00,337.86,10,8874,8884
2022/03/11,23:30:00,337.86,11,8482,8493
2022/03/12,00:00:00,337.86,9,8041,8050
2022/03/12,00:30:00,337.86,8,7630,7638
2022/03/12,01:00:00,338.57,7,7272,7279
2022/03/12,01:30:00,338.21,8,7165,7173
2022/03/12,02:00:00,337.86,8,6953,6961
2022/03/12,02:30:00,337.86,5,6805,6810
2022/03/12,03:00:00,337.86,5,6721,6726
2022/03/12,03:30:00,338.21,5,6656,6661
2022/03/12,04:00:00,337.51,7,6674,6681
2022/03/12,04:30:00,337.86,6,6760,6766
2022/03/12,05:00:00,337.51,6,6863,6869
2022/03/12,05:30:00,337.51,7,6983,6990
2022/03/12,06:00:00,337.51,10,6933,6943
2022/03/12,06:30:00,337.86,14,7024,7038
2022/03/12,07:00:00,337.86,181,7027,7208
2022/03/12,07:30:00,338.21,344,6994,7338
2022/03/12,08:00:00,337.86,465,7146,7611
2022/03/12,08:30:00,338.57,546,7327,7873
2022/03/12,09:00:00,338.21,662,7526,8188
2022/03/12,09:30:00,337.86,800,7759,8559
2022/03/12,10:00:00,337.86,947,7957,8904
2022/03/12,10:30:00,337.86,911,8180,9091
2022/03/12,11:00:00,338.21,1055,8378,9433
2022/03/12,11:30:00,338.21,1256,8255,9511
2022/03/12,12:00:00,337.51,1346,8232,9578
2022/03/12,12:30:00,338.21,1191,8382,9573
2022/03/12,13:00:00,337.51,1024,8604,9628
2022/03/12,13:30:00,337.86,921,8576,9497
2022/03/12,14:00:00,337.51,932,8533,9465
2022/03/12,14:30:00,337.86,766,8789,9555
2022/03/12,15:00:00,337.86,679,8951,9630
2022/03/12,15:30:00,338.57,616,9105,9721
2022/03/12,16:00:00,395.48,443,9350,9793
2022/03/12,16:30:00,398.37,331,9787,10118
2022/03/12,17:00:00,398.57,216,10163,10379
2022/03/12,17:30:00,394.89,28,10497,10525
2022/03/12,18:00:00,397.24,28,10943,10971
2022/03/12,18:30:00,341.35,2,11337,11339
2022/03/12,19:00:00,342.31,0,11710,11710
2022/03/12,19:30:00,2250.32,0,11788,11788
2022/03/12,20:00:00,2250.32,1,11729,11730
2022/03/12,20:30:00,2250.32,2,11586,11588
2022/03/12,21:00:00,2250.32,4,11388,11392
2022/03/12,21:30:00,2276.05,4,11164,11168
2022/03/12,22:00:00,2250.32,6,10835,10841
2022/03/12,22:30:00,321.28,6,10391,10397
2022/03/12,23:00:00,321.19,9,9827,9836
2022/03/12,23:30:00,331.73,7,9201,9208
2022/03/13,00:00:00,338.21,7,8600,8607
2022/03/13,00:30:00,337.86,4,8043,8047
2022/03/13,01:00:00,338.21,4,7538,7542
2022/03/13,01:30:00,337.86,1,7136,7137
2022/03/13,02:00:00,336.16,2,7032,7034
2022/03/13,02:30:00,333.97,2,6954,6956
2022/03/13,03:00:00,330.23,2,6820,6822
2022/03/13,03:30:00,331.47,2,6820,6822
2022/03/13,04:00:00,332,2,6814,6816
2022/03/13,04:30:00,332.54,2,7028,7030
2022/03/13,05:00:00,332,2,7245,7247
2022/03/13,05:30:00,331.22,2,7395,7397
2022/03/13,06:00:00,330.72,2,7632,7634
2022/03/13,06:30:00,331.47,36,8194,8230
2022/03/13,07:00:00,330.96,112,8460,8572
2022/03/13,07:30:00,330.96,756,8618,9374
2022/03/13,08:00:00,330.96,1088,8257,9345
2022/03/13,08:30:00,330.96,1368,8316,9684
2022/03/13,09:00:00,332.27,1589,8198,9787
2022/03/13,09:30:00,331.22,1991,8047,10038
2022/03/13,10:00:00,330.96,2151,7993,10144
2022/03/13,10:30:00,330.96,2293,8359,10652
2022/03/13,11:00:00,331.22,2337,8537,10874
2022/03/13,11:30:00,332.82,2262,8601,10863
2022/03/13,12:00:00,334.27,2187,8768,10955
2022/03/13,12:30:00,333.67,2019,9072,11091
2022/03/13,13:00:00,333.97,2027,9111,11138
2022/03/13,13:30:00,333.97,1988,9255,11243
2022/03/13,14:00:00,334.57,1715,9564,11279
2022/03/13,14:30:00,333.67,1252,9913,11165
2022/03/13,15:00:00,323.35,1089,10178,11267
2022/03/13,15:30:00,322.64,897,10446,11343
2022/03/13,16:00:00,321.02,733,10673,11406
2022/03/13,16:30:00,401.73,567,11178,11745
2022/03/13,17:00:00,2250.32,396,11598,11994
2022/03/13,17:30:00,2225.69,117,12052,12169
2022/03/13,18:00:00,2883.83,117,12644,12761
2022/03/13,18:30:00,3086.9,115,13084,13199
2022/03/13,19:00:00,2606.39,115,13188,13303
2022/03/13,19:30:00,2606.39,118,13169,13287
2022/03/13,20:00:00,2606.39,115,13098,13213
2022/03/13,20:30:00,2960.91,96,12944,13040
2022/03/13,21:00:00,2933.87,51,12716,12767
2022/03/13,21:30:00,2250.32,10,12277,12287
2022/03/13,22:00:00,342.75,6,11782,11788
2022/03/13,22:30:00,322.74,3,11297,11300
2022/03/13,23:00:00,321.18,2,10567,10569
2022/03/13,23:30:00,328.77,1,9826,9827
2022/03/14,00:00:00,338.93,1,9060,9061
2022/03/14,00:30:00,337.51,0,8425,8425
2022/03/14,01:00:00,337.51,0,7870,7870
2022/03/14,01:30:00,336.82,0,7851,7851
2022/03/14,02:00:00,325.74,0,7616,7616
2022/03/14,02:30:00,326.93,0,7433,7433
2022/03/14,03:00:00,328.88,0,7358,7358
2022/03/14,03:30:00,328.25,0,7342,7342
2022/03/14,04:00:00,328.88,2,7369,7371
2022/03/14,04:30:00,338.21,0,7589,7589
2022/03/14,05:00:00,337.86,1,7822,7823
2022/03/14,05:30:00,337.86,1,8198,8199
2022/03/14,06:00:00,338.21,0,8400,8400
2022/03/14,06:30:00,337.86,0,9145,9145
2022/03/14,07:00:00,338.21,160,9578,9738
2022/03/14,07:30:00,337.86,362,9703,10065
2022/03/14,08:00:00,337.86,515,9412,9927
2022/03/14,08:30:00,337.51,740,9226,9966
2022/03/14,09:00:00,338.21,880,9374,10254
2022/03/14,09:30:00,337.86,1174,9282,10456
2022/03/14,10:00:00,338.21,1285,9239,10524
2022/03/14,10:30:00,338.21,1297,9244,10541
2022/03/14,11:00:00,337.86,1503,9166,10669
2022/03/14,11:30:00,338.21,1541,9038,10579
2022/03/14,12:00:00,337.86,1582,8932,10514
2022/03/14,12:30:00,337.51,1716,8791,10507
2022/03/14,13:00:00,337.51,1729,8662,10391
2022/03/14,13:30:00,338.21,1709,8623,10332
2022/03/14,14:00:00,337.51,1673,8605,10278
2022/03/14,14:30:00,337.86,1638,8698,10336
2022/03/14,15:00:00,337.86,1502,8928,10430
2022/03/14,15:30:00,337.86,1147,9261,10408
2022/03/14,16:00:00,337.86,1004,9687,10691
2022/03/14,16:30:00,337.51,678,10388,11066
2022/03/14,17:00:00,323.26,371,11143,11514
2022/03/14,17:30:00,2155.84,3,11817,11820
2022/03/14,18:00:00,2007.71,4,12688,12692
2022/03/14,18:30:00,2742.52,5,13132,13137
2022/03/14,19:00:00,2742.52,4,13289,13293
2022/03/14,19:30:00,2742.52,5,13312,13317
2022/03/14,20:00:00,2742.52,2,13261,13263
2022/03/14,20:30:00,2742.52,2,13100,13102
2022/03/14,21:00:00,2742.52,1,12842,12843
2022/03/14,21:30:00,2250.32,1,12550,12551
2022/03/14,22:00:00,406.07,1,11913,11914
2022/03/14,22:30:00,323.26,0,11484,11484
2022/03/14,23:00:00,323.35,0,10784,10784
2022/03/14,23:30:00,327.09,0,10002,10002
2022/03/15,00:00:00,337.86,0,9220,9220
2022/03/15,00:30:00,338.21,0,8622,8622
2022/03/15,01:00:00,338.21,0,8119,8119
2022/03/15,01:30:00,337.86,0,8022,8022
2022/03/15,02:00:00,338.21,0,7818,7818
2022/03/15,02:30:00,338.21,0,7631,7631
2022/03/15,03:00:00,338.21,0,7511,7511
2022/03/15,03:30:00,337.86,0,7463,7463
2022/03/15,04:00:00,337.86,0,7510,7510
2022/03/15,04:30:00,338.21,0,7696,7696
2022/03/15,05:00:00,338.21,0,7816,7816
2022/03/15,05:30:00,338.21,0,8023,8023
2022/03/15,06:00:00,338.21,0,8325,8325
2022/03/15,06:30:00,338.21,8,9041,9049
2022/03/15,07:00:00,338.21,150,9760,9910
2022/03/15,07:30:00,337.86,359,10036,10395
2022/03/15,08:00:00,338.57,558,9787,10345
2022/03/15,08:30:00,338.57,735,9742,10477
2022/03/15,09:00:00,338.57,991,9586,10577
2022/03/15,09:30:00,336.49,1214,9524,10738
2022/03/15,10:00:00,338.21,1443,9359,10802
2022/03/15,10:30:00,338.21,1635,9279,10914
2022/03/15,11:00:00,338.21,1585,9419,11004
2022/03/15,11:30:00,337.86,1588,9323,10911
2022/03/15,12:00:00,337.86,1370,9343,10713
2022/03/15,12:30:00,338.57,1522,9458,10980
2022/03/15,13:00:00,338.21,1603,9610,11213
2022/03/15,13:30:00,337.86,1565,9618,11183
2022/03/15,14:00:00,338.21,1374,9250,10624
2022/03/15,14:30:00,338.21,1315,9464,10779
2022/03/15,15:00:00,338.21,1391,9544,10935
2022/03/15,15:30:00,332,1038,9939,10977
2022/03/15,16:00:00,332.27,898,10420,11318
2022/03/15,16:30:00,1895.2,554,11082,11636
2022/03/15,17:00:00,2082.01,328,11709,12037
2022/03/15,17:30:00,2082.01,8,12259,12267
2022/03/15,18:00:00,1846.22,26,13031,13057
2022/03/15,18:30:00,2489.78,25,13460,13485
2022/03/15,19:00:00,2934.48,26,13546,13572
2022/03/15,19:30:00,2934.48,27,13582,13609
2022/03/15,20:00:00,2981.27,21,13433,13454
2022/03/15,20:30:00,2814.63,1,13302,13303
2022/03/15,21:00:00,2250.32,1,13024,13025
2022/03/15,21:30:00,321.39,3,12661,12664
2022/03/15,22:00:00,321.28,3,12228,12231
2022/03/15,22:30:00,323.07,2,11775,11777
2022/03/15,23:00:00,334.57,3,10885,10888
2022/03/15,23:30:00,338.21,2,10183,10185
2022/03/16,00:00:00,338.21,2,9476,9478
2022/03/16,00:30:00,338.57,0,8866,8866
2022/03/16,01:00:00,336.16,0,8279,8279
2022/03/16,01:30:00,338.21,0,7956,7956
2022/03/16,02:00:00,337.51,0,7802,7802
2022/03/16,02:30:00,338.21,0,7795,7795
2022/03/16,03:00:00,338.57,0,7641,7641
2022/03/16,03:30:00,338.57,0,7632,7632
2022/03/16,04:00:00,337.86,0,7677,7677
2022/03/16,04:30:00,337.86,0,7869,7869
2022/03/16,05:00:00,337.86,0,7934,7934
2022/03/16,05:30:00,337.86,0,8317,8317
2022/03/16,06:00:00,338.57,0,8254,8254
2022/03/16,06:30:00,338.57,26,8655,8681
2022/03/16,07:00:00,338.21,220,8942,9162
2022/03/16,07:30:00,337.86,785,8944,9729
2022/03/16,08:00:00,338.21,1013,8826,9839
2022/03/16,08:30:00,337.86,1311,8768,10079
2022/03/16,09:00:00,338.21,1454,8485,9939
2022/03/16,09:30:00,338.21,1716,8301,10017
2022/03/16,10:00:00,338.21,1889,8189,10078
2022/03/16,10:30:00,338.21,1739,8458,10197
2022/03/16,11:00:00,338.21,1836,8456,10292
2022/03/16,11:30:00,338.93,1930,8363,10293
2022/03/16,12:00:00,338.57,2009,8194,10203
2022/03/16,12:30:00,338.21,1999,8294,10293
2022/03/16,13:00:00,338.21,1901,8251,10152
2022/03/16,13:30:00,338.21,1923,8235,10158
2022/03/16,14:00:00,338.57,1713,8097,9810
2022/03/16,14:30:00,338.21,1376,8464,9840
2022/03/16,15:00:00,337.86,1168,9009,10177
2022/03/16,15:30:00,338.57,872,9718,10590
2022/03/16,16:00:00,395.54,616,10293,10909
2022/03/16,16:30:00,322.81,433,11060,11493
2022/03/16,17:00:00,2225.69,316,11601,11917
2022/03/16,17:30:00,2250.32,51,12097,12148
2022/03/16,18:00:00,2202.14,8,12497,12505
2022/03/16,18:30:00,2492.84,7,12662,12669
2022/03/16,19:00:00,2492.84,8,12769,12777
2022/03/16,19:30:00,2250.32,7,12816,12823
2022/03/16,20:00:00,2159.48,6,12750,12756
2022/03/16,20:30:00,333.05,5,12512,12517
2022/03/16,21:00:00,332.44,3,12253,12256
2022/03/16,21:30:00,340.35,1,11898,11899
2022/03/16,22:00:00,337.51,1,11372,11373
2022/03/16,22:30:00,337.86,0,10990,10990
2022/03/16,23:00:00,337.51,0,10421,10421
2022/03/16,23:30:00,338.21,0,9721,9721
2022/03/17,00:00:00,337.16,0,9087,9087
2022/03/17,00:30:00,337.51,0,8541,8541
2022/03/17,01:00:00,337.16,0,8072,8072
2022/03/17,01:30:00,337.86,0,7789,7789
2022/03/17,02:00:00,338.21,0,7773,7773
2022/03/17,02:30:00,337.51,0,7615,7615
2022/03/17,03:00:00,337.86,0,7496,7496
2022/03/17,03:30:00,337.51,0,7448,7448
2022/03/17,04:00:00,337.86,0,7485,7485
2022/03/17,04:30:00,337.16,0,7662,7662
2022/03/17,05:00:00,337.16,0,7845,7845
2022/03/17,05:30:00,337.16,0,7848,7848
2022/03/17,06:00:00,337.16,0,7952,7952
2022/03/17,06:30:00,337.16,17,8292,8309
2022/03/17,07:00:00,337.16,232,8512,8744
2022/03/17,07:30:00,337.16,617,8662,9279
2022/03/17,08:00:00,338.21,963,8357,9320
2022/03/17,08:30:00,337.51,1327,8189,9516
2022/03/17,09:00:00,337.16,1655,7970,9625
2022/03/17,09:30:00,337.86,1953,7832,9785
2022/03/17,10:00:00,338.21,2158,7574,9732
2022/03/17,10:30:00,337.16,2353,7328,9681
2022/03/17,11:00:00,338.21,2376,7206,9582
2022/03/17,11:30:00,338.21,2392,7121,9513
2022/03/17,12:00:00,337.86,2373,7083,9456
2022/03/17,12:30:00,338.21,2387,6971,9358
2022/03/17,13:00:00,338.21,2389,6910,9299
2022/03/17,13:30:00,338.57,2325,6916,9241
2022/03/17,14:00:00,338.21,2245,6998,9243
2022/03/17,14:30:00,337.51,1968,7053,9021
2022/03/17,15:00:00,337.51,1794,7130,8924
2022/03/17,15:30:00,337.51,1544,7435,8979
2022/03/17,16:00:00,337.86,1200,7889,9089
2022/03/17,16:30:00,336.16,872,8515,9387
2022/03/17,17:00:00,336.49,480,9177,9657
2022/03/17,17:30:00,336.49,208,9928,10136
2022/03/17,18:00:00,335.83,93,10780,10873
2022/03/17,18:30:00,354.57,35,11314,11349
2022/03/17,19:00:00,356.7,4,11501,11505
2022/03/17,19:30:00,346.6,3,11562,11565
2022/03/17,20:00:00,336.16,4,11513,11517
2022/03/17,20:30:00,335.83,3,11415,11418
2022/03/17,21:00:00,336.82,3,11240,11243
2022/03/17,21:30:00,336.16,3,10981,10984
2022/03/17,22:00:00,335.83,3,10635,10638
2022/03/17,22:30:00,337.51,2,10264,10266
2022/03/17,23:00:00,337.16,1,9752,9753
2022/03/17,23:30:00,338.21,3,9176,9179
2022/03/18,00:00:00,336.82,2,8650,8652
2022/03/18,00:30:00,336.49,3,8134,8137
2022/03/18,01:00:00,336.82,1,7745,7746
2022/03/18,01:30:00,336.49,2,7414,7416
2022/03/18,02:00:00,337.51,2,7159,7161
2022/03/18,02:30:00,337.16,4,7259,7263
2022/03/18,03:00:00,336.49,3,7128,7131
2022/03/18,03:30:00,336.49,3,7088,7091
2022/03/18,04:00:00,336.49,2,7085,7087
2022/03/18,04:30:00,336.49,2,7181,7183
2022/03/18,05:00:00,336.82,1,7291,7292
2022/03/18,05:30:00,336.82,3,7444,7447
2022/03/18,06:00:00,336.49,2,7250,7252
2022/03/18,06:30:00,336.49,31,7351,7382
2022/03/18,07:00:00,336.82,227,7393,7620
2022/03/18,07:30:00,336.82,719,7449,8168
2022/03/18,08:00:00,337.16,1102,7298,8400
2022/03/18,08:30:00,336.49,1433,7385,8818
2022/03/18,09:00:00,336.49,1691,7440,9131
2022/03/18,09:30:00,336.82,1995,7538,9533
2022/03/18,10:00:00,336.82,2033,7727,9760
2022/03/18,10:30:00,336.82,2024,7994,10018
2022/03/18,11:00:00,336.82,2127,8225,10352
2022/03/18,11:30:00,336.49,2013,8275,10288
2022/03/18,12:00:00,337.86,2032,8254,10286
2022/03/18,12:30:00,337.51,1971,8326,10297
2022/03/18,13:00:00,337.86,1920,8635,10555
2022/03/18,13:30:00,395.61,1898,8905,10803
2022/03/18,14:00:00,395.61,1841,8983,10824
2022/03/18,14:30:00,398.48,1722,9148,10870
2022/03/18,15:00:00,396.04,1523,9226,10749
2022/03/18,15:30:00,398.76,1278,9467,10745
2022/03/18,16:00:00,394.49,1024,9855,10879
2022/03/18,16:30:00,324.52,683,10272,10955
2022/03/18,17:00:00,327.22,389,10689,11078
2022/03/18,17:30:00,350.12,111,10776,10887
2022/03/18,18:00:00,403.44,109,10914,11023
2022/03/18,18:30:00,359.14,110,10983,11093
2022/03/18,19:00:00,337.38,110,10770,10880
2022/03/18,19:30:00,337.14,110,10477,10587
2022/03/18,20:00:00,340.06,56,10225,10281
2022/03/18,20:30:00,343.81,0,10190,10190
2022/03/18,21:00:00,337.16,0,10062,10062
2022/03/18,21:30:00,337.86,1,9846,9847
2022/03/18,22:00:00,337.86,1,9616,9617
2022/03/18,22:30:00,338.21,1,9306,9307
2022/03/18,23:00:00,337.86,1,8946,8947
2022/03/18,23:30:00,338.21,1,8530,8531
2022/03/19,00:00:00,337.51,1,8102,8103
2022/03/19,00:30:00,336.82,0,7642,7642
2022/03/19,01:00:00,337.86,2,7323,7325
2022/03/19,01:30:00,338.21,2,7083,7085
2022/03/19,02:00:00,337.86,2,6998,7000
2022/03/19,02:30:00,337.51,4,6863,6867
2022/03/19,03:00:00,338.57,6,6774,6780
2022/03/19,03:30:00,337.51,4,6736,6740
2022/03/19,04:00:00,338.57,4,6733,6737
2022/03/19,04:30:00,337.86,4,6814,6818
2022/03/19,05:00:00,337.86,4,6846,6850
2022/03/19,05:30:00,337.16,4,6965,6969
2022/03/19,06:00:00,338.21,4,6937,6941
2022/03/19,06:30:00,338.57,23,6915,6938
2022/03/19,07:00:00,337.86,214,6836,7050
2022/03/19,07:30:00,338.21,560,6786,7346
2022/03/19,08:00:00,337.51,788,6880,7668
2022/03/19,08:30:00,338.21,1057,6924,7981
2022/03/19,09:00:00,337.51,1280,6849,8129
2022/03/19,09:30:00,337.51,1493,7011,8504
2022/03/19,10:00:00,338.21,1557,7093,8650
2022/03/19,10:30:00,338.57,1723,6834,8557
2022/03/19,11:00:00,337.16,1873,6838,8711
2022/03/19,11:30:00,337.86,1910,6739,8649
2022/03/19,12:00:00,336.49,2113,6603,8716
2022/03/19,12:30:00,338.57,2198,6481,8679
2022/03/19,13:00:00,337.16,2114,6521,8635
2022/03/19,13:30:00,337.86,2038,6635,8673
2022/03/19,14:00:00,337.86,1821,6675,8496
2022/03/19,14:30:00,336.82,1627,6693,8320
2022/03/19,15:00:00,337.51,1573,6827,8400
2022/03/19,15:30:00,337.16,1326,7210,8536
2022/03/19,16:00:00,336.16,997,7656,8653
2022/03/19,16:30:00,336.49,657,8292,8949
2022/03/19,17:00:00,336.16,292,8889,9181
2022/03/19,17:30:00,403.97,99,9568,9667
2022/03/19,18:00:00,403.97,2,10214,10216
2022/03/19,18:30:00,407.09,1,10695,10696
2022/03/19,19:00:00,407.09,0,11156,11156
2022/03/19,19:30:00,407.09,0,11262,11262
2022/03/19,20:00:00,398.48,0,11190,11190
2022/03/19,20:30:00,398.31,0,11090,11090
2022/03/19,21:00:00,398.31,0,10999,10999
2022/03/19,21:30:00,400.49,2,10808,10810
2022/03/19,22:00:00,336.16,1,10453,10454
2022/03/19,22:30:00,337.51,2,10084,10086
2022/03/19,23:00:00,337.51,1,9565,9566
2022/03/19,23:30:00,337.86,1,8981,8982
2022/03/20,00:00:00,336.49,1,8422,8423
2022/03/20,00:30:00,336.49,0,7853,7853
2022/03/20,01:00:00,337.86,0,7413,7413
2022/03/20,01:30:00,338.21,0,7185,7185
2022/03/20,02:00:00,337.86,0,7036,7036
2022/03/20,02:30:00,337.16,0,6910,6910
2022/03/20,03:00:00,338.57,0,6795,6795
2022/03/20,03:30:00,335.51,0,6748,6748
2022/03/20,04:00:00,335.83,0,6749,6749
2022/03/20,04:30:00,335.19,0,6983,6983
2022/03/20,05:00:00,335.83,0,7159,7159
2022/03/20,05:30:00,335.51,0,7337,7337
2022/03/20,06:00:00,337.16,0,7373,7373
2022/03/20,06:30:00,337.51,21,7883,7904
2022/03/20,07:00:00,335.51,207,8395,8602
2022/03/20,07:30:00,336.82,497,8620,9117
2022/03/20,08:00:00,336.82,736,8501,9237
2022/03/20,08:30:00,337.16,874,8544,9418
2022/03/20,09:00:00,338.21,1055,8156,9211
2022/03/20,09:30:00,338.57,1598,7669,9267
2022/03/20,10:00:00,337.51,1865,7668,9533
2022/03/20,10:30:00,337.16,1771,7915,9686
2022/03/20,11:00:00,337.51,1965,7592,9557
2022/03/20,11:30:00,337.51,2219,7435,9654
2022/03/20,12:00:00,328.22,2368,7453,9821
2022/03/20,12:30:00,338.93,2364,7557,9921
2022/03/20,13:00:00,338.57,2446,7561,10007
2022/03/20,13:30:00,335.83,2263,7752,10015
2022/03/20,14:00:00,336.49,2110,7903,10013
2022/03/20,14:30:00,336.49,1874,8263,10137
2022/03/20,15:00:00,336.49,1562,8351,9913
2022/03/20,15:30:00,336.16,1459,8694,10153
2022/03/20,16:00:00,336.49,1173,9218,10391
2022/03/20,16:30:00,336.49,769,9658,10427
2022/03/20,17:00:00,386.12,371,10501,10872
2022/03/20,17:30:00,1909.31,107,11441,11548
2022/03/20,18:00:00,2948.68,2,12447,12449
2022/03/20,18:30:00,2934.48,3,12886,12889
2022/03/20,19:00:00,2934.48,2,13056,13058
2022/03/20,19:30:00,2934.48,0,13066,13066
2022/03/20,20:00:00,2934.48,0,12968,12968
2022/03/20,20:30:00,3379.26,0,12801,12801
2022/03/20,21:00:00,3379.26,0,12487,12487
2022/03/20,21:30:00,2225.69,0,12098,12098
2022/03/20,22:00:00,390.43,0,11508,11508
2022/03/20,22:30:00,431.24,0,11015,11015
2022/03/20,23:00:00,431.17,0,10220,10220
2022/03/20,23:30:00,337.51,0,9456,9456
2022/03/21,00:00:00,337.86,0,8739,8739
2022/03/21,00:30:00,337.51,0,8148,8148
2022/03/21,01:00:00,338.21,0,7822,7822
2022/03/21,01:30:00,338.21,2,7579,7581
2022/03/21,02:00:00,337.51,2,7360,7362
2022/03/21,02:30:00,338.21,3,7151,7154
2022/03/21,03:00:00,337.86,3,7113,7116
2022/03/21,03:30:00,338.21,4,7040,7044
2022/03/21,04:00:00,338.21,3,7152,7155
2022/03/21,04:30:00,337.51,4,7344,7348
2022/03/21,05:00:00,336.49,6,7546,7552
2022/03/21,05:30:00,338.21,6,7549,7555
2022/03/21,06:00:00,337.51,7,7785,7792
2022/03/21,06:30:00,335.51,28,8383,8411
2022/03/21,07:00:00,338.21,202,8916,9118
2022/03/21,07:30:00,380.76,519,9303,9822
2022/03/21,08:00:00,382.55,721,9099,9820
2022/03/21,08:30:00,380.1,1079,8991,10070
2022/03/21,09:00:00,382.55,1301,9155,10456
2022/03/21,09:30:00,377.7,1198,9285,10483
2022/03/21,10:00:00,377.7,1438,8905,10343
2022/03/21,10:30:00,379.81,1406,8889,10295
2022/03/21,11:00:00,377.61,1208,8984,10192
2022/03/21,11:30:00,382.46,1112,9083,10195
2022/03/21,12:00:00,375.38,1123,9131,10254
2022/03/21,12:30:00,382.55,988,9203,10191
2022/03/21,13:00:00,377.72,1052,9411,10463
2022/03/21,13:30:00,377.72,822,9413,10235
2022/03/21,14:00:00,382.64,903,9429,10332
2022/03/21,14:30:00,382.89,804,9589,10393
2022/03/21,15:00:00,376.06,681,9690,10371
2022/03/21,15:30:00,376.06,599,9952,10551
2022/03/21,16:00:00,478.38,415,10184,10599
2022/03/21,16:30:00,405.42,328,10595,10923
2022/03/21,17:00:00,2155.84,192,11110,11302
2022/03/21,17:30:00,2250.32,1,11737,11738
2022/03/21,18:00:00,2982.25,0,12418,12418
2022/03/21,18:30:00,3379.26,0,12859,12859
2022/03/21,19:00:00,3379.26,1,12987,12988
2022/03/21,19:30:00,3379.26,1,13029,13030
2022/03/21,20:00:00,3379.26,1,12911,12912
2022/03/21,20:30:00,3379.26,0,12751,12751
2022/03/21,21:00:00,3379.26,0,12480,12480
2022/03/21,21:30:00,2302.91,0,12207,12207
2022/03/21,22:00:00,430.3,0,11492,11492
2022/03/21,22:30:00,430.3,0,11079,11079
2022/03/21,23:00:00,397.49,0,10322,10322
2022/03/21,23:30:00,397.21,0,9594,9594
2022/03/22,00:00:00,338.21,1,8833,8834
2022/03/22,00:30:00,338.57,1,8282,8283
2022/03/22,01:00:00,337.86,0,7739,7739
2022/03/22,01:30:00,337.86,0,7713,7713
2022/03/22,02:00:00,337.86,0,7471,7471
2022/03/22,02:30:00,338.21,0,7308,7308
2022/03/22,03:00:00,338.21,0,7172,7172
2022/03/22,03:30:00,338.21,0,7155,7155
2022/03/22,04:00:00,338.21,0,7227,7227
2022/03/22,04:30:00,338.21,0,7414,7414
2022/03/22,05:00:00,338.21,0,7671,7671
2022/03/22,05:30:00,423.51,0,7839,7839
2022/03/22,06:00:00,392.75,0,8058,8058
2022/03/22,06:30:00,371.28,37,8390,8427
2022/03/22,07:00:00,414.71,236,8715,8951
2022/03/22,07:30:00,338.21,728,8546,9274
2022/03/22,08:00:00,338.21,1091,8085,9176
2022/03/22,08:30:00,337.86,1469,7705,9174
2022/03/22,09:00:00,337.86,1757,7394,9151
2022/03/22,09:30:00,338.21,2009,7213,9222
2022/03/22,10:00:00,338.57,1952,7027,8979
2022/03/22,10:30:00,338.21,2266,6898,9164
2022/03/22,11:00:00,338.21,2238,6984,9222
2022/03/22,11:30:00,338.21,2191,6897,9088
2022/03/22,12:00:00,338.21,2113,6881,8994
2022/03/22,12:30:00,337.86,2064,6885,8949
2022/03/22,13:00:00,337.86,1972,7000,8972
2022/03/22,13:30:00,337.86,2045,6974,9019
2022/03/22,14:00:00,337.86,1912,6976,8888
2022/03/22,14:30:00,337.51,1763,7242,9005
2022/03/22,15:00:00,338.21,1506,7548,9054
2022/03/22,15:30:00,337.86,1233,7915,9148
2022/03/22,16:00:00,399.76,1038,8259,9297
2022/03/22,16:30:00,403.86,699,8691,9390
2022/03/22,17:00:00,423.63,398,9372,9770
2022/03/22,17:30:00,395.37,162,10171,10333
2022/03/22,18:00:00,2161.76,5,11173,11178
2022/03/22,18:30:00,2225.69,9,11929,11938
2022/03/22,19:00:00,1839.81,8,12241,12249
2022/03/22,19:30:00,1839.81,5,12358,12363
2022/03/22,20:00:00,1839.81,3,12346,12349
2022/03/22,20:30:00,2161.76,2,12241,12243
2022/03/22,21:00:00,2250.32,2,12065,12067
2022/03/22,21:30:00,2250.32,0,11776,11776
2022/03/22,22:00:00,430.3,0,11243,11243
2022/03/22,22:30:00,373.24,0,10810,10810
2022/03/22,23:00:00,430.3,0,10120,10120
2022/03/22,23:30:00,337.86,0,9395,9395
2022/03/23,00:00:00,337.51,0,8753,8753
2022/03/23,00:30:00,337.51,0,8137,8137
2022/03/23,01:00:00,337.86,0,7662,7662
2022/03/23,01:30:00,337.16,0,7466,7466
2022/03/23,02:00:00,337.51,0,7373,7373
2022/03/23,02:30:00,337.51,0,7234,7234
2022/03/23,03:00:00,337.16,0,7112,7112
2022/03/23,03:30:00,337.51,0,7104,7104
2022/03/23,04:00:00,337.51,0,7170,7170
2022/03/23,04:30:00,337.51,0,7356,7356
2022/03/23,05:00:00,337.51,0,7617,7617
2022/03/23,05:30:00,337.16,0,7729,7729
2022/03/23,06:00:00,337.51,0,7890,7890
2022/03/23,06:30:00,337.51,29,8285,8314
2022/03/23,07:00:00,337.51,392,8666,9058
2022/03/23,07:30:00,337.51,654,8833,9487
2022/03/23,08:00:00,337.51,953,8492,9445
2022/03/23,08:30:00,334.57,1333,8505,9838
2022/03/23,09:00:00,336.82,1429,8349,9778
2022/03/23,09:30:00,337.16,1724,8365,10089
2022/03/23,10:00:00,337.51,1621,8652,10273
2022/03/23,10:30:00,338.21,1729,8735,10464
2022/03/23,11:00:00,336.82,1373,8720,10093
2022/03/23,11:30:00,336.82,1374,8749,10123
2022/03/23,12:00:00,337.86,1404,8755,10159
2022/03/23,12:30:00,337.51,1591,8693,10284
2022/03/23,13:00:00,340.07,1832,8654,10486
2022/03/23,13:30:00,341.76,1920,8708,10628
2022/03/23,14:00:00,341.76,1853,8548,10401
2022/03/23,14:30:00,336.82,1724,8597,10321
2022/03/23,15:00:00,337.16,1557,8797,10354
2022/03/23,15:30:00,397.1,1333,9102,10435
2022/03/23,16:00:00,397.22,1087,9439,10526
2022/03/23,16:30:00,397.38,757,9905,10662
2022/03/23,17:00:00,385.62,530,10478,11008
2022/03/23,17:30:00,1851.52,255,11058,11313
2022/03/23,18:00:00,2089.23,67,11957,12024
2022/03/23,18:30:00,2074.73,2,12587,12589
2022/03/23,19:00:00,2549.08,5,12773,12778
2022/03/23,19:30:00,2883.83,4,12803,12807
2022/03/23,20:00:00,2883.83,3,12713,12716
2022/03/23,20:30:00,2883.83,5,12559,12564
2022/03/23,21:00:00,2250.32,0,12317,12317
2022/03/23,21:30:00,2225.69,0,11962,11962
2022/03/23,22:00:00,326.88,0,11323,11323
2022/03/23,22:30:00,326.23,0,10889,10889
2022/03/23,23:00:00,337.86,0,10195,10195
2022/03/23,23:30:00,337.51,0,9470,9470
2022/03/24,00:00:00,337.51,0,8858,8858
2022/03/24,00:30:00,337.51,1,8262,8263
2022/03/24,01:00:00,337.86,2,7796,7798
2022/03/24,01:30:00,338.21,11,7602,7613
2022/03/24,02:00:00,337.51,6,7476,7482
2022/03/24,02:30:00,337.86,0,7343,7343
2022/03/24,03:00:00,337.51,1,7235,7236
2022/03/24,03:30:00,337.51,10,7204,7214
2022/03/24,04:00:00,337.86,8,7286,7294
2022/03/24,04:30:00,336.49,4,7473,7477
2022/03/24,05:00:00,337.51,7,7581,7588
2022/03/24,05:30:00,336.82,8,7717,7725
2022/03/24,06:00:00,336.16,11,7946,7957
2022/03/24,06:30:00,336.82,44,8473,8517
2022/03/24,07:00:00,336.49,375,8922,9297
2022/03/24,07:30:00,336.49,675,9316,9991
2022/03/24,08:00:00,337.16,1043,9193,10236
2022/03/24,08:30:00,336.82,1308,9454,10762
2022/03/24,09:00:00,336.49,1355,9659,11014
2022/03/24,09:30:00,336.82,1306,9889,11195
2022/03/24,10:00:00,336.49,1292,9981,11273
2022/03/24,10:30:00,336.82,1361,10109,11470
2022/03/24,11:00:00,336.16,1405,10001,11406
2022/03/24,11:30:00,336.49,1408,10135,11543
2022/03/24,12:00:00,329.92,1434,10007,11441
2022/03/24,12:30:00,328.49,1606,9908,11514
2022/03/24,13:00:00,330.22,1647,10074,11721
2022/03/24,13:30:00,328.77,1593,10181,11774
2022/03/24,14:00:00,329.33,1248,10366,11614
2022/03/24,14:30:00,399.88,1186,10529,11715
2022/03/24,15:00:00,399.87,1141,10344,11485
2022/03/24,15:30:00,323.26,970,10444,11414
2022/03/24,16:00:00,323.16,832,10804,11636
2022/03/24,16:30:00,397.72,655,11176,11831
2022/03/24,17:00:00,1868.33,343,11681,12024
2022/03/24,17:30:00,2022.68,160,12096,12256
2022/03/24,18:00:00,2948.68,6,12820,12826
2022/03/24,18:30:00,2934.48,2,13219,13221
2022/03/24,19:00:00,3379.26,0,13288,13288
2022/03/24,19:30:00,3379.26,0,13201,13201
2022/03/24,20:00:00,3379.26,0,13026,13026
2022/03/24,20:30:00,2115.47,0,12820,12820
2022/03/24,21:00:00,2250.32,0,12584,12584
2022/03/24,21:30:00,328.23,3,11977,11980
2022/03/24,22:00:00,327.1,10,11536,11546
2022/03/24,22:30:00,398.09,10,11160,11170
2022/03/24,23:00:00,401.92,8,10517,10525
2022/03/24,23:30:00,338.57,5,9865,9870
2022/03/25,00:00:00,337.86,3,9216,9219
2022/03/25,00:30:00,337.86,3,8662,8665
2022/03/25,01:00:00,338.21,6,8195,8202
2022/03/25,01:30:00,338.57,5,7841,7846
2022/03/25,03:00:00,338.57,2,7700,7701
2022/03/25,03:30:00,338.21,3,7620,7623
2022/03/25,04:00:00,337.86,3,7490,7493
2022/03/25,04:30:00,338.21,3,7478,7481
2022/03/25,05:00:00,338.21,4,7576,7581
2022/03/25,05:30:00,337.86,3,7776,7780
2022/03/25,06:00:00,338.21,10,7842,7852
2022/03/25,06:30:00,338.21,5,8101,8106
2022/03/25,07:00:00,338.21,3,8414,8417
2022/03/25,07:30:00,337.86,125,8807,8931
2022/03/25,08:00:00,338.57,316,8787,9104
2022/03/25,08:30:00,338.21,461,8935,9396
2022/03/25,09:00:00,338.21,581,9138,9719
2022/03/25,09:30:00,338.21,610,9350,9960
2022/03/25,10:00:00,338.21,911,9207,10119
2022/03/25,10:30:00,338.21,1095,9164,10259
2022/03/25,11:00:00,338.21,1189,9138,10327
2022/03/25,11:30:00,338.21,1263,9252,10515
2022/03/25,12:00:00,338.21,1393,9133,10526
2022/03/25,12:30:00,335.19,1637,8974,10611
2022/03/25,13:00:00,335.19,1600,9051,10651
2022/03/25,13:30:00,337.86,1586,9172,10758
2022/03/25,14:00:00,337.86,1456,9031,10486
2022/03/25,14:30:00,337.86,1597,9020,10617
2022/03/25,15:00:00,337.51,1399,9073,10472
2022/03/25,15:30:00,337.86,1100,9285,10385
2022/03/25,16:00:00,337.51,874,9203,10077
2022/03/25,16:30:00,403.66,734,9556,10290
2022/03/25,17:00:00,406.82,571,9902,10473
2022/03/25,17:30:00,425.21,321,10305,10626
2022/03/25,18:00:00,393.24,50,10816,10865
2022/03/25,18:30:00,381.94,13,11005,11017
2022/03/25,19:00:00,382.28,37,11058,11095
2022/03/25,19:30:00,402.15,32,11130,11162
2022/03/25,20:00:00,406.51,26,10934,10960
2022/03/25,20:30:00,405.22,16,10816,10831
2022/03/25,21:00:00,380.31,29,10633,10663
2022/03/25,21:30:00,396.04,27,10401,10429
2022/03/25,22:00:00,401.48,43,10213,10256
2022/03/25,22:30:00,383.17,33,9987,10020
2022/03/25,23:00:00,394.46,31,9585,9616
2022/03/25,23:30:00,403.53,33,9183,9216
2022/03/26,00:00:00,338.21,29,8706,8735
2022/03/26,00:30:00,337.86,49,8229,8278
2022/03/26,01:00:00,338.21,14,7848,7862
2022/03/26,01:30:00,338.21,10,7530,7540
2022/03/26,02:00:00,337.51,8,7251,7259
2022/03/26,02:30:00,337.86,31,7264,7295
2022/03/26,03:00:00,337.86,49,7070,7119
2022/03/26,03:30:00,337.86,47,7030,7077
2022/03/26,04:00:00,337.86,53,6968,7021
2022/03/26,04:30:00,337.86,72,6954,7026
2022/03/26,05:00:00,337.86,59,7056,7115
2022/03/26,05:30:00,337.86,45,7183,7228
2022/03/26,06:00:00,337.86,32,7300,7332
2022/03/26,06:30:00,337.86,26,7406,7432
2022/03/26,07:00:00,338.57,11,7370,7381
2022/03/26,07:30:00,338.57,214,7400,7614
2022/03/26,08:00:00,337.86,547,7102,7649
2022/03/26,08:30:00,338.57,946,6856,7802
2022/03/26,09:00:00,338.21,1327,6562,7889
2022/03/26,09:30:00,338.57,1761,6397,8158
2022/03/26,10:00:00,338.21,2059,6216,8275
2022/03/26,10:30:00,338.21,2252,6074,8326
2022/03/26,11:00:00,338.57,2457,5939,8396
2022/03/26,11:30:00,338.21,2458,5799,8257
2022/03/26,12:00:00,337.51,2512,5514,8026
2022/03/26,12:30:00,337.86,2542,5437,7979
2022/03/26,13:00:00,338.21,2587,5298,7885
2022/03/26,13:30:00,338.57,2579,5153,7732
2022/03/26,14:00:00,338.21,2377,5043,7420
2022/03/26,14:30:00,337.51,2200,5052,7252
2022/03/26,15:00:00,338.21,2079,5043,7122
2022/03/26,15:30:00,337.86,1663,5120,6783
2022/03/26,16:00:00,336.82,1474,5394,6868
2022/03/26,16:30:00,336.82,1032,5876,6908
2022/03/26,17:00:00,336.49,984,6233,7217
2022/03/26,17:30:00,337.16,613,6916,7529
2022/03/26,18:00:00,385.96,302,7710,8012
2022/03/26,18:30:00,430.5,202,8499,8701
2022/03/26,19:00:00,430.5,189,9275,9464
2022/03/26,19:30:00,423.98,189,9931,10120
2022/03/26,20:00:00,423.98,191,10419,10610
2022/03/26,20:30:00,382.21,190,10533,10723
2022/03/26,21:00:00,395.55,189,10506,10695
2022/03/26,21:30:00,403.69,182,10459,10641
2022/03/26,22:00:00,385.37,184,10254,10438
2022/03/26,22:30:00,378.91,190,9922,10112
2022/03/26,23:00:00,402.28,189,9568,9757
2022/03/26,23:30:00,405.42,142,9031,9173
2022/03/27,00:00:00,337.51,82,8570,8652
2022/03/27,00:30:00,337.86,82,7989,8071
2022/03/27,01:00:00,337.86,82,7513,7595
2022/03/27,01:30:00,337.51,78,7032,7110
2022/03/27,02:00:00,338.21,79,6719,6798
2022/03/27,02:30:00,337.51,81,6454,6535
2022/03/27,03:00:00,338.21,80,6349,6429
2022/03/27,03:30:00,337.51,80,6277,6357
2022/03/27,04:00:00,337.86,79,6245,6324
2022/03/27,04:30:00,337.51,79,6336,6415
2022/03/27,05:00:00,338.21,80,6566,6646
2022/03/27,05:30:00,337.86,78,6929,7007
2022/03/27,06:00:00,393.64,77,7191,7268
2022/03/27,06:30:00,348.92,76,7742,7818
2022/03/27,07:00:00,385.16,57,8229,8286
2022/03/27,07:30:00,430.63,258,8571,8829
2022/03/27,08:00:00,337.16,654,8055,8709
2022/03/27,08:30:00,337.86,1067,7675,8742
2022/03/27,09:00:00,338.21,1466,7536,9002
2022/03/27,09:30:00,338.57,1840,7297,9137
2022/03/27,10:00:00,337.86,2019,7012,9031
2022/03/27,10:30:00,337.86,2111,6952,9063
2022/03/27,11:00:00,337.51,2198,6797,8995
2022/03/27,11:30:00,337.86,2427,6624,9051
2022/03/27,12:00:00,338.57,2440,6463,8903
2022/03/27,12:30:00,338.57,2477,6378,8855
2022/03/27,13:00:00,338.21,2528,6392,8920
2022/03/27,13:30:00,337.51,2540,6314,8854
2022/03/27,14:00:00,337.16,2231,6380,8611
2022/03/27,14:30:00,337.51,1983,6356,8339
2022/03/27,15:00:00,337.86,1918,6376,8294
2022/03/27,15:30:00,337.16,2044,6485,8529
2022/03/27,16:00:00,337.51,1995,6678,8673
2022/03/27,16:30:00,337.16,1709,6792,8501
2022/03/27,17:00:00,337.86,1442,7334,8776
2022/03/27,17:30:00,397.83,1068,7940,9008
2022/03/27,18:00:00,430.63,665,8445,9110
2022/03/27,18:30:00,430.63,348,9161,9509
2022/03/27,19:00:00,424.14,163,9907,10070
2022/03/27,19:30:00,430.63,195,10547,10742
2022/03/27,20:00:00,430.63,194,10728,10922
2022/03/27,20:30:00,420.02,176,10737,10913
2022/03/27,21:00:00,430.63,155,10681,10836
2022/03/27,21:30:00,430.63,145,10516,10661
2022/03/27,22:00:00,430.63,144,10225,10369
2022/03/27,22:30:00,374.53,148,9895,10043
2022/03/27,23:00:00,401.59,132,9409,9541
2022/03/27,23:30:00,403.48,60,8805,8865
2022/03/28,00:00:00,338.21,5,8243,8248
2022/03/28,00:30:00,338.21,11,7696,7707
2022/03/28,01:00:00,338.57,18,7173,7191
2022/03/28,01:30:00,338.93,10,6889,6899
2022/03/28,02:00:00,338.57,8,6645,6653
2022/03/28,02:30:00,338.57,5,6457,6462
2022/03/28,03:00:00,338.21,0,6343,6343
2022/03/28,03:30:00,338.93,1,6282,6283
2022/03/28,04:00:00,338.93,6,6317,6323
2022/03/28,04:30:00,338.93,10,6424,6434
2022/03/28,05:00:00,338.57,14,6669,6683
2022/03/28,05:30:00,338.93,24,6970,6994
2022/03/28,06:00:00,396.68,37,7297,7334
2022/03/28,06:30:00,406.92,45,7742,7787
2022/03/28,07:00:00,398.84,52,8210,8262
2022/03/28,07:30:00,402.06,263,8361,8624
2022/03/28,08:00:00,330.22,605,7870,8475
2022/03/28,08:30:00,335.83,1007,7362,8369
2022/03/28,09:00:00,338.21,1472,6896,8368
2022/03/28,09:30:00,335.51,1793,6821,8614
2022/03/28,10:00:00,335.83,2009,6486,8495
2022/03/28,10:30:00,338.21,2197,6233,8430
2022/03/28,11:00:00,336.16,2338,6020,8358
2022/03/28,11:30:00,336.16,2571,5905,8476
2022/03/28,12:00:00,335.51,2602,5783,8385
2022/03/28,12:30:00,335.83,2615,5707,8322
2022/03/28,13:00:00,337.16,2601,5662,8263
2022/03/28,13:30:00,338.93,2572,5654,8226
2022/03/28,14:00:00,338.57,2562,5609,8171
2022/03/28,14:30:00,336.16,2418,5642,8060
2022/03/28,15:00:00,336.16,2270,5693,7963
2022/03/28,15:30:00,336.16,2088,5852,7940
2022/03/28,16:00:00,335.83,1991,6046,8037
2022/03/28,16:30:00,335.19,1795,6402,8197
2022/03/28,17:00:00,336.49,1491,6794,8285
2022/03/28,17:30:00,335.83,1105,7285,8390
2022/03/28,18:00:00,335.51,680,7765,8445
2022/03/28,18:30:00,336.16,370,8465,8835
2022/03/28,19:00:00,402.46,163,9219,9382
2022/03/28,19:30:00,403.87,156,9985,10141
2022/03/28,20:00:00,403.87,161,10184,10345
2022/03/28,20:30:00,403.59,157,10256,10413
2022/03/28,21:00:00,399,168,10164,10332
2022/03/28,21:30:00,401.25,186,9992,10178
2022/03/28,22:00:00,403.56,187,9668,9855
2022/03/28,22:30:00,405.7,189,9418,9607
2022/03/28,23:00:00,396.96,190,8853,9043
2022/03/28,23:30:00,329.62,190,8330,8520
2022/03/29,00:00:00,328.49,117,7828,7945
2022/03/29,00:30:00,325.74,75,7289,7364
2022/03/29,01:00:00,328.49,73,6963,7036
2022/03/29,01:30:00,329.05,73,6588,6661
2022/03/29,02:00:00,325.52,76,6391,6467
2022/03/29,02:30:00,329.33,76,6161,6237
2022/03/29,03:00:00,324.46,76,6232,6308
2022/03/29,03:30:00,330.22,75,6156,6231
2022/03/29,04:00:00,328.49,74,6210,6284
2022/03/29,04:30:00,327.95,76,6145,6221
2022/03/29,05:00:00,327.18,75,6379,6454
2022/03/29,05:30:00,329.62,75,6730,6805
2022/03/29,06:00:00,328.77,75,6937,7012
2022/03/29,06:30:00,330.22,79,7382,7461
2022/03/29,07:00:00,407.51,89,7674,7763
2022/03/29,07:30:00,407.51,329,7800,8129
2022/03/29,08:00:00,329.33,578,7369,7947
2022/03/29,08:30:00,330.83,846,7215,8061
2022/03/29,09:00:00,329.05,1219,6767,7986
2022/03/29,09:30:00,329.62,1570,6520,8090
2022/03/29,10:00:00,329.62,1843,6150,7993
2022/03/29,10:30:00,330.22,2163,5879,8042
2022/03/29,11:00:00,329.92,2293,5661,7954
2022/03/29,11:30:00,327.43,2449,5508,7957
2022/03/29,12:00:00,328.22,2416,5509,7925
2022/03/29,12:30:00,328.49,2466,5462,7928
2022/03/29,13:00:00,327.43,2519,5615,8134
2022/03/29,13:30:00,328.49,2519,5612,8131
2022/03/29,14:00:00,330.22,2497,5583,8080
2022/03/29,14:30:00,329.62,2488,5597,8085
2022/03/29,15:00:00,329.33,2326,5662,7988
2022/03/29,15:30:00,329.62,2202,5829,8031
2022/03/29,16:00:00,329.33,1925,6048,7973
2022/03/29,16:30:00,329.33,1680,6368,8048
2022/03/29,17:00:00,329.92,1371,6713,8084
2022/03/29,17:30:00,329.62,992,6917,7909
2022/03/29,18:00:00,409.48,597,7409,8006
2022/03/29,18:30:00,437.3,354,7872,8226
2022/03/29,19:00:00,430.11,169,8401,8570
2022/03/29,19:30:00,437.3,164,8941,9105
2022/03/29,20:00:00,432.54,161,9053,9214
2022/03/29,20:30:00,437.3,163,8997,9160
2022/03/29,21:00:00,403.75,149,8911,9060
2022/03/29,21:30:00,437.3,71,8908,8979
2022/03/29,22:00:00,425.73,34,8703,8737
2022/03/29,22:30:00,437.3,24,8500,8524
2022/03/29,23:00:00,328.22,19,8140,8159
2022/03/29,23:30:00,329.33,15,7676,7691
2022/03/30,00:00:00,329.92,8,7207,7215
2022/03/30,00:30:00,329.92,10,6789,6799
2022/03/30,01:00:00,327.18,6,6504,6510
2022/03/30,01:30:00,329.05,1,6550,6551
2022/03/30,02:00:00,329.33,0,6366,6366
2022/03/30,02:30:00,329.33,2,6243,6245
2022/03/30,03:00:00,329.05,2,6076,6078
2022/03/30,03:30:00,329.33,5,6048,6053
2022/03/30,04:00:00,327.95,5,6081,6086
2022/03/30,04:30:00,407.62,6,6203,6209
2022/03/30,05:00:00,402.19,8,6387,6395
2022/03/30,05:30:00,380.37,5,6508,6513
2022/03/30,06:00:00,387.18,5,6564,6569
2022/03/30,06:30:00,393.64,13,6817,6830
2022/03/30,07:00:00,391.71,15,7146,7161
2022/03/30,07:30:00,422.4,227,7256,7483
2022/03/30,08:00:00,411.58,506,7003,7509
2022/03/30,08:30:00,385.6,790,6661,7451
2022/03/30,09:00:00,329.05,1163,6348,7511
2022/03/30,09:30:00,329.62,1547,6005,7552
2022/03/30,10:00:00,329.33,1946,5639,7585
2022/03/30,10:30:00,329.62,2120,5364,7484
2022/03/30,11:00:00,329.05,2265,5209,7474
2022/03/30,11:30:00,329.92,2424,5105,7529
2022/03/30,12:00:00,329.92,2432,5044,7476
2022/03/30,12:30:00,330.22,2422,4999,7421
2022/03/30,13:00:00,329.92,2466,5117,7583
2022/03/30,13:30:00,327.95,2455,5071,7526
2022/03/30,14:00:00,330.22,2379,5132,7511
2022/03/30,14:30:00,329.05,2347,5178,7525
2022/03/30,15:00:00,329.92,2198,5366,7564
2022/03/30,15:30:00,329.05,2162,5414,7576
2022/03/30,16:00:00,328.77,1909,5499,7408
2022/03/30,16:30:00,328.49,1597,5957,7554
2022/03/30,17:00:00,329.33,1202,6486,7688
2022/03/30,17:30:00,330.22,884,6974,7858
2022/03/30,18:00:00,404.2,603,7394,7997
2022/03/30,18:30:00,434.56,318,7915,8233
2022/03/30,19:00:00,434.56,162,8428,8590
2022/03/30,19:30:00,425.93,169,8928,9097
2022/03/30,20:00:00,425.84,163,9032,9195
2022/03/30,20:30:00,434.56,148,9041,9189
2022/03/30,21:00:00,434.56,151,8908,9059
2022/03/30,21:30:00,403.23,154,8732,8886
2022/03/30,22:00:00,434.56,130,8560,8690
2022/03/30,22:30:00,393.78,57,8312,8369
2022/03/30,23:00:00,401.7,31,7948,7979
2022/03/30,23:30:00,434.56,24,7552,7576
2022/03/31,00:00:00,328.77,19,7126,7145
2022/03/31,00:30:00,329.62,34,6710,6744
2022/03/31,01:00:00,330.52,23,6382,6405
2022/03/31,01:30:00,327.69,19,6137,6156
2022/03/31,02:00:00,328.22,7,5978,5985
2022/03/31,02:30:00,328.22,0,5878,5878
2022/03/31,03:00:00,327.43,0,5768,5768
2022/03/31,03:30:00,329.05,0,5751,5751
2022/03/31,04:00:00,327.69,1,5758,5759
2022/03/31,04:30:00,328.22,0,5922,5922
2022/03/31,05:00:00,327.69,0,6039,6039
2022/03/31,05:30:00,328.22,0,6338,6338
2022/03/31,06:00:00,392.83,0,6547,6547
2022/03/31,06:30:00,395.83,0,6802,6802
2022/03/31,07:00:00,403.07,19,7057,7076
2022/03/31,07:30:00,401.8,285,7177,7462
2022/03/31,08:00:00,395.84,670,6773,7443
2022/03/31,08:30:00,329.92,1008,6420,7428
2022/03/31,09:00:00,330.22,1425,5905,7330
2022/03/31,09:30:00,329.62,1711,5589,7300
2022/03/31,10:00:00,328.49,1998,5495,7493
2022/03/31,10:30:00,329.05,2154,5306,7460
2022/03/31,11:00:00,328.77,2285,5150,7435
2022/03/31,11:30:00,330.22,2441,5172,7613
2022/03/31,12:00:00,329.92,2474,5131,7605
2022/03/31,12:30:00,330.22,2495,5115,7610
2022/03/31,13:00:00,328.77,2478,4972,7450
2022/03/31,13:30:00,329.05,2431,5029,7460
2022/03/31,14:00:00,328.77,2407,5215,7622
2022/03/31,14:30:00,328.77,2325,5283,7608
2022/03/31,15:00:00,329.92,2123,5332,7455
2022/03/31,15:30:00,327.69,2040,5477,7517
2022/03/31,16:00:00,329.33,1748,5770,7518
2022/03/31,16:30:00,327.95,1382,6273,7655
2022/03/31,17:00:00,328.22,1145,6465,7610
2022/03/31,17:30:00,326.93,918,6831,7749
2022/03/31,18:00:00,397.89,531,7191,7722
2022/03/31,18:30:00,397.89,326,7615,7941
2022/03/31,19:00:00,427.65,131,8086,8217
2022/03/31,19:30:00,434.41,130,8515,8645
2022/03/31,20:00:00,434.41,132,8590,8722
2022/03/31,20:30:00,434.41,138,8509,8647
2022/03/31,21:00:00,434.41,135,8395,8530
2022/03/31,21:30:00,434.41,41,8294,8335
2022/03/31,22:00:00,434.41,35,8105,8140
2022/03/31,22:30:00,413.35,35,7938,7973
2022/03/31,23:00:00,434.41,34,7658,7692
2022/03/31,23:30:00,327.95,4,7287,7291
2022/04/01,00:00:00,327.69,4,6906,6910
2022/04/01,00:30:00,327.18,4,6571,6575
2022/04/01,01:00:00,325.08,4,6269,6273
2022/04/01,01:30:00,324.66,4,6063,6067
2022/04/01,02:00:00,329.05,4,5862,5866
2022/04/01,02:30:00,329.05,2,5739,5741
2022/04/01,03:00:00,329.62,4,5610,5614
2022/04/01,03:30:00,329.05,4,5558,5562
2022/04/01,04:00:00,401.4,3,5567,5570
2022/04/01,04:30:00,401.85,3,5580,5583
2022/04/01,05:00:00,390.57,3,5660,5663
2022/04/01,05:30:00,390.94,3,5872,5875
2022/04/01,06:00:00,412.73,3,5995,5998
2022/04/01,06:30:00,414.62,3,5981,5984
2022/04/01,07:00:00,412.89,11,6093,6104
2022/04/01,07:30:00,413.12,288,6090,6378
2022/04/01,08:00:00,395.78,629,5732,6361
2022/04/01,08:30:00,401.56,980,5552,6532
2022/04/01,09:00:00,401.57,1379,5343,6722
2022/04/01,09:30:00,394.73,1681,4978,6659
2022/04/01,10:00:00,329.92,1931,4823,6754
2022/04/01,10:30:00,329.62,2057,4780,6837
2022/04/01,11:00:00,328.49,2238,4843,7081
2022/04/01,11:30:00,329.05,2336,4823,7159
2022/04/01,12:00:00,329.33,2384,4861,7245
2022/04/01,12:30:00,329.62,2286,4934,7220
2022/04/01,13:00:00,322.62,2211,4708,6919
2022/04/01,13:30:00,327.18,2172,4676,6848
2022/04/01,14:00:00,328.77,2124,4748,6872
2022/04/01,14:30:00,329.05,2014,4882,6896
2022/04/01,15:00:00,328.77,1801,5058,6859
2022/04/01,15:30:00,328.49,1594,5344,6938
2022/04/01,16:00:00,328.22,1361,5588,6949
2022/04/01,16:30:00,327.43,1124,5914,7038
2022/04/01,17:00:00,327.95,916,6292,7208
2022/04/01,17:30:00,328.22,692,6688,7380
2022/04/01,18:00:00,403.63,426,7185,7611
2022/04/01,18:30:00,407.62,193,7516,7709
2022/04/01,19:00:00,434.84,0,7543,7543
2022/04/01,19:30:00,434.84,0,7685,7685
2022/04/01,20:00:00,428.07,0,7627,7627
2022/04/01,20:30:00,400.56,0,7456,7456
2022/04/01,21:00:00,434.84,0,7333,7333
2022/04/01,21:30:00,427.27,0,7180,7180
2022/04/01,22:00:00,427.27,0,7071,7071
2022/04/01,22:30:00,394.23,0,6940,6940
2022/04/01,23:00:00,434.84,0,6783,6783
2022/04/01,23:30:00,330.22,0,6518,6518
2022/04/02,00:00:00,329.05,0,6362,6362
2022/04/02,00:30:00,329.33,0,6172,6172
2022/04/02,01:00:00,325.52,4,5967,5971
2022/04/02,01:30:00,330.22,3,5806,5809
2022/04/02,02:00:00,328.77,2,5676,5678
2022/04/02,02:30:00,329.92,2,5580,5582
2022/04/02,03:00:00,329.05,2,5539,5541
2022/04/02,03:30:00,329.05,2,5699,5701
2022/04/02,04:00:00,329.92,2,5675,5677
2022/04/02,04:30:00,329.33,2,5807,5809
2022/04/02,05:00:00,327.69,2,5967,5969
2022/04/02,05:30:00,327.18,2,5921,5923
2022/04/02,06:00:00,327.18,2,5982,5984
2022/04/02,06:30:00,327.95,2,5786,5788
2022/04/02,07:00:00,328.49,2,5667,5669
2022/04/02,07:30:00,329.05,190,5546,5736
2022/04/02,08:00:00,328.22,334,5488,5822
2022/04/02,08:30:00,327.43,573,5319,5892
2022/04/02,09:00:00,329.62,903,5115,6018
2022/04/02,09:30:00,329.33,1171,4871,6042
2022/04/02,10:00:00,329.92,1405,4779,6184
2022/04/02,10:30:00,329.62,1500,4680,6180
2022/04/02,11:00:00,328.49,1643,4634,6277
2022/04/02,11:30:00,329.92,1705,4647,6352
2022/04/02,12:00:00,327.95,1862,4543,6405
2022/04/02,12:30:00,329.92,1910,4527,6437
2022/04/02,13:00:00,329.05,1903,4585,6488
2022/04/02,13:30:00,329.33,1867,4632,6499
2022/04/02,14:00:00,329.92,1810,4666,6476
2022/04/02,14:30:00,329.33,1781,4696,6477
2022/04/02,15:00:00,326.93,1646,4791,6437
2022/04/02,15:30:00,327.69,1555,4928,6483
2022/04/02,16:00:00,327.95,1329,5291,6620
2022/04/02,16:30:00,326.93,1034,5627,6661
2022/04/02,17:00:00,327.43,706,5918,6624
2022/04/02,17:30:00,327.43,522,6302,6824
2022/04/02,18:00:00,327.43,304,6644,6948
2022/04/02,18:30:00,403.15,151,6998,7149
2022/04/02,19:00:00,403.39,3,7229,7232
2022/04/02,19:30:00,434.78,3,7387,7390
2022/04/02,20:00:00,434.78,3,7651,7654
2022/04/02,20:30:00,434.78,21,7708,7729
2022/04/02,21:00:00,404.09,28,7687,7715
2022/04/02,21:30:00,402.42,28,7611,7639
2022/04/02,22:00:00,427.69,13,7465,7478
2022/04/02,22:30:00,434.78,0,7310,7310
2022/04/02,23:00:00,434.78,0,7130,7130
2022/04/02,23:30:00,327.43,0,6863,6863
2022/04/03,00:00:00,533,0,6640,6640
2022/04/03,00:30:00,533,0,6329,6329
2022/04/03,01:00:00,532.49,0,6109,6109
2022/04/03,01:30:00,532.74,0,5889,5889
2022/04/03,02:00:00,533.25,0,5735,5735
2022/04/03,02:30:00,533,0,5540,5540
2022/04/03,03:00:00,533,2,5473,5475
2022/04/03,03:30:00,532.49,2,5462,5464
2022/04/03,04:00:00,532.74,1,5525,5526
2022/04/03,04:30:00,533.25,1,5643,5644
2022/04/03,05:00:00,533.25,1,5763,5764
2022/04/03,05:30:00,532.74,2,5901,5903
2022/04/03,06:00:00,532.74,1,6009,6010
2022/04/03,06:30:00,532.74,1,6176,6177
2022/04/03,07:00:00,532.74,5,6458,6463
2022/04/03,07:30:00,532.74,151,6636,6787
2022/04/03,08:00:00,533,377,6471,6848
2022/04/03,08:30:00,533.25,658,6283,6941
2022/04/03,09:00:00,532.74,917,6013,6930
2022/04/03,09:30:00,533,1214,5868,7082
2022/04/03,10:00:00,533.25,1395,5714,7109
2022/04/03,10:30:00,532.74,1563,5565,7128
2022/04/03,11:00:00,532.49,1716,5687,7403
2022/04/03,11:30:00,533.25,1942,5599,7541
2022/04/03,12:00:00,532.74,1987,5533,7520
2022/04/03,12:30:00,533.25,2048,5566,7614
2022/04/03,13:00:00,533,2105,5500,7605
2022/04/03,13:30:00,532.74,2146,5471,7617
2022/04/03,14:00:00,533,2375,5302,7677
2022/04/03,14:30:00,533,2349,5295,7644
2022/04/03,15:00:00,533,2243,5328,7571
2022/04/03,15:30:00,532.49,2158,5524,7682
2022/04/03,16:00:00,532.74,1927,5448,7375
2022/04/03,16:30:00,532.74,1642,5753,7395
2022/04/03,17:00:00,533.25,1302,6160,7462
2022/04/03,17:30:00,533,951,6713,7664
2022/04/03,18:00:00,532.74,540,7205,7745
2022/04/03,18:30:00,532.74,303,7671,7974
2022/04/03,19:00:00,532.49,108,7932,8040
2022/04/03,19:30:00,532.74,109,8065,8174
2022/04/03,20:00:00,532.74,111,8168,8279
2022/04/03,20:30:00,533,59,8267,8326
2022/04/03,21:00:00,533,7,8171,8178
2022/04/03,21:30:00,533,6,8061,8067
2022/04/03,22:00:00,533,5,7875,7880
2022/04/03,22:30:00,532.74,3,7658,7661
2022/04/03,23:00:00,533,2,7339,7341
2022/04/03,23:30:00,533,1,7033,7034
2022/04/04,00:00:00,533,5,6719,6724
2022/04/04,00:30:00,533,3,6436,6439
2022/04/04,01:00:00,533,6,6204,6210
2022/04/04,01:30:00,532.74,7,5952,5959
2022/04/04,02:00:00,533,8,5821,5829
2022/04/04,02:30:00,533.25,8,5662,5670
2022/04/04,03:00:00,533.25,4,5608,5612
2022/04/04,03:30:00,532.74,2,5573,5575
2022/04/04,04:00:00,533,1,5718,5719
2022/04/04,04:30:00,532.49,1,5847,5848
2022/04/04,05:00:00,532.74,0,6002,6002
2022/04/04,05:30:00,532.74,0,6098,6098
2022/04/04,06:00:00,532.49,0,6246,6246
2022/04/04,06:30:00,533,0,6391,6391
2022/04/04,07:00:00,532.74,13,6558,6571
2022/04/04,07:30:00,532.49,282,6565,6847
2022/04/04,08:00:00,533,630,6261,6891
2022/04/04,08:30:00,533.25,946,5894,6840
2022/04/04,09:00:00,533,1337,5593,6930
2022/04/04,09:30:00,533,1703,5399,7102
2022/04/04,10:00:00,532.74,1958,5206,7164
2022/04/04,10:30:00,532.74,2134,5083,7217
2022/04/04,11:00:00,532.74,2326,4970,7296
2022/04/04,11:30:00,532.23,2444,4920,7364
2022/04/04,12:00:00,533.25,2485,5078,7563
2022/04/04,12:30:00,532.23,2513,5105,7618
2022/04/04,13:00:00,532.74,2500,5213,7713
2022/04/04,13:30:00,533,2497,5278,7775
2022/04/04,14:00:00,533,2460,5311,7771
2022/04/04,14:30:00,532.74,2447,5412,7859
2022/04/04,15:00:00,532.74,2248,5560,7808
2022/04/04,15:30:00,533,2143,5719,7862
2022/04/04,16:00:00,533.25,1883,5915,7798
2022/04/04,16:30:00,532.74,1649,6233,7882
2022/04/04,17:00:00,532.74,1302,6653,7955
2022/04/04,17:30:00,532.49,925,7107,8032
2022/04/04,18:00:00,532.74,566,7246,7812
2022/04/04,18:30:00,533,315,7620,7935
2022/04/04,19:00:00,533,168,7851,8019
2022/04/04,19:30:00,533,163,7967,8130
2022/04/04,20:00:00,533,158,8086,8244
2022/04/04,20:30:00,533.51,101,8187,8288
2022/04/04,21:00:00,533,40,8135,8175
2022/04/04,21:30:00,533.51,33,7999,8032
2022/04/04,22:00:00,533,37,7813,7850
2022/04/04,22:30:00,533,0,7665,7665
2022/04/04,23:00:00,533,0,7334,7334
2022/04/04,23:30:00,532.49,0,7081,7081
2022/04/05,00:00:00,532.74,0,6709,6709
2022/04/05,00:30:00,532.74,0,6505,6505
2022/04/05,01:00:00,532.74,0,6274,6274
2022/04/05,01:30:00,532.74,0,6135,6135
2022/04/05,02:00:00,533.25,0,5917,5917
2022/04/05,02:30:00,533,0,5836,5836
2022/04/05,03:00:00,533,0,5702,5702
2022/04/05,03:30:00,533,0,5741,5741
2022/04/05,04:00:00,533,0,5781,5781
2022/04/05,04:30:00,532.74,0,5858,5858
2022/04/05,05:00:00,532.74,0,5991,5991
2022/04/05,05:30:00,533.51,0,6132,6132
2022/04/05,06:00:00,533,0,6198,6198
2022/04/05,06:30:00,533,4,6387,6391
2022/04/05,07:00:00,533,27,6405,6432
2022/04/05,07:30:00,532.49,346,6447,6793
2022/04/05,08:00:00,532.74,645,6166,6811
2022/04/05,08:30:00,531.47,934,6057,6991
2022/04/05,09:00:00,532.49,1257,5856,7113
2022/04/05,09:30:00,532.49,1517,5866,7383
2022/04/05,10:00:00,532.74,1841,5620,7461
2022/04/05,10:30:00,531.98,2036,5499,7535
2022/04/05,11:00:00,532.74,2221,5478,7699
2022/04/05,11:30:00,533,2385,5500,7885
2022/04/05,12:00:00,521.46,2399,5476,7875
2022/04/05,12:30:00,533,2411,5540,7951
2022/04/05,13:00:00,533,2410,5630,8040
2022/04/05,13:30:00,533.51,2376,5800,8176
2022/04/05,14:00:00,532.49,2367,5935,8302
2022/04/05,14:30:00,533.76,2246,6157,8403
2022/04/05,15:00:00,533.25,2102,6283,8385
2022/04/05,15:30:00,532.74,1873,6387,8260
2022/04/05,16:00:00,532.74,1646,6658,8304
2022/04/05,16:30:00,534.02,1452,6910,8362
2022/04/05,17:00:00,533.51,1083,7269,8352
2022/04/05,17:30:00,533.25,698,7585,8283
2022/04/05,18:00:00,532.74,475,7702,8177
2022/04/05,18:30:00,533.25,452,8072,8524
2022/04/05,19:00:00,533.25,57,8250,8307
2022/04/05,19:30:00,533,2,8321,8323
2022/04/05,20:00:00,533.25,1,8384,8385
2022/04/05,20:30:00,532.74,6,8377,8383
2022/04/05,21:00:00,532.74,6,8252,8258
2022/04/05,21:30:00,533.76,4,8140,8144
2022/04/05,22:00:00,532.74,10,7946,7956
2022/04/05,22:30:00,533.25,9,7817,7826
2022/04/05,23:00:00,532.74,17,7515,7532
2022/04/05,23:30:00,533,11,7203,7214
2022/04/06,00:00:00,533,10,6942,6952
2022/04/06,00:30:00,533,12,6728,6740
2022/04/06,01:00:00,533,11,6447,6458
2022/04/06,01:30:00,532.74,12,6305,6317
2022/04/06,02:00:00,532.74,16,6164,6180
2022/04/06,02:30:00,533.25,16,6083,6099
2022/04/06,03:00:00,533.25,13,5980,5993
2022/04/06,03:30:00,532.74,10,5910,5920
2022/04/06,04:00:00,533.25,15,5980,5995
2022/04/06,04:30:00,532.74,14,6015,6029
2022/04/06,05:00:00,533.25,18,6161,6179
2022/04/06,05:30:00,533.25,18,6268,6286
2022/04/06,06:00:00,533,16,6329,6345
2022/04/06,06:30:00,533,20,6495,6515
2022/04/06,07:00:00,532.74,38,6610,6648
2022/04/06,07:30:00,533.51,226,6800,7026
2022/04/06,08:00:00,533,531,6648,7179
2022/04/06,08:30:00,533,862,6502,7364
2022/04/06,09:00:00,533,1152,6325,7477
2022/04/06,09:30:00,533,1424,6210,7634
2022/04/06,10:00:00,532.74,1830,6108,7938
2022/04/06,10:30:00,533,2067,6371,8438
2022/04/06,11:00:00,532.49,2184,6327,8511
2022/04/06,11:30:00,533,2229,6240,8469
2022/04/06,12:00:00,532.74,2242,6173,8415
2022/04/06,12:30:00,532.74,2247,6135,8382
2022/04/06,13:00:00,532.74,2288,6149,8437
2022/04/06,13:30:00,532.74,2298,6144,8442
2022/04/06,14:00:00,533,2294,6163,8457
2022/04/06,14:30:00,532.74,2290,6081,8371
2022/04/06,15:00:00,533.25,2118,6222,8340
2022/04/06,15:30:00,533,2004,6169,8173
2022/04/06,16:00:00,519.14,1739,6300,8039
2022/04/06,16:30:00,512.75,1479,6574,8053
2022/04/06,17:00:00,511.91,1216,6885,8101
2022/04/06,17:30:00,512.33,939,7164,8103
2022/04/06,18:00:00,512.75,584,7538,8122
2022/04/06,18:30:00,512.75,353,7842,8195
2022/04/06,19:00:00,512.54,121,8034,8155
2022/04/06,19:30:00,512.54,120,8121,8241
2022/04/06,20:00:00,512.33,118,8209,8327
2022/04/06,20:30:00,512.96,112,8205,8317
2022/04/06,21:00:00,512.33,82,8119,8201
2022/04/06,21:30:00,512.54,83,7980,8063
2022/04/06,22:00:00,513.6,83,7718,7801
2022/04/06,22:30:00,533.51,83,7540,7623
2022/04/06,23:00:00,533.51,79,7299,7378
2022/04/06,23:30:00,533.51,80,7020,7100
2022/04/07,00:00:00,533.51,79,6778,6857
2022/04/07,00:30:00,533.51,78,6543,6621
2022/04/07,01:00:00,533.51,79,6283,6362
2022/04/07,01:30:00,533.25,75,6123,6198
2022/04/07,02:00:00,533.25,78,5975,6053
2022/04/07,02:30:00,533.25,79,6112,6191
2022/04/07,03:00:00,533.25,78,6031,6109
2022/04/07,03:30:00,533.76,74,6023,6097
2022/04/07,04:00:00,533.51,75,6078,6153
2022/04/07,04:30:00,533.51,74,6165,6239
2022/04/07,05:00:00,533.25,74,6143,6217
2022/04/07,05:30:00,533.51,72,6119,6191
2022/04/07,06:00:00,533.51,72,6184,6256
2022/04/07,06:30:00,533.51,72,6222,6294
2022/04/07,07:00:00,533.51,83,6350,6433
2022/04/07,07:30:00,533.51,340,6459,6799
2022/04/07,08:00:00,533.51,633,6283,6916
2022/04/07,08:30:00,533.25,937,6115,7052
2022/04/07,09:00:00,533.25,1228,6030,7258
2022/04/07,09:30:00,533.25,1420,5839,7259
2022/04/07,10:00:00,533.76,1686,5774,7460
2022/04/07,10:30:00,533.76,2031,5537,7568
2022/04/07,11:00:00,533.76,2239,5454,7693
2022/04/07,11:30:00,533.25,2331,5426,7757
2022/04/07,12:00:00,533.25,2373,5430,7803
2022/04/07,12:30:00,533.25,2412,5498,7910
2022/04/07,13:00:00,533.25,2293,5645,7938
2022/04/07,13:30:00,533.51,2189,5706,7895
2022/04/07,14:00:00,533.51,1977,5827,7804
2022/04/07,14:30:00,533.51,1950,5962,7912
2022/04/07,15:00:00,533.51,1592,6309,7901
2022/04/07,15:30:00,533.51,1318,6434,7752
2022/04/07,16:00:00,533.51,1071,6673,7744
2022/04/07,16:30:00,515.55,806,6989,7795
2022/04/07,17:00:00,513.17,659,7141,7800
2022/04/07,17:30:00,512.54,606,7396,8002
2022/04/07,18:00:00,512.54,351,7640,7991
2022/04/07,18:30:00,508.48,228,7908,8136
2022/04/07,19:00:00,498.74,14,8077,8091
2022/04/07,19:30:00,498.31,24,8152,8176
2022/04/07,20:00:00,498.17,19,8225,8244
2022/04/07,20:30:00,498.45,17,8225,8242
2022/04/07,21:00:00,498.31,13,8102,8115
2022/04/07,21:30:00,497.75,12,7970,7982
2022/04/07,22:00:00,503.33,15,7767,7782
2022/04/07,22:30:00,506.94,12,7615,7627
2022/04/07,23:00:00,507.71,12,7394,7406
2022/04/07,23:30:00,507.13,21,7186,7207
2022/04/08,00:00:00,515.11,20,7027,7047
2022/04/08,00:30:00,533.51,18,6783,6801
2022/04/08,01:00:00,533.25,21,6607,6628
2022/04/08,01:30:00,533.25,22,6408,6430
2022/04/08,02:00:00,533.25,25,6291,6316
2022/04/08,02:30:00,532.74,21,6168,6189
2022/04/08,03:00:00,533.25,16,6060,6076
2022/04/08,03:30:00,533,11,6045,6056
2022/04/08,04:00:00,533,16,6030,6046
2022/04/08,04:30:00,533,17,6095,6112
2022/04/08,05:00:00,533.51,9,6168,6177
2022/04/08,05:30:00,533.51,7,6186,6193
2022/04/08,06:00:00,533,6,6250,6256
2022/04/08,06:30:00,533,5,6115,6120
2022/04/08,07:00:00,533,14,6153,6167
2022/04/08,07:30:00,533,175,6218,6393
2022/04/08,08:00:00,533,347,6205,6552
2022/04/08,08:30:00,533,615,6169,6784
2022/04/08,09:00:00,533.25,904,6190,7094
2022/04/08,09:30:00,533.25,1055,6183,7238
2022/04/08,10:00:00,532.74,1185,5811,6996
2022/04/08,10:30:00,532.74,1437,5825,7262
2022/04/08,11:00:00,533.25,1750,5857,7607
2022/04/08,11:30:00,532.74,1898,5764,7662
2022/04/08,12:00:00,533.25,1977,5641,7618
2022/04/08,12:30:00,533.25,1995,5614,7609
2022/04/08,13:00:00,533.25,1956,5575,7531
2022/04/08,13:30:00,532.74,1833,5680,7513
2022/04/08,14:00:00,533.25,1788,5854,7642
2022/04/08,14:30:00,532.74,1497,6161,7658
2022/04/08,15:00:00,529.21,1318,6381,7699
2022/04/08,15:30:00,515.77,1061,6693,7754
2022/04/08,16:00:00,516.21,829,7039,7868
2022/04/08,16:30:00,503.85,614,7129,7743
2022/04/08,17:00:00,498.59,497,7424,7921
2022/04/08,17:30:00,495.23,412,7726,8138
2022/04/08,18:00:00,495.18,326,7942,8268
2022/04/08,18:30:00,501.01,197,7992,8189
2022/04/08,19:00:00,508.48,70,7802,7872
2022/04/08,19:30:00,511.29,79,7701,7780
2022/04/08,20:00:00,523.11,83,7570,7653
2022/04/08,20:30:00,534.28,87,7412,7499
2022/04/08,21:00:00,533,75,7232,7307
2022/04/08,21:30:00,533,79,7111,7190
2022/04/08,22:00:00,533,79,6966,7045
2022/04/08,22:30:00,532.74,75,6837,6912
2022/04/08,23:00:00,532.74,75,6666,6741
2022/04/08,23:30:00,532.74,77,6535,6612
2022/04/09,00:00:00,532.74,76,6355,6431
2022/04/09,00:30:00,533.51,75,6180,6255
2022/04/09,01:00:00,533,76,6025,6101
2022/04/09,01:30:00,533.25,76,5917,5993
2022/04/09,02:00:00,533,76,5762,5838
2022/04/09,02:30:00,533,75,5668,5743
2022/04/09,03:00:00,533,55,5641,5696
2022/04/09,03:30:00,533,54,5620,5674
2022/04/09,04:00:00,533,35,5663,5698
2022/04/09,04:30:00,533,43,5674,5717
2022/04/09,05:00:00,533,42,5670,5712
2022/04/09,05:30:00,533,32,5724,5756
2022/04/09,06:00:00,533,21,5719,5740
2022/04/09,06:30:00,533.25,41,5550,5591
2022/04/09,07:00:00,532.74,52,5522,5574
2022/04/09,07:30:00,532.74,345,5457,5802
2022/04/09,08:00:00,532.23,579,5224,5803
2022/04/09,08:30:00,532.49,926,4975,5901
2022/04/09,09:00:00,532.49,1478,4564,6042
2022/04/09,09:30:00,532.49,1741,4349,6090
2022/04/09,10:00:00,532.74,1934,4278,6212
2022/04/09,10:30:00,533,2076,4168,6244
2022/04/09,11:00:00,533,2214,4120,6334
2022/04/09,11:30:00,533,2434,4042,6476
2022/04/09,12:00:00,533,2498,3980,6478
2022/04/09,12:30:00,533,2503,4004,6507
2022/04/09,13:00:00,533,2494,4023,6517
2022/04/09,13:30:00,533,2461,4052,6513
2022/04/09,14:00:00,533,2446,4132,6578
2022/04/09,14:30:00,533,2407,4159,6566
2022/04/09,15:00:00,533,2243,4192,6435
2022/04/09,15:30:00,533,2132,4349,6481
2022/04/09,16:00:00,533,1959,4580,6539
2022/04/09,16:30:00,533,1751,4953,6704
2022/04/09,17:00:00,533,1370,5379,6749
2022/04/09,17:30:00,533,1017,5919,6936
2022/04/09,18:00:00,533.25,673,6511,7184
2022/04/09,18:30:00,533.25,406,7048,7454
2022/04/09,19:00:00,532.74,121,7077,7198
2022/04/09,19:30:00,533,114,7252,7366
2022/04/09,20:00:00,532.74,115,7585,7700
2022/04/09,20:30:00,532.49,112,7701,7813
2022/04/09,21:00:00,517.32,88,7709,7797
2022/04/09,21:30:00,515.99,7,7675,7682
2022/04/09,22:00:00,517.32,2,7560,7562
2022/04/09,22:30:00,526.74,0,7443,7443
2022/04/09,23:00:00,517.1,0,7238,7238
2022/04/09,23:30:00,516.21,0,6995,6995
2022/04/10,00:00:00,521.93,0,6781,6781
2022/04/10,00:30:00,534.02,0,6529,6529
2022/04/10,01:00:00,533.51,3,6254,6257
2022/04/10,01:30:00,533.76,3,6066,6069
2022/04/10,02:00:00,533.76,0,5863,5863
2022/04/10,02:30:00,533.76,0,5743,5743
2022/04/10,03:00:00,533.76,1,5643,5644
2022/04/10,03:30:00,533.76,0,5605,5605
2022/04/10,04:00:00,533.76,0,5655,5655
2022/04/10,04:30:00,533.76,0,5765,5765
2022/04/10,05:00:00,533.51,1,5808,5809
2022/04/10,05:30:00,533.76,5,5991,5996
2022/04/10,06:00:00,533.76,1,5990,5991
2022/04/10,06:30:00,533.25,0,6122,6122
2022/04/10,07:00:00,533.76,8,6193,6201
2022/04/10,07:30:00,533.76,291,6266,6557
2022/04/10,08:00:00,533.25,574,6000,6574
2022/04/10,08:30:00,533.51,842,6050,6892
2022/04/10,09:00:00,533.76,1262,5912,7174
2022/04/10,09:30:00,534.02,1518,5808,7326
2022/04/10,10:00:00,533.51,1810,5605,7415
2022/04/10,10:30:00,533.51,1954,5504,7458
2022/04/10,11:00:00,533.76,2105,5387,7492
2022/04/10,11:30:00,533.76,2240,5233,7473
2022/04/10,12:00:00,533.76,2342,5319,7661
2022/04/10,12:30:00,533.25,2335,5309,7644
2022/04/10,13:00:00,533.51,2363,5390,7753
2022/04/10,13:30:00,533.25,2337,5522,7859
2022/04/10,14:00:00,533.76,2298,5602,7900
2022/04/10,14:30:00,533.76,2209,5713,7922
2022/04/10,15:00:00,533.76,1974,5827,7801
2022/04/10,15:30:00,533.76,1888,6013,7901
2022/04/10,16:00:00,533.76,1590,6263,7853
2022/04/10,16:30:00,533.25,1396,6558,7954
2022/04/10,17:00:00,533.76,1128,6715,7843
2022/04/10,17:30:00,533.76,793,6964,7757
2022/04/10,18:00:00,533.51,439,7399,7838
2022/04/10,18:30:00,533.76,228,7798,8026
2022/04/10,19:00:00,534.02,22,8031,8053
2022/04/10,19:30:00,533.76,24,8121,8145
2022/04/10,20:00:00,533.25,23,8266,8289
2022/04/10,20:30:00,522.64,20,8299,8319
2022/04/10,21:00:00,518.45,26,8159,8185
2022/04/10,21:30:00,518,22,8098,8120
2022/04/10,22:00:00,533.25,15,7862,7877
2022/04/10,22:30:00,533,11,7746,7757
2022/04/10,23:00:00,533,12,7484,7496
2022/04/10,23:30:00,532.74,14,7204,7218
2022/04/11,00:00:00,532.74,17,6868,6885
2022/04/11,00:30:00,532.74,19,6604,6623
2022/04/11,01:00:00,532.74,15,6396,6411
2022/04/11,01:30:00,532.74,21,6217,6238
2022/04/11,02:00:00,532.49,22,6083,6105
2022/04/11,02:30:00,533,19,5912,5931
2022/04/11,03:00:00,532.74,20,5844,5864
2022/04/11,03:30:00,532.74,21,5831,5852
2022/04/11,04:00:00,533,6,5876,5882
2022/04/11,04:30:00,533,4,5977,5981
2022/04/11,05:00:00,533,1,6088,6089
2022/04/11,05:30:00,533,1,6210,6211
2022/04/11,06:00:00,533,1,6238,6239
2022/04/11,06:30:00,532.74,0,6319,6319
2022/04/11,07:00:00,533,13,6481,6494
2022/04/11,07:30:00,533,267,6582,6849
2022/04/11,08:00:00,532.74,436,6478,6914
2022/04/11,08:30:00,532.74,604,6448,7052
2022/04/11,09:00:00,532.74,785,6224,7009
2022/04/11,09:30:00,532.74,1030,6000,7030
2022/04/11,10:00:00,533,1402,5861,7263
2022/04/11,10:30:00,532.74,1764,5676,7440
2022/04/11,11:00:00,532.74,1983,5484,7467
2022/04/11,11:30:00,532.74,2176,5325,7501
2022/04/11,12:00:00,532.74,2257,5301,7558
2022/04/11,12:30:00,532.74,2302,5290,7592
2022/04/11,13:00:00,533,2345,5277,7622
2022/04/11,13:30:00,533,2359,5324,7683
2022/04/11,14:00:00,533,2338,5290,7628
2022/04/11,14:30:00,533,2333,5362,7695
2022/04/11,15:00:00,533,2140,5404,7544
2022/04/11,15:30:00,533,2009,5556,7565
2022/04/11,16:00:00,533,1706,5783,7489
2022/04/11,16:30:00,532.74,1556,6114,7670
2022/04/11,17:00:00,533.25,1211,6229,7440
2022/04/11,17:30:00,532.74,927,6747,7674
2022/04/11,18:00:00,532.74,587,7216,7803
2022/04/11,18:30:00,532.49,324,7627,7951
2022/04/11,19:00:00,533.25,109,7931,8040
2022/04/11,19:30:00,532.74,114,8040,8154
2022/04/11,20:00:00,532.74,111,8204,8315
2022/04/11,20:30:00,533.25,107,8275,8382
2022/04/11,21:00:00,532.74,104,8158,8262
2022/04/11,21:30:00,533,105,8035,8140
2022/04/11,22:00:00,533,103,7918,8021
2022/04/11,22:30:00,533,79,7753,7832
2022/04/11,23:00:00,533,81,7468,7549
2022/04/11,23:30:00,532.49,80,7228,7308
2022/04/12,00:00:00,533,78,6945,7023
2022/04/12,00:30:00,533,79,6635,6714
2022/04/12,01:00:00,532.74,78,6396,6474
2022/04/12,01:30:00,532.74,77,6360,6437
2022/04/12,02:00:00,532.74,77,6146,6223
2022/04/12,02:30:00,532.74,78,6208,6286
2022/04/12,03:00:00,533.25,79,6064,6143
2022/04/12,03:30:00,533.25,79,6047,6126
2022/04/12,04:00:00,533.25,79,6099,6178
2022/04/12,04:30:00,532.74,79,6080,6159
2022/04/12,05:00:00,533,79,6141,6220
2022/04/12,05:30:00,533,76,6250,6326
2022/04/12,06:00:00,532.23,76,6177,6253
2022/04/12,06:30:00,532.74,75,6223,6298
2022/04/12,07:00:00,532.74,89,6338,6427
2022/04/12,07:30:00,532.49,322,6436,6758
2022/04/12,08:00:00,533.51,559,6286,6845
2022/04/12,08:30:00,533,781,6202,6983
2022/04/12,09:00:00,533.25,970,6046,7016
2022/04/12,09:30:00,533.25,1033,6031,7064
2022/04/12,10:00:00,532.74,1322,5916,7238
2022/04/12,10:30:00,532.74,1542,5787,7329
2022/04/12,11:00:00,533,1814,5840,7654
2022/04/12,11:30:00,533,2007,5762,7769
2022/04/12,12:00:00,532.74,1942,5666,7608
2022/04/12,12:30:00,532.74,2166,5643,7809
2022/04/12,13:00:00,532.74,2279,5539,7818
2022/04/12,13:30:00,532.74,2103,5528,7631
2022/04/12,14:00:00,533,2067,5462,7529
2022/04/12,14:30:00,532.74,2124,5572,7696
2022/04/12,15:00:00,533,1980,5487,7467
2022/04/12,15:30:00,532.49,1899,5647,7546
2022/04/12,16:00:00,533,1736,5780,7516
2022/04/12,16:30:00,533,1567,6061,7628
2022/04/12,17:00:00,533.25,1345,6182,7527
2022/04/12,17:30:00,533,1003,6742,7745
2022/04/12,18:00:00,533,649,7197,7846
2022/04/12,18:30:00,533,414,7682,8096
2022/04/12,19:00:00,533.25,87,8042,8129
2022/04/12,19:30:00,532.49,105,8162,8267
2022/04/12,20:00:00,533.25,109,8402,8511
2022/04/12,20:30:00,532.74,109,8474,8583
2022/04/12,21:00:00,532.74,111,8331,8442
2022/04/12,21:30:00,532.74,112,8206,8318
2022/04/12,22:00:00,532.74,108,8058,8166
2022/04/12,22:30:00,532.74,75,7911,7986
2022/04/12,23:00:00,533,75,7611,7686
2022/04/12,23:30:00,533,74,7325,7399
2022/04/13,00:00:00,533,73,7003,7076
2022/04/13,00:30:00,533,73,6745,6818
2022/04/13,01:00:00,533,72,6445,6517
2022/04/13,01:30:00,533.51,73,6263,6336
2022/04/13,02:00:00,532.74,72,6053,6125
2022/04/13,02:30:00,532.49,72,5872,5944
2022/04/13,03:00:00,532.49,72,5793,5865
2022/04/13,03:30:00,533.51,73,5756,5829
2022/04/13,04:00:00,532.74,72,5786,5858
2022/04/13,04:30:00,532.74,72,5875,5947
2022/04/13,05:00:00,532.74,72,5991,6063
2022/04/13,05:30:00,532.49,72,6062,6134
2022/04/13,06:00:00,532.74,72,6141,6213
2022/04/13,06:30:00,532.49,73,6186,6259
2022/04/13,07:00:00,532.74,99,6284,6383
2022/04/13,07:30:00,533,444,6229,6673
2022/04/13,08:00:00,533,790,6016,6806
2022/04/13,08:30:00,532.74,1099,5808,6907
2022/04/13,09:00:00,532.23,1442,5745,7187
2022/04/13,09:30:00,532.49,1591,5705,7296
2022/04/13,10:00:00,532.49,1806,5625,7431
2022/04/13,10:30:00,532.49,1925,5436,7361
2022/04/13,11:00:00,532.23,2170,5308,7478
2022/04/13,11:30:00,532.74,2352,5193,7545
2022/04/13,12:00:00,533.51,2432,5128,7560
2022/04/13,12:30:00,532.74,2466,5055,7521
2022/04/13,13:00:00,532.74,2472,5091,7563
2022/04/13,13:30:00,533.51,2510,5063,7573
2022/04/13,14:00:00,533.51,2496,5071,7567
2022/04/13,14:30:00,533.76,2425,5142,7567
2022/04/13,15:00:00,533.76,2245,5181,7426
2022/04/13,15:30:00,533.76,2179,5301,7480
2022/04/13,16:00:00,534.53,1989,5534,7523
2022/04/13,16:30:00,533.25,1797,5826,7623
2022/04/13,17:00:00,533.51,1485,5953,7438
2022/04/13,17:30:00,534.53,1104,6479,7583
2022/04/13,18:00:00,533.51,717,7010,7727
2022/04/13,18:30:00,533.51,417,7627,8044
2022/04/13,19:00:00,533.51,171,7929,8100
2022/04/13,19:30:00,533.76,167,8117,8284
2022/04/13,20:00:00,513.81,154,8360,8514
2022/04/13,20:30:00,513.39,149,8461,8610
2022/04/13,21:00:00,513.39,37,8436,8473
2022/04/13,21:30:00,513.17,67,8356,8423
2022/04/13,22:00:00,513.81,132,8079,8211
2022/04/13,22:30:00,517.32,111,7867,7978
2022/04/13,23:00:00,533,125,7609,7734
2022/04/13,23:30:00,532.49,133,7280,7413
2022/04/14,00:00:00,532.49,153,6960,7113
2022/04/14,00:30:00,533,164,6686,6850
2022/04/14,01:00:00,533,35,6537,6572
2022/04/14,01:30:00,533.51,47,6274,6321
2022/04/14,02:00:00,533.51,49,6082,6131
2022/04/14,02:30:00,533.25,58,5915,5973
2022/04/14,03:00:00,532.74,71,5819,5890
2022/04/14,03:30:00,533,72,5776,5848
2022/04/14,04:00:00,533.51,72,5807,5879
2022/04/14,04:30:00,533,72,5883,5955
2022/04/14,05:00:00,532.49,72,5921,5993
2022/04/14,05:30:00,531.98,72,5987,6059
2022/04/14,06:00:00,532.74,73,6042,6115
2022/04/14,06:30:00,532.49,73,6089,6162
2022/04/14,07:00:00,533.25,105,6133,6238
2022/04/14,07:30:00,532.49,504,6028,6532
2022/04/14,08:00:00,532.49,811,5805,6616
2022/04/14,08:30:00,532.74,1227,5710,6937
2022/04/14,09:00:00,532.49,1589,5568,7157
2022/04/14,09:30:00,532.74,1885,5350,7235
2022/04/14,10:00:00,532.23,2143,5132,7275
2022/04/14,10:30:00,533,2269,5032,7301
2022/04/14,11:00:00,532.49,2351,4977,7328
2022/04/14,11:30:00,533,2572,4945,7517
2022/04/14,12:00:00,532.49,2562,4920,7482
2022/04/14,12:30:00,532.74,2569,4942,7511
2022/04/14,13:00:00,533.25,2553,5009,7562
2022/04/14,13:30:00,533.25,2538,5025,7563
2022/04/14,14:00:00,533,2516,5001,7517
2022/04/14,14:30:00,533,2460,5061,7521
2022/04/14,15:00:00,533,2226,5095,7321
2022/04/14,15:30:00,533,2229,5231,7460
2022/04/14,16:00:00,533,2015,5328,7343
2022/04/14,16:30:00,532.49,1808,5621,7429
2022/04/14,17:00:00,533.25,1391,5920,7311
2022/04/14,17:30:00,533,948,6533,7481
2022/04/14,18:00:00,532.49,530,7095,7625
2022/04/14,18:30:00,533,373,7546,7919
2022/04/14,19:00:00,515.99,107,7829,7936
2022/04/14,19:30:00,513.39,147,7969,8116
2022/04/14,20:00:00,513.39,152,8225,8377
2022/04/14,20:30:00,513.39,147,8230,8377
2022/04/14,21:00:00,531.47,145,8134,8279
2022/04/14,21:30:00,532.23,155,8005,8160
2022/04/14,22:00:00,532.49,167,7844,8011
2022/04/14,22:30:00,532.74,147,7692,7839
2022/04/14,23:00:00,532.74,189,7415,7604
2022/04/14,23:30:00,532.74,189,7140,7329
2022/04/15,00:00:00,533.25,185,6873,7058
2022/04/15,00:30:00,532.23,187,6585,6772
2022/04/15,01:00:00,532.49,181,6338,6519
2022/04/15,01:30:00,532.49,191,6063,6254
2022/04/15,02:00:00,533,148,5926,6074
2022/04/15,02:30:00,533,70,5836,5906
2022/04/15,03:00:00,533,63,5722,5785
2022/04/15,03:30:00,532.74,62,5632,5694
2022/04/15,04:00:00,533.25,72,5626,5698
2022/04/15,04:30:00,532.49,72,5658,5730
2022/04/15,05:00:00,533.25,72,5680,5752
2022/04/15,05:30:00,533,68,5682,5750
2022/04/15,06:00:00,532.49,65,5663,5728
2022/04/15,06:30:00,533.25,67,5547,5614
2022/04/15,07:00:00,533,101,5458,5559
2022/04/15,07:30:00,532.49,510,5309,5819
2022/04/15,08:00:00,532.49,758,5217,5975
2022/04/15,08:30:00,533,1124,4927,6051
2022/04/15,09:00:00,533,1477,4874,6351
2022/04/15,09:30:00,533,1790,4694,6484
2022/04/15,10:00:00,533,2109,4566,6675
2022/04/15,10:30:00,532.49,2218,4478,6696
2022/04/15,11:00:00,533,2314,4442,6756
2022/04/15,11:30:00,532.23,2492,4465,6957
2022/04/15,12:00:00,532.49,2504,4512,7016
2022/04/15,12:30:00,533.25,2514,4524,7038
2022/04/15,13:00:00,532.74,2541,4516,7057
2022/04/15,13:30:00,532.49,2504,4514,7018
2022/04/15,14:00:00,533,2495,4542,7037
2022/04/15,14:30:00,532.49,2460,4591,7051
2022/04/15,15:00:00,533,2239,4690,6929
2022/04/15,15:30:00,533,2197,4862,7059
2022/04/15,16:00:00,533,2010,4960,6970
2022/04/15,16:30:00,533,1710,5389,7099
2022/04/15,17:00:00,533,1293,5855,7148
2022/04/15,17:30:00,533,793,6558,7351
2022/04/15,18:00:00,533,518,6980,7498
2022/04/15,18:30:00,533.51,344,7192,7536
2022/04/15,19:00:00,533,197,7048,7245
2022/04/15,19:30:00,533,181,6821,7002
2022/04/15,20:00:00,533,183,6776,6959
2022/04/15,20:30:00,533,154,6665,6819
2022/04/15,21:00:00,533,132,6532,6664
2022/04/15,21:30:00,533,135,6452,6587
2022/04/15,22:00:00,532.49,138,6371,6509
2022/04/15,22:30:00,533,125,6345,6470
2022/04/15,23:00:00,532.74,119,6285,6404
2022/04/15,23:30:00,533.25,117,6223,6340
2022/04/16,00:00:00,532.74,118,6117,6235
2022/04/16,00:30:00,532.74,87,6028,6115
2022/04/16,01:00:00,533.25,37,5912,5949
2022/04/16,01:30:00,532.49,2,5802,5804
2022/04/16,02:00:00,533.25,1,5650,5651
2022/04/16,02:30:00,533.25,0,5567,5567
2022/04/16,03:00:00,533.25,1,5485,5486
2022/04/16,03:30:00,532.74,0,5452,5452
2022/04/16,04:00:00,533.25,5,5456,5461
2022/04/16,04:30:00,532.74,5,5405,5410
2022/04/16,05:00:00,532.74,10,5409,5419
2022/04/16,05:30:00,532.74,29,5404,5433
2022/04/16,06:00:00,532.74,38,5294,5332
2022/04/16,06:30:00,533.25,31,5150,5181
2022/04/16,07:00:00,532.74,34,5018,5052
2022/04/16,07:30:00,532.74,303,4784,5087
2022/04/16,08:00:00,532.74,495,4715,5210
2022/04/16,08:30:00,532.74,735,4442,5177
2022/04/16,09:00:00,532.49,1005,4274,5279
2022/04/16,09:30:00,533,1462,4040,5502
2022/04/16,10:00:00,533.25,1798,3852,5650
2022/04/16,10:30:00,532.49,1960,3707,5667
2022/04/16,11:00:00,532.74,2223,3565,5788
2022/04/16,11:30:00,533.25,2296,3568,5864
2022/04/16,12:00:00,532.49,2379,3622,6001
2022/04/16,12:30:00,533,2473,3536,6009
2022/04/16,13:00:00,533,2319,3665,5984
2022/04/16,13:30:00,532.49,2293,3718,6011
2022/04/16,14:00:00,532.49,2129,3905,6034
2022/04/16,14:30:00,533,2105,4012,6117
2022/04/16,15:00:00,532.49,2074,4082,6156
2022/04/16,15:30:00,533,1903,4207,6110
2022/04/16,16:00:00,533,1799,4497,6296
2022/04/16,16:30:00,533,1567,4816,6383
2022/04/16,17:00:00,532.74,1312,5220,6532
2022/04/16,17:30:00,532.74,964,5683,6647
2022/04/16,18:00:00,533.25,633,6198,6831
2022/04/16,18:30:00,532.74,357,6354,6711
2022/04/16,19:00:00,532.74,108,6678,6786
2022/04/16,19:30:00,532.23,116,6775,6891
2022/04/16,20:00:00,533.25,115,7039,7154
2022/04/16,20:30:00,532.74,111,7112,7223
2022/04/16,21:00:00,532.74,110,7137,7247
2022/04/16,21:30:00,533,110,7084,7194
2022/04/16,22:00:00,533,109,7004,7113
2022/04/16,22:30:00,533,110,6886,6996
2022/04/16,23:00:00,533,110,6701,6811
2022/04/16,23:30:00,533,110,6488,6598
2022/04/17,00:00:00,532.74,112,6307,6419
2022/04/17,00:30:00,533.25,110,6089,6199
2022/04/17,01:00:00,532.49,65,5899,5964
2022/04/17,01:30:00,533,12,5777,5789
2022/04/17,02:00:00,533,49,5590,5639
2022/04/17,02:30:00,533,45,5483,5528
2022/04/17,03:00:00,533,46,5363,5409
2022/04/17,03:30:00,533,45,5351,5396
2022/04/17,04:00:00,532.74,34,5398,5432
2022/04/17,04:30:00,533.25,50,5419,5469
2022/04/17,05:00:00,532.74,60,5452,5512
2022/04/17,05:30:00,533,60,5568,5628
2022/04/17,06:00:00,532.23,55,5596,5651
2022/04/17,06:30:00,533,69,5560,5629
2022/04/17,07:00:00,532.74,91,5569,5660
2022/04/17,07:30:00,532.74,371,5554,5925
2022/04/17,08:00:00,533.25,681,5461,6142
2022/04/17,08:30:00,533.51,977,5448,6425
2022/04/17,09:00:00,531.98,1280,5308,6588
2022/04/17,09:30:00,533,1525,5153,6678
2022/04/17,10:00:00,533.51,1798,5151,6949
2022/04/17,10:30:00,532.74,2010,5085,7095
2022/04/17,11:00:00,532.74,2169,4960,7129
2022/04/17,11:30:00,531.98,2303,4939,7242
2022/04/17,12:00:00,533.51,2374,4935,7309
2022/04/17,12:30:00,532.74,2365,5005,7370
2022/04/17,13:00:00,533,2378,5054,7432
2022/04/17,13:30:00,534.79,2346,5162,7508
2022/04/17,14:00:00,533.25,2305,5258,7563
2022/04/17,14:30:00,532.23,2235,5389,7624
2022/04/17,15:00:00,532.49,2074,5285,7359
2022/04/17,15:30:00,532.49,1911,5525,7436
2022/04/17,16:00:00,533,1689,5737,7426
2022/04/17,16:30:00,533,1484,6087,7571
2022/04/17,17:00:00,533.25,1185,6400,7585
2022/04/17,17:30:00,531.47,895,6804,7699
2022/04/17,18:00:00,509.07,550,7152,7702
2022/04/17,18:30:00,497.08,272,7503,7775
2022/04/17,19:00:00,494.88,48,7691,7739
2022/04/17,19:30:00,494.88,48,7685,7733
2022/04/17,20:00:00,499.32,47,7856,7903
2022/04/17,20:30:00,511.5,49,7839,7888
2022/04/17,21:00:00,533,47,7719,7766
2022/04/17,21:30:00,533.51,50,7645,7695
2022/04/17,22:00:00,533.51,50,7474,7524
2022/04/17,22:30:00,533.51,33,7346,7379
2022/04/17,23:00:00,533.51,34,7196,7230
2022/04/17,23:30:00,533.51,46,7022,7068
2022/04/18,00:00:00,533,50,6839,6889
2022/04/18,00:30:00,533,60,6652,6712
2022/04/18,01:00:00,533.51,64,6432,6496
2022/04/18,01:30:00,532.74,54,6298,6352
2022/04/18,02:00:00,533.25,63,6177,6240
2022/04/18,02:30:00,533,63,6054,6117
2022/04/18,03:00:00,533.76,49,5991,6040
2022/04/18,03:30:00,533.25,48,5947,5995
2022/04/18,04:00:00,533.25,43,5999,6042
2022/04/18,04:30:00,533.76,43,6004,6047
2022/04/18,05:00:00,532.74,49,6020,6069
2022/04/18,05:30:00,533.51,50,6160,6210
2022/04/18,06:00:00,531.98,48,6170,6218
2022/04/18,06:30:00,532.49,60,6103,6163
2022/04/18,07:00:00,531.98,68,6175,6243
2022/04/18,07:30:00,533,306,6268,6574
2022/04/18,08:00:00,533,580,6202,6782
2022/04/18,08:30:00,533,809,6093,6902
2022/04/18,09:00:00,533,1174,6088,7262
2022/04/18,09:30:00,531.73,1288,6143,7431
2022/04/18,10:00:00,532.49,1504,6051,7555
2022/04/18,10:30:00,339.84,1639,6239,7878
2022/04/18,11:00:00,340.33,1705,6138,7843
2022/04/18,11:30:00,532.49,1880,6100,7980
2022/04/18,12:00:00,535.31,1844,6247,8091
2022/04/18,12:30:00,533.76,1759,6325,8084
2022/04/18,13:00:00,533.25,1639,6608,8247
2022/04/18,13:30:00,533.51,1520,6688,8208
2022/04/18,14:00:00,530.97,1458,6730,8188
2022/04/18,14:30:00,533,1258,6830,8088
2022/04/18,15:00:00,533.25,1031,6889,7920
2022/04/18,15:30:00,532.74,901,6941,7842
2022/04/18,16:00:00,532.74,819,6977,7796
2022/04/18,16:30:00,533.51,670,7096,7766
2022/04/18,17:00:00,533.25,589,7243,7832
2022/04/18,17:30:00,531.73,399,7435,7834
2022/04/18,18:00:00,533.25,230,7543,7773
2022/04/18,18:30:00,533,28,7709,7737
2022/04/18,19:00:00,533.25,33,7828,7861
2022/04/18,19:30:00,533.25,27,7834,7861
2022/04/18,20:00:00,533.25,43,7964,8007
2022/04/18,20:30:00,533.25,33,7937,7970
2022/04/18,21:00:00,533,42,7806,7848
2022/04/18,21:30:00,533,24,7730,7754
2022/04/18,22:00:00,532.74,27,7575,7602
2022/04/18,22:30:00,533.51,8,7468,7476
2022/04/18,23:00:00,532.49,20,7271,7291
2022/04/18,23:30:00,533.25,24,7041,7065
2022/04/19,00:00:00,532.49,20,6832,6852
2022/04/19,00:30:00,533,17,6656,6673
2022/04/19,01:00:00,533.25,19,6449,6468
2022/04/19,01:30:00,533,9,6325,6334
2022/04/19,02:00:00,533,10,6153,6163
2022/04/19,02:30:00,533,6,6149,6155
2022/04/19,03:00:00,533,16,6079,6095
2022/04/19,03:30:00,533.25,27,6043,6070
2022/04/19,04:00:00,533,29,6053,6082
2022/04/19,04:30:00,533,24,6081,6105
2022/04/19,05:00:00,533,35,6071,6106
2022/04/19,05:30:00,533,50,6155,6205
2022/04/19,06:00:00,533,75,5990,6065
2022/04/19,06:30:00,533,90,6019,6109
2022/04/19,07:00:00,533,102,5993,6095
2022/04/19,07:30:00,533,336,6142,6478
2022/04/19,08:00:00,533.25,480,6180,6660
2022/04/19,08:30:00,532.23,624,6061,6685
2022/04/19,09:00:00,533,883,5981,6864
2022/04/19,09:30:00,533.51,985,5929,6914
2022/04/19,10:00:00,533,1219,5864,7083
2022/04/19,10:30:00,533,1527,5818,7345
2022/04/19,11:00:00,533,1607,5787,7394
2022/04/19,11:30:00,533,1450,5835,7285
2022/04/19,12:00:00,533.25,1757,5537,7294
2022/04/19,12:30:00,533.25,1866,5383,7249
2022/04/19,13:00:00,533.25,2104,5134,7238
2022/04/19,13:30:00,533,2230,4975,7205
2022/04/19,14:00:00,533.51,2297,4916,7213
2022/04/19,14:30:00,533,2407,4831,7238
2022/04/19,15:00:00,533.25,2231,4882,7113
2022/04/19,15:30:00,532.74,2127,5015,7142
2022/04/19,16:00:00,533.51,1956,5218,7174
2022/04/19,16:30:00,533.51,1750,5560,7310
2022/04/19,17:00:00,533,1464,5765,7229
2022/04/19,17:30:00,533,1071,6240,7311
2022/04/19,18:00:00,532.74,718,6530,7248
2022/04/19,18:30:00,533,504,6975,7479
2022/04/19,19:00:00,533,219,7253,7472
2022/04/19,19:30:00,533.51,223,7350,7573
2022/04/19,20:00:00,532.74,229,7536,7765
2022/04/19,20:30:00,532.74,229,7585,7814
2022/04/19,21:00:00,533,228,7491,7719
2022/04/19,21:30:00,533,209,7443,7652
2022/04/19,22:00:00,533.25,191,7309,7500
2022/04/19,22:30:00,532.74,170,7190,7360
2022/04/19,23:00:00,532.74,156,7006,7162
2022/04/19,23:30:00,532.74,135,6793,6928
2022/04/20,00:00:00,532.74,75,6602,6677
2022/04/20,00:30:00,533.51,45,6418,6463
2022/04/20,01:00:00,532.74,44,6204,6248
2022/04/20,01:30:00,533.51,40,6034,6074
2022/04/20,02:00:00,532.74,50,5863,5913
2022/04/20,02:30:00,533.25,57,5718,5775
2022/04/20,03:00:00,533,74,5646,5720
2022/04/20,03:30:00,533,71,5607,5678
2022/04/20,04:00:00,533,74,5638,5712
2022/04/20,04:30:00,533,77,5636,5713
2022/04/20,05:00:00,533.51,67,5685,5752
2022/04/20,05:30:00,532.74,69,5763,5832
2022/04/20,06:00:00,533.25,45,5770,5815
2022/04/20,06:30:00,532.49,45,5755,5800
2022/04/20,07:00:00,533,80,5768,5848
2022/04/20,07:30:00,533,434,5793,6227
2022/04/20,08:00:00,532.74,625,5636,6261
2022/04/20,08:30:00,532.74,847,5648,6495
2022/04/20,09:00:00,533.25,1116,5679,6795
2022/04/20,09:30:00,533,1216,5515,6731
2022/04/20,10:00:00,533.25,1428,5365,6793
2022/04/20,10:30:00,532.74,1729,5212,6941
2022/04/20,11:00:00,533.25,1856,4981,6837
2022/04/20,11:30:00,533.25,2149,4945,7094
2022/04/20,12:00:00,533.25,2127,4795,6922
2022/04/20,12:30:00,533.25,2263,4706,6969
2022/04/20,13:00:00,533.25,2341,4688,7029
2022/04/20,13:30:00,532.74,2404,4577,6981
2022/04/20,14:00:00,533,2479,4550,7029
2022/04/20,14:30:00,533,2390,4574,6964
2022/04/20,15:00:00,533,2314,4594,6908
2022/04/20,15:30:00,533,2226,4711,6937
2022/04/20,16:00:00,533,2040,4813,6853
2022/04/20,16:30:00,533,1772,5136,6908
2022/04/20,17:00:00,533,1449,5366,6815
2022/04/20,17:30:00,532.74,1091,5862,6953
2022/04/20,18:00:00,532.74,781,6327,7108
2022/04/20,18:30:00,533.25,517,6811,7328
2022/04/20,19:00:00,533.25,318,7158,7476
2022/04/20,19:30:00,532.74,224,7253,7477
2022/04/20,20:00:00,533.25,222,7523,7745
2022/04/20,20:30:00,532.74,215,7558,7773
2022/04/20,21:00:00,533.25,216,7489,7705
2022/04/20,21:30:00,532.74,213,7383,7596
2022/04/20,22:00:00,532.74,207,7204,7411
2022/04/20,22:30:00,533.25,182,7133,7315
2022/04/20,23:00:00,533,131,6968,7099
2022/04/20,23:30:00,533,55,6843,6898
2022/04/21,00:00:00,533,44,6630,6674
2022/04/21,00:30:00,533.25,38,6391,6429
2022/04/21,01:00:00,532.74,39,6182,6221
2022/04/21,01:30:00,533,20,6037,6057
2022/04/21,02:00:00,533.25,5,5854,5859
2022/04/21,02:30:00,532.74,5,5741,5746
2022/04/21,03:00:00,532.74,5,5579,5584
2022/04/21,03:30:00,532.74,8,5593,5601
2022/04/21,04:00:00,532.74,5,5604,5609
2022/04/21,04:30:00,533,4,5589,5593
2022/04/21,05:00:00,533,6,5640,5646
2022/04/21,05:30:00,532.74,6,5700,5706
2022/04/21,06:00:00,533,12,5694,5706
2022/04/21,06:30:00,532.74,25,5608,5633
2022/04/21,07:00:00,533.25,63,5555,5618
2022/04/21,07:30:00,532.49,399,5518,5917
2022/04/21,08:00:00,533.25,616,5309,5925
2022/04/21,08:30:00,533,1084,4965,6049
2022/04/21,09:00:00,533.25,1549,5120,6669
2022/04/21,09:30:00,533,1783,4910,6693
2022/04/21,10:00:00,533,2045,4735,6780
2022/04/21,10:30:00,533,2213,4579,6792
2022/04/21,11:00:00,533.51,2284,4512,6796
2022/04/21,11:30:00,533,2519,4453,6972
2022/04/21,12:00:00,533.25,2575,4401,6976
2022/04/21,12:30:00,533.25,2595,4367,6962
2022/04/21,13:00:00,533,2586,4358,6944
2022/04/21,13:30:00,533,2569,4371,6940
2022/04/21,14:00:00,533.25,2532,4409,6941
2022/04/21,14:30:00,533,2496,4436,6932
2022/04/21,15:00:00,533,2262,4506,6768
2022/04/21,15:30:00,533.25,2203,4696,6899
2022/04/21,16:00:00,533.25,2011,4937,6948
2022/04/21,16:30:00,533,1779,5277,7056
2022/04/21,17:00:00,532.74,1480,5474,6954
2022/04/21,17:30:00,533.25,1107,6091,7198
2022/04/21,18:00:00,533.25,768,6643,7411
2022/04/21,18:30:00,532.74,480,7110,7590
2022/04/21,19:00:00,533.25,281,7206,7487
2022/04/21,19:30:00,533.25,177,7073,7250
2022/04/21,20:00:00,533.25,177,7079,7256
2022/04/21,20:30:00,533.51,145,7000,7145
2022/04/21,21:00:00,533.51,144,6863,7007
2022/04/21,21:30:00,533,149,6754,6903
2022/04/21,22:00:00,532.74,145,6651,6796
2022/04/21,22:30:00,533.25,137,6547,6684
2022/04/21,23:00:00,532.74,142,6415,6557
2022/04/21,23:30:00,533.25,130,6291,6421
2022/04/22,00:00:00,533.25,126,6146,6272
2022/04/22,00:30:00,533.25,148,5932,6080
2022/04/22,01:00:00,533,164,5744,5908
2022/04/22,01:30:00,533.76,159,5641,5800
2022/04/22,02:00:00,533.51,149,5506,5655
2022/04/22,02:30:00,533,101,5455,5556
2022/04/22,03:00:00,533,35,5478,5513
2022/04/22,03:30:00,533.51,39,5433,5472
2022/04/22,04:00:00,532.74,43,5445,5488
2022/04/22,04:30:00,533.76,45,5424,5469
2022/04/22,05:00:00,533.25,46,5413,5459
2022/04/22,05:30:00,533.25,37,5420,5457
2022/04/22,06:00:00,532.74,39,5320,5359
2022/04/22,06:30:00,532.74,50,5273,5323
2022/04/22,07:00:00,532.74,89,5083,5172
2022/04/22,07:30:00,532.74,383,4871,5254
2022/04/22,08:00:00,532.74,645,4581,5226
2022/04/22,08:30:00,532.74,1091,4341,5432
2022/04/22,09:00:00,533.51,1577,3981,5558
2022/04/22,09:30:00,533.76,1675,4027,5702
2022/04/22,10:00:00,533.76,1816,3944,5760
2022/04/22,10:30:00,534.53,1907,3917,5824
2022/04/22,11:00:00,534.53,1879,4112,5991
2022/04/22,11:30:00,534.79,1883,4119,6002
2022/04/22,12:00:00,534.28,2075,4058,6133
2022/04/22,12:30:00,534.53,2246,3999,6245
2022/04/22,13:00:00,534.28,2167,3976,6143
2022/04/22,13:30:00,534.53,1955,4205,6160
2022/04/22,14:00:00,534.02,1955,4127,6082
2022/04/22,14:30:00,534.53,1976,4206,6182
2022/04/22,15:00:00,534.28,1888,4218,6106
2022/04/22,15:30:00,534.02,1573,4520,6093
2022/04/22,16:00:00,534.02,1484,4808,6292
2022/04/22,16:30:00,534.02,1288,5108,6396
2022/04/22,17:00:00,534.53,921,5549,6470
2022/04/22,17:30:00,534.02,711,6012,6723
2022/04/22,18:00:00,534.28,479,6372,6851
2022/04/22,18:30:00,534.79,264,6719,6983
2022/04/22,19:00:00,533.76,45,6950,6995
2022/04/22,19:30:00,534.02,41,7029,7070
2022/04/22,20:00:00,534.02,45,7102,7147
2022/04/22,20:30:00,534.53,20,7030,7050
2022/04/22,21:00:00,534.53,20,6960,6980
2022/04/22,21:30:00,534.28,22,6900,6922
2022/04/22,22:00:00,534.53,24,6793,6817
2022/04/22,22:30:00,534.53,51,6653,6704
2022/04/22,23:00:00,534.53,59,6487,6546
2022/04/22,23:30:00,534.53,69,6363,6432
2022/04/23,00:00:00,534.53,78,6194,6272
2022/04/23,00:30:00,534.53,77,6078,6155
2022/04/23,01:00:00,534.53,80,5915,5995
2022/04/23,01:30:00,534.28,80,5799,5879
2022/04/23,02:00:00,534.53,80,5688,5768
2022/04/23,02:30:00,534.53,79,5622,5701
2022/04/23,03:00:00,534.53,79,5541,5620
2022/04/23,03:30:00,534.53,79,5534,5613
2022/04/23,04:00:00,534.28,78,5550,5628
2022/04/23,04:30:00,534.28,78,5542,5620
2022/04/23,05:00:00,534.79,80,5511,5591
2022/04/23,05:30:00,534.79,79,5509,5588
2022/04/23,06:00:00,534.79,81,5428,5509
2022/04/23,06:30:00,534.79,81,5276,5357
2022/04/23,07:00:00,534.79,105,5146,5251
2022/04/23,07:30:00,534.02,341,5160,5501
2022/04/23,08:00:00,534.02,566,5099,5665
2022/04/23,08:30:00,534.53,814,4934,5748
2022/04/23,09:00:00,534.53,1110,4700,5810
2022/04/23,09:30:00,534.28,1406,4431,5837
2022/04/23,10:00:00,534.28,1719,4226,5945
2022/04/23,10:30:00,534.79,1962,4108,6070
2022/04/23,11:00:00,534.02,2197,3983,6180
2022/04/23,11:30:00,533.76,2331,3981,6312
2022/04/23,12:00:00,534.28,2446,3967,6413
2022/04/23,12:30:00,534.28,2449,3987,6436
2022/04/23,13:00:00,534.53,2463,4038,6501
2022/04/23,13:30:00,534.53,2406,4053,6459
2022/04/23,14:00:00,534.28,2403,4107,6510
2022/04/23,14:30:00,534.28,2349,4123,6472
2022/04/23,15:00:00,534.28,2171,4359,6530
2022/04/23,15:30:00,533.76,2035,4559,6594
2022/04/23,16:00:00,533.76,1816,4853,6669
2022/04/23,16:30:00,534.28,1597,5240,6837
2022/04/23,17:00:00,534.02,1375,5610,6985
2022/04/23,17:30:00,534.02,1049,6060,7109
2022/04/23,18:00:00,534.02,671,6528,7199
2022/04/23,18:30:00,527.72,387,6806,7193
2022/04/23,19:00:00,516.65,157,7115,7272
2022/04/23,19:30:00,515.77,172,7055,7227
2022/04/23,20:00:00,515.77,163,7315,7478
2022/04/23,20:30:00,515.99,165,7434,7599
2022/04/23,21:00:00,515.99,132,7424,7556
2022/04/23,21:30:00,532.49,124,7375,7499
2022/04/23,22:00:00,531.98,127,7291,7418
2022/04/23,22:30:00,533,128,7199,7327
2022/04/23,23:00:00,533,133,7035,7168
2022/04/23,23:30:00,533,132,6874,7006
2022/04/24,00:00:00,533,138,6689,6827
2022/04/24,00:30:00,533,145,6463,6608
2022/04/24,01:00:00,533,143,6288,6431
2022/04/24,01:30:00,532.49,95,6156,6251
2022/04/24,02:00:00,533.25,51,6018,6069
2022/04/24,02:30:00,533,65,5891,5956
2022/04/24,03:00:00,533,48,5795,5843
2022/04/24,03:30:00,533.51,41,5762,5803
2022/04/24,04:00:00,532.74,35,5771,5806
2022/04/24,04:30:00,533,26,5832,5858
2022/04/24,05:00:00,533,16,5867,5883
2022/04/24,05:30:00,533,17,6042,6059
2022/04/24,06:00:00,533,22,5998,6020
2022/04/24,06:30:00,533.51,25,6170,6195
2022/04/24,07:00:00,533,52,6373,6425
2022/04/24,07:30:00,533.25,319,6522,6841
2022/04/24,08:00:00,533.25,463,6507,6970
2022/04/24,08:30:00,532.74,621,6460,7081
2022/04/24,09:00:00,533,813,6408,7221
2022/04/24,09:30:00,533,1062,6274,7336
2022/04/24,10:00:00,532.23,1327,6161,7488
2022/04/24,10:30:00,532.74,1512,6064,7576
2022/04/24,11:00:00,532.74,1620,6127,7747
2022/04/24,11:30:00,533,1724,6070,7794
2022/04/24,12:00:00,533,1793,6021,7814
2022/04/24,12:30:00,533,1862,6010,7872
2022/04/24,13:00:00,532.74,1908,6209,8117
2022/04/24,13:30:00,532.74,1960,6228,8188
2022/04/24,14:00:00,533,1960,6244,8204
2022/04/24,14:30:00,533,1879,6292,8171
2022/04/24,15:00:00,533,1775,6409,8184
2022/04/24,15:30:00,533,1612,6384,7996
2022/04/24,16:00:00,533,1439,6640,8079
2022/04/24,16:30:00,533.25,1181,6931,8112
2022/04/24,17:00:00,533.51,896,7159,8055
2022/04/24,17:30:00,533,644,7403,8047
2022/04/24,18:00:00,532.74,393,7683,8076
2022/04/24,18:30:00,532.74,268,7953,8221
2022/04/24,19:00:00,532.74,43,8157,8200
2022/04/24,19:30:00,530.47,42,8218,8260
2022/04/24,20:00:00,516.65,40,8393,8433
2022/04/24,20:30:00,515.77,39,8447,8486
2022/04/24,21:00:00,515.55,37,8375,8412
2022/04/24,21:30:00,515.55,38,8251,8289
2022/04/24,22:00:00,529.71,33,8063,8096
2022/04/24,22:30:00,532.23,6,7854,7860
2022/04/24,23:00:00,532.74,6,7605,7611
2022/04/24,23:30:00,532.74,5,7324,7329
2022/04/25,00:00:00,533.25,6,7015,7021
2022/04/25,00:30:00,533,6,6800,6806
2022/04/25,01:00:00,533.51,5,6580,6585
2022/04/25,01:30:00,533.51,7,6371,6378
2022/04/25,02:00:00,533.25,7,6213,6220
2022/04/25,02:30:00,533.25,5,6128,6133
2022/04/25,03:00:00,533,6,6040,6046
2022/04/25,03:30:00,533,5,6001,6006
2022/04/25,04:00:00,533.25,5,6003,6008
2022/04/25,04:30:00,533,5,6045,6050
2022/04/25,05:00:00,533,5,6120,6125
2022/04/25,05:30:00,533,6,6229,6235
2022/04/25,06:00:00,532.49,5,6184,6189
2022/04/25,06:30:00,533,11,6326,6337
2022/04/25,07:00:00,533.51,31,6470,6501
2022/04/25,07:30:00,532.49,354,6564,6918
2022/04/25,08:00:00,532.49,558,6441,6999
2022/04/25,08:30:00,531.98,824,6316,7140
2022/04/25,09:00:00,532.23,1074,6414,7488
2022/04/25,09:30:00,532.23,1327,6253,7580
2022/04/25,10:00:00,532.49,1661,6162,7823
2022/04/25,10:30:00,532.74,1930,6035,7965
2022/04/25,11:00:00,532.49,2149,5916,8065
2022/04/25,11:30:00,532.49,2263,5907,8170
2022/04/25,12:00:00,532.49,2327,5901,8228
2022/04/25,12:30:00,533,2360,5918,8278
2022/04/25,13:00:00,533,2354,6032,8386
2022/04/25,13:30:00,533,2350,6133,8483
2022/04/25,14:00:00,532.74,2281,6240,8521
2022/04/25,14:30:00,533.25,2196,6406,8602
2022/04/25,15:00:00,533,2077,6535,8612
2022/04/25,15:30:00,532.49,1919,6722,8641
2022/04/25,16:00:00,532.49,1675,6909,8584
2022/04/25,16:30:00,533,1473,7193,8666
2022/04/25,17:00:00,533,1156,7437,8593
2022/04/25,17:30:00,533,832,7634,8466
2022/04/25,18:00:00,533.25,545,7731,8276
2022/04/25,18:30:00,518,361,7949,8310
2022/04/25,19:00:00,511.91,157,8184,8341
2022/04/25,19:30:00,507.51,142,8234,8376
2022/04/25,20:00:00,498.88,115,8431,8546
2022/04/25,20:30:00,498.88,33,8593,8626
2022/04/25,21:00:00,503.68,33,8442,8475
2022/04/25,21:30:00,511.09,33,8294,8327
2022/04/25,22:00:00,511.5,33,8141,8174
2022/04/25,22:30:00,511.5,2,7944,7946
2022/04/25,23:00:00,524.31,2,7689,7691
2022/04/25,23:30:00,532.74,2,7434,7436
2022/04/26,00:00:00,533.25,2,7208,7210
2022/04/26,00:30:00,533.25,2,6926,6928
2022/04/26,01:00:00,533.51,2,6674,6676
2022/04/26,01:30:00,533,3,6473,6476
2022/04/26,02:00:00,532.74,3,6326,6329
2022/04/26,02:30:00,533,3,6218,6221
2022/04/26,03:00:00,533.25,3,6128,6131
2022/04/26,03:30:00,533,5,6108,6113
2022/04/26,04:00:00,533,4,6110,6114
2022/04/26,04:30:00,533,3,6126,6129
2022/04/26,05:00:00,533,3,6186,6189
2022/04/26,05:30:00,533,2,6335,6337
2022/04/26,06:00:00,533,2,6263,6265
2022/04/26,06:30:00,533,8,6372,6380
2022/04/26,07:00:00,533,32,6528,6560
2022/04/26,07:30:00,520.52,346,6675,7021
2022/04/26,08:00:00,515.99,509,6626,7135
2022/04/26,08:30:00,515.99,716,6515,7231
2022/04/26,09:00:00,521.93,1042,6532,7574
2022/04/26,09:30:00,531.98,1442,6351,7793
2022/04/26,10:00:00,533.51,1801,6141,7942
2022/04/26,10:30:00,532.74,2079,5992,8071
2022/04/26,11:00:00,532.49,2183,5911,8094
2022/04/26,11:30:00,533.25,2319,5944,8263
2022/04/26,12:00:00,532.74,2338,5921,8259
2022/04/26,12:30:00,533.25,2335,5988,8323
2022/04/26,13:00:00,533.25,2381,6067,8448
2022/04/26,13:30:00,532.74,2372,6206,8578
2022/04/26,14:00:00,532.74,2325,6291,8616
2022/04/26,14:30:00,532.74,2292,6405,8697
2022/04/26,15:00:00,532.74,2112,6524,8636
2022/04/26,15:30:00,533,1953,6709,8662
2022/04/26,16:00:00,533,1719,6874,8593
2022/04/26,16:30:00,533,1462,7173,8635
2022/04/26,17:00:00,533,1140,7410,8550
2022/04/26,17:30:00,532.49,820,7519,8339
2022/04/26,18:00:00,533,499,7757,8256
2022/04/26,18:30:00,525.76,324,7990,8314
2022/04/26,19:00:00,518.68,55,8217,8272
2022/04/26,19:30:00,518,47,8256,8303
2022/04/26,20:00:00,518,41,8415,8456
2022/04/26,20:30:00,532.74,40,8374,8414
2022/04/26,21:00:00,533.25,36,8289,8325
2022/04/26,21:30:00,533.25,35,8134,8169
2022/04/26,22:00:00,533,35,8053,8088
2022/04/26,22:30:00,533,4,7892,7896
2022/04/26,23:00:00,533,4,7617,7621
2022/04/26,23:30:00,533.25,4,7378,7382
2022/04/27,00:00:00,532.74,4,7135,7139
2022/04/27,00:30:00,532.74,4,6891,6895
2022/04/27,01:00:00,533.25,4,6689,6693
2022/04/27,01:30:00,532.49,5,6509,6514
2022/04/27,02:00:00,533,5,6318,6323
2022/04/27,02:30:00,532.74,6,6217,6223
2022/04/27,03:00:00,532.49,6,6134,6140
2022/04/27,03:30:00,533,6,6089,6095
2022/04/27,04:00:00,533,6,6111,6117
2022/04/27,04:30:00,533,6,6152,6158
2022/04/27,05:00:00,533,6,6191,6197
2022/04/27,05:30:00,533,5,6364,6369
2022/04/27,06:00:00,533,3,6255,6258
2022/04/27,06:30:00,533,10,6369,6379
2022/04/27,07:00:00,532.49,42,6516,6558
2022/04/27,07:30:00,533,404,6524,6928
2022/04/27,08:00:00,533,618,6335,6953
2022/04/27,08:30:00,533,873,6255,7128
2022/04/27,09:00:00,533,1198,6187,7385
2022/04/27,09:30:00,533,1493,5994,7487
2022/04/27,10:00:00,533,1790,5997,7787
2022/04/27,10:30:00,533,2021,5873,7894
2022/04/27,11:00:00,532.74,2197,5842,8039
2022/04/27,11:30:00,532.74,2258,5803,8061
2022/04/27,12:00:00,532.74,2324,5800,8124
2022/04/27,12:30:00,532.74,2361,5789,8150
2022/04/27,13:00:00,533.25,2420,5851,8271
2022/04/27,13:30:00,533.25,2412,5868,8280
2022/04/27,14:00:00,532.74,2349,5899,8248
2022/04/27,14:30:00,533,2346,6040,8386
2022/04/27,15:00:00,532.74,2197,6022,8219
2022/04/27,15:30:00,533,2085,6195,8280
2022/04/27,16:00:00,532.74,1850,6376,8226
2022/04/27,16:30:00,532.74,1601,6604,8205
2022/04/27,17:00:00,532.74,1250,6891,8141
2022/04/27,17:30:00,532.74,950,7124,8074
2022/04/27,18:00:00,532.74,634,7437,8071
2022/04/27,18:30:00,532.74,372,7686,8058
2022/04/27,19:00:00,532.74,208,7863,8071
2022/04/27,19:30:00,532.74,124,7933,8057
2022/04/27,20:00:00,532.74,127,8037,8164
2022/04/27,20:30:00,533.25,127,8041,8168
2022/04/27,21:00:00,533.25,127,7917,8044
2022/04/27,21:30:00,533.25,128,7807,7935
2022/04/27,22:00:00,532.74,125,7722,7847
2022/04/27,22:30:00,532.74,123,7568,7691
2022/04/27,23:00:00,533,123,7341,7464
2022/04/27,23:30:00,533,120,7073,7193
2022/04/28,00:00:00,533,79,6904,6983
2022/04/28,00:30:00,533,5,6752,6757
2022/04/28,01:00:00,533,5,6550,6555
2022/04/28,01:30:00,533,8,6389,6397
2022/04/28,02:00:00,533,9,6266,6275
2022/04/28,02:30:00,533,9,6298,6307
2022/04/28,03:00:00,533,9,6223,6232
2022/04/28,03:30:00,533,8,6204,6212
2022/04/28,04:00:00,532.49,7,6219,6226
2022/04/28,04:30:00,532.74,8,6260,6268
2022/04/28,05:00:00,533.25,9,6283,6292
2022/04/28,05:30:00,533.25,8,6463,6471
2022/04/28,06:00:00,533.25,7,6354,6361
2022/04/28,06:30:00,533.25,13,6349,6362
2022/04/28,07:00:00,532.74,44,6413,6457
2022/04/28,07:30:00,532.74,449,6457,6906
2022/04/28,08:00:00,532.74,673,6312,6985
2022/04/28,08:30:00,532.74,940,6111,7051
2022/04/28,09:00:00,533,1300,6131,7431
2022/04/28,09:30:00,533,1617,5949,7566
2022/04/28,10:00:00,532.74,1921,5701,7622
2022/04/28,10:30:00,532.74,2125,5643,7768
2022/04/28,11:00:00,532.49,2277,5567,7844
2022/04/28,11:30:00,533,2385,5516,7901
2022/04/28,12:00:00,533,2438,5475,7913
2022/04/28,12:30:00,533,2474,5516,7990
2022/04/28,13:00:00,519.14,2508,5587,8095
2022/04/28,13:30:00,511.7,2479,5649,8128
2022/04/28,14:00:00,511.29,2433,5697,8130
2022/04/28,14:30:00,511.29,2390,5777,8167
2022/04/28,15:00:00,511.7,2243,5777,8020
2022/04/28,15:30:00,512.75,2124,5874,7998
2022/04/28,16:00:00,514.03,1887,6075,7962
2022/04/28,16:30:00,513.81,1630,6341,7971
2022/04/28,17:00:00,513.81,1344,6601,7945
2022/04/28,17:30:00,514.24,982,6905,7887
2022/04/28,18:00:00,514.03,660,7249,7909
2022/04/28,18:30:00,513.81,473,7622,8095
2022/04/28,19:00:00,513.81,248,7843,8091
2022/04/28,19:30:00,513.81,140,7984,8124
2022/04/28,20:00:00,513.81,142,8103,8245
2022/04/28,20:30:00,513.39,141,8099,8240
2022/04/28,21:00:00,513.81,33,8084,8117
2022/04/28,21:30:00,513.6,33,7950,7983
2022/04/28,22:00:00,513.81,33,7879,7912
2022/04/28,22:30:00,532.49,5,7692,7697
2022/04/28,23:00:00,532.74,3,7508,7511
2022/04/28,23:30:00,533.25,3,7213,7216
2022/04/29,00:00:00,533.25,3,6999,7002
2022/04/29,00:30:00,532.74,3,6776,6779
2022/04/29,01:00:00,533.25,2,6583,6585
2022/04/29,01:30:00,532.74,2,6412,6414
2022/04/29,02:00:00,532.74,2,6249,6251
2022/04/29,02:30:00,532.74,2,6106,6108
2022/04/29,03:00:00,533,2,6013,6015
2022/04/29,03:30:00,533,2,5996,5998
2022/04/29,04:00:00,532.74,2,5968,5970
2022/04/29,04:30:00,533.25,2,5994,5996
2022/04/29,05:00:00,533.25,2,5983,5985
2022/04/29,05:30:00,532.74,2,6060,6062
2022/04/29,06:00:00,532.74,2,5903,5905
2022/04/29,06:30:00,533,13,5853,5866
2022/04/29,07:00:00,533,55,5782,5837
2022/04/29,07:30:00,533,505,5708,6213
2022/04/29,08:00:00,532.74,766,5451,6217
2022/04/29,08:30:00,533,1087,5529,6616
2022/04/29,09:00:00,533,1428,5391,6819
2022/04/29,09:30:00,532.49,1643,5285,6928
2022/04/29,10:00:00,533,1938,5272,7210
2022/04/29,10:30:00,533,2113,5246,7359
2022/04/29,11:00:00,532.74,2248,5223,7471
2022/04/29,11:30:00,533.51,2333,5253,7586
2022/04/29,12:00:00,532.74,2383,5281,7664
2022/04/29,12:30:00,534.28,2394,5326,7720
2022/04/29,13:00:00,533.25,2408,5371,7779
2022/04/29,13:30:00,533.25,2378,5466,7844
2022/04/29,14:00:00,532.74,2325,5457,7782
2022/04/29,14:30:00,533.51,2276,5606,7882
2022/04/29,15:00:00,532.74,2124,5740,7864
2022/04/29,15:30:00,533.25,1954,6022,7976
2022/04/29,16:00:00,532.74,1545,6326,7871
2022/04/29,16:30:00,533,1341,6575,7916
2022/04/29,17:00:00,533,928,7002,7930
2022/04/29,17:30:00,533,693,7432,8125
2022/04/29,18:00:00,533,444,7826,8270
2022/04/29,18:30:00,533,285,8089,8374
2022/04/29,19:00:00,533,122,8125,8247
2022/04/29,19:30:00,533,117,7994,8111
2022/04/29,20:00:00,532.74,117,8058,8175
2022/04/29,20:30:00,532.74,116,7942,8058
2022/04/29,21:00:00,532.74,80,7773,7853
2022/04/29,21:30:00,533.25,2,7732,7734
2022/04/29,22:00:00,533,2,7600,7602
2022/04/29,22:30:00,533,2,7441,7443
2022/04/29,23:00:00,533,2,7327,7329
2022/04/29,23:30:00,533,2,7194,7196
2022/04/30,00:00:00,533.51,7,6987,6994
2022/04/30,00:30:00,533,15,6871,6886
2022/04/30,01:00:00,533,25,6726,6751
2022/04/30,01:30:00,533,24,6597,6621
2022/04/30,02:00:00,533,45,6468,6513
2022/04/30,02:30:00,533,35,6557,6592
2022/04/30,03:00:00,533,26,6480,6506
2022/04/30,03:30:00,533,30,6452,6482
2022/04/30,04:00:00,533,39,6394,6433
2022/04/30,04:30:00,533,37,6390,6427
2022/04/30,05:00:00,533,39,6365,6404
2022/04/30,05:30:00,533,46,6354,6400
2022/04/30,06:00:00,533,46,6190,6236
2022/04/30,06:30:00,533,51,6212,6263
2022/04/30,07:00:00,533,92,6051,6143
2022/04/30,07:30:00,533,432,5949,6381
2022/04/30,08:00:00,533,663,5799,6462
2022/04/30,08:30:00,533,878,5709,6587
2022/04/30,09:00:00,533,1163,5623,6786
2022/04/30,09:30:00,533,1427,5554,6981
2022/04/30,10:00:00,533,1734,5519,7253
2022/04/30,10:30:00,533.25,1873,5551,7424
2022/04/30,11:00:00,532.74,2039,5462,7501
2022/04/30,11:30:00,533.51,2142,5424,7566
2022/04/30,12:00:00,533.51,2143,5446,7589
2022/04/30,12:30:00,532.74,2200,5379,7579
2022/04/30,13:00:00,533,2257,5357,7614
2022/04/30,13:30:00,533,2262,5396,7658
2022/04/30,14:00:00,533,2206,5443,7649
2022/04/30,14:30:00,532.74,2160,5508,7668
2022/04/30,15:00:00,532.74,2003,5655,7658
2022/04/30,15:30:00,533,1824,5874,7698
2022/04/30,16:00:00,533,1615,5953,7568
2022/04/30,16:30:00,533,1365,6101,7466
2022/04/30,17:00:00,533,1099,6387,7486
2022/04/30,17:30:00,533,801,6709,7510
2022/04/30,18:00:00,533,537,7018,7555
2022/04/30,18:30:00,533,340,7276,7616
2022/04/30,19:00:00,533,184,7503,7687
2022/04/30,19:30:00,533,86,7608,7694
2022/04/30,20:00:00,533,66,7771,7837
2022/04/30,20:30:00,533,83,7857,7940
2022/04/30,21:00:00,533,85,7915,8000
2022/04/30,21:30:00,533,90,7828,7918
2022/04/30,22:00:00,533,89,7688,7777
2022/04/30,22:30:00,533,84,7541,7625
2022/04/30,23:00:00,533,95,7327,7422
2022/04/30,23:30:00,532.74,95,7124,7219
2022/05/01,00:00:00,490.82,95,6891,6986
2022/05/01,00:30:00,490.82,94,6716,6810
2022/05/01,01:00:00,490.82,92,6521,6613
2022/05/01,01:30:00,491.05,94,6339,6433
2022/05/01,02:00:00,491.05,90,6215,6305
2022/05/01,02:30:00,491.05,92,6096,6188
2022/05/01,03:00:00,491.05,93,5990,6083
2022/05/01,03:30:00,491.05,92,5960,6052
2022/05/01,04:00:00,491.05,93,5974,6067
2022/05/01,04:30:00,491.05,94,6011,6105
2022/05/01,05:00:00,491.05,92,6058,6150
2022/05/01,05:30:00,491.05,79,6191,6270
2022/05/01,06:00:00,490.58,66,6115,6181
2022/05/01,06:30:00,491.05,58,6308,6366
2022/05/01,07:00:00,490.82,201,6467,6668
2022/05/01,07:30:00,490.82,422,6522,6944
2022/05/01,08:00:00,491.05,651,6395,7046
2022/05/01,08:30:00,488.72,851,6301,7152
2022/05/01,09:00:00,486.43,1138,6249,7387
2022/05/01,09:30:00,486.43,1460,6173,7633
2022/05/01,10:00:00,487.34,1832,5975,7807
2022/05/01,10:30:00,487.8,1947,5890,7837
2022/05/01,11:00:00,487.8,2097,5738,7835
2022/05/01,11:30:00,488.26,2206,5735,7941
2022/05/01,12:00:00,488.26,2304,5561,7865
2022/05/01,12:30:00,488.03,2334,5614,7948
2022/05/01,13:00:00,487.57,2418,5651,8069
2022/05/01,13:30:00,487.34,2442,5672,8114
2022/05/01,14:00:00,488.03,2461,5759,8220
2022/05/01,14:30:00,487.8,2416,5839,8255
2022/05/01,15:00:00,487.8,2277,5956,8233
2022/05/01,15:30:00,487.8,2126,6114,8240
2022/05/01,16:00:00,487.8,1903,6303,8206
2022/05/01,16:30:00,487.57,1633,6420,8053
2022/05/01,17:00:00,488.49,1323,6553,7876
2022/05/01,17:30:00,488.03,1011,6946,7957
2022/05/01,18:00:00,487.8,709,7342,8051
2022/05/01,18:30:00,488.03,481,7697,8178
2022/05/01,19:00:00,487.8,259,7872,8131
2022/05/01,19:30:00,488.26,163,8101,8264
2022/05/01,20:00:00,488.26,149,8263,8412
2022/05/01,20:30:00,488.26,151,8275,8426
2022/05/01,21:00:00,488.03,150,8105,8255
2022/05/01,21:30:00,488.03,152,7953,8105
2022/05/01,22:00:00,487.8,154,7867,8021
2022/05/01,22:30:00,487.57,143,7655,7798
2022/05/01,23:00:00,488.26,115,7412,7527
2022/05/01,23:30:00,487.8,42,7240,7282
2022/05/02,00:00:00,493.09,47,6939,6986
2022/05/02,00:30:00,493.55,48,6707,6755
2022/05/02,01:00:00,493.55,54,6528,6582
2022/05/02,01:30:00,493.55,49,6376,6425
2022/05/02,02:00:00,493.09,25,6254,6279
2022/05/02,02:30:00,493.09,16,6148,6164
2022/05/02,03:00:00,493.32,12,6032,6044
2022/05/02,03:30:00,493.55,11,5996,6007
2022/05/02,04:00:00,493.55,11,5978,5989
2022/05/02,04:30:00,493.32,10,6023,6033
2022/05/02,05:00:00,492.86,13,6150,6163
2022/05/02,05:30:00,493.32,9,6354,6363
2022/05/02,06:00:00,493.32,11,6267,6278
2022/05/02,06:30:00,493.55,26,6358,6384
2022/05/02,07:00:00,493.09,198,6412,6610
2022/05/02,07:30:00,493.09,445,6457,6902
2022/05/02,08:00:00,493.32,720,6351,7071
2022/05/02,08:30:00,493.32,1009,6127,7136
2022/05/02,09:00:00,493.09,1408,5934,7342
2022/05/02,09:30:00,493.09,1682,5733,7415
2022/05/02,10:00:00,498.23,1940,5541,7481
2022/05/02,10:30:00,497.99,2112,5419,7531
2022/05/02,11:00:00,498.47,2228,5332,7560
2022/05/02,11:30:00,498.47,2372,5268,7640
2022/05/02,12:00:00,498.47,2423,5285,7708
2022/05/02,12:30:00,498.47,2382,5340,7722
2022/05/02,13:00:00,497.99,2380,5470,7850
2022/05/02,13:30:00,497.99,2311,5745,8056
2022/05/02,14:00:00,498.47,2118,5998,8116
2022/05/02,14:30:00,494.71,1966,6029,7995
2022/05/02,15:00:00,485.5,1804,6196,8000
2022/05/02,15:30:00,495.41,1204,6767,7971
2022/05/02,16:00:00,495.64,836,7072,7908
2022/05/02,16:30:00,495.87,682,7114,7796
2022/05/02,17:00:00,495.64,674,7064,7738
2022/05/02,17:30:00,495.87,718,7104,7822
2022/05/02,18:00:00,496.34,403,7376,7779
2022/05/02,18:30:00,496.11,227,7553,7780
2022/05/02,19:00:00,496.11,90,7784,7874
2022/05/02,19:30:00,496.11,73,8055,8128
2022/05/02,20:00:00,496.11,68,8119,8187
2022/05/02,20:30:00,495.87,82,8034,8116
2022/05/02,21:00:00,495.87,52,7902,7954
2022/05/02,21:30:00,495.87,44,7806,7850
2022/05/02,22:00:00,495.87,35,7702,7737
2022/05/02,22:30:00,495.87,9,7521,7530
2022/05/02,23:00:00,495.87,4,7301,7305
2022/05/02,23:30:00,496.34,12,7016,7028
2022/05/03,00:00:00,496.34,6,6777,6783
2022/05/03,00:30:00,495.87,4,6567,6571
2022/05/03,01:00:00,496.34,46,6305,6351
2022/05/03,01:30:00,496.58,24,6175,6199
2022/05/03,02:00:00,495.87,9,6073,6082
2022/05/03,02:30:00,495.87,8,6095,6103
2022/05/03,03:00:00,495.41,5,6057,6062
2022/05/03,03:30:00,495.87,11,6014,6025
2022/05/03,04:00:00,495.87,23,6000,6023
2022/05/03,04:30:00,495.87,8,6126,6134
2022/05/03,05:00:00,495.87,4,6156,6160
2022/05/03,05:30:00,495.87,18,6205,6223
2022/05/03,06:00:00,496.11,24,6147,6171
2022/05/03,06:30:00,496.11,45,6261,6306
2022/05/03,07:00:00,495.87,214,6386,6600
2022/05/03,07:30:00,495.87,440,6482,6922
2022/05/03,08:00:00,495.87,681,6340,7021
2022/05/03,08:30:00,495.87,953,6285,7238
2022/05/03,09:00:00,495.87,1228,6238,7466
2022/05/03,09:30:00,495.87,1463,6201,7664
2022/05/03,10:00:00,495.87,1721,6105,7826
2022/05/03,10:30:00,496.58,1904,6186,8090
2022/05/03,11:00:00,496.11,2102,6157,8259
2022/05/03,11:30:00,496.11,2277,6185,8462
2022/05/03,12:00:00,495.87,2360,6394,8754
2022/05/03,12:30:00,495.87,2367,6401,8768
2022/05/03,13:00:00,496.34,2340,6460,8800
2022/05/03,13:30:00,496.11,2297,6728,9025
2022/05/03,14:00:00,495.87,2287,6663,8950
2022/05/03,14:30:00,496.34,2284,6686,8970
2022/05/03,15:00:00,495.87,2037,6769,8806
2022/05/03,15:30:00,495.64,1911,6846,8757
2022/05/03,16:00:00,495.87,1689,6972,8661
2022/05/03,16:30:00,495.87,1421,7186,8607
2022/05/03,17:00:00,495.64,1093,7378,8471
2022/05/03,17:30:00,496.34,700,7603,8303
2022/05/03,18:00:00,496.34,478,7630,8108
2022/05/03,18:30:00,496.11,307,7692,7999
2022/05/03,19:00:00,496.11,153,7756,7909
2022/05/03,19:30:00,495.64,74,7944,8018
2022/05/03,20:00:00,496.11,60,7869,7929
2022/05/03,20:30:00,495.87,51,7857,7908
2022/05/03,21:00:00,495.87,52,7744,7796
2022/05/03,21:30:00,495.64,53,7655,7708
2022/05/03,22:00:00,495.64,46,7602,7648
2022/05/03,22:30:00,496.11,17,7478,7495
2022/05/03,23:00:00,496.11,15,7304,7319
2022/05/03,23:30:00,496.11,17,7061,7078
2022/05/04,00:00:00,495.87,19,6866,6885
2022/05/04,00:30:00,496.11,18,6664,6682
2022/05/04,01:00:00,496.11,27,6481,6508
2022/05/04,01:30:00,496.11,24,6337,6361
2022/05/04,02:00:00,496.11,25,6200,6225
2022/05/04,02:30:00,495.64,23,6098,6121
2022/05/04,03:00:00,495.64,29,6019,6048
2022/05/04,03:30:00,496.34,25,5981,6006
2022/05/04,04:00:00,495.64,28,5971,5999
2022/05/04,04:30:00,496.11,34,6018,6052
2022/05/04,05:00:00,496.11,47,6069,6116
2022/05/04,05:30:00,495.64,42,6205,6247
2022/05/04,06:00:00,495.64,31,6204,6235
2022/05/04,06:30:00,496.11,47,6223,6270
2022/05/04,07:00:00,495.64,193,6348,6541
2022/05/04,07:30:00,496.11,349,6507,6856
2022/05/04,08:00:00,496.34,503,6476,6979
2022/05/04,08:30:00,495.87,701,6568,7269
2022/05/04,09:00:00,495.87,819,6654,7473
2022/05/04,09:30:00,495.64,1041,6536,7577
2022/05/04,10:00:00,495.87,1189,6419,7608
2022/05/04,10:30:00,495.64,1304,6269,7573
2022/05/04,11:00:00,495.87,1587,5990,7577
2022/05/04,11:30:00,495.87,1660,5888,7548
2022/05/04,12:00:00,495.87,1936,5734,7670
2022/05/04,12:30:00,495.87,1826,5809,7635
2022/05/04,13:00:00,496.34,1924,5722,7646
2022/05/04,13:30:00,495.87,1908,5678,7586
2022/05/04,14:00:00,495.87,1814,5744,7558
2022/05/04,14:30:00,495.87,1839,5639,7478
2022/05/04,15:00:00,495.87,1827,5659,7486
2022/05/04,15:30:00,496.11,1761,5687,7448
2022/05/04,16:00:00,495.64,1537,5746,7283
2022/05/04,16:30:00,496.34,1449,5770,7219
2022/05/04,17:00:00,495.87,1127,6127,7254
2022/05/04,17:30:00,495.64,811,6537,7348
2022/05/04,18:00:00,496.11,513,6851,7364
2022/05/04,18:30:00,496.11,317,7209,7526
2022/05/04,19:00:00,495.64,115,7418,7533
2022/05/04,19:30:00,496.11,118,7630,7748
2022/05/04,20:00:00,495.64,76,7685,7761
2022/05/04,20:30:00,495.64,82,7483,7565
2022/05/04,21:00:00,496.11,89,7244,7333
2022/05/04,21:30:00,495.64,92,7086,7178
2022/05/04,22:00:00,495.64,87,6921,7008
2022/05/04,22:30:00,495.87,87,6800,6887
2022/05/04,23:00:00,495.87,81,6714,6795
2022/05/04,23:30:00,495.87,83,6531,6614
2022/05/05,00:00:00,495.87,81,6368,6449
2022/05/05,00:30:00,495.87,81,6167,6248
2022/05/05,01:00:00,495.87,80,6001,6081
2022/05/05,01:30:00,495.87,80,5865,5945
2022/05/05,02:00:00,495.87,80,5673,5753
2022/05/05,02:30:00,495.87,79,5585,5664
2022/05/05,03:00:00,496.34,79,5492,5571
2022/05/05,03:30:00,496.34,81,5430,5511
2022/05/05,04:00:00,496.34,83,5404,5487
2022/05/05,04:30:00,495.64,81,5451,5532
2022/05/05,05:00:00,495.64,81,5467,5548
2022/05/05,05:30:00,496.11,80,5542,5622
2022/05/05,06:00:00,496.11,81,5397,5478
2022/05/05,06:30:00,496.11,78,5397,5475
2022/05/05,07:00:00,495.87,251,5440,5691
2022/05/05,07:30:00,495.41,531,5292,5823
2022/05/05,08:00:00,495.87,782,5179,5961
2022/05/05,08:30:00,496.11,957,5138,6095
2022/05/05,09:00:00,495.87,1037,5173,6210
2022/05/05,09:30:00,495.64,1227,5238,6465
2022/05/05,10:00:00,495.87,1391,5150,6541
2022/05/05,10:30:00,496.11,1581,5028,6609
2022/05/05,11:00:00,496.11,1793,4966,6759
2022/05/05,11:30:00,496.11,2043,4912,6955
2022/05/05,12:00:00,495.41,1968,4826,6794
2022/05/05,12:30:00,496.11,2130,4747,6877
2022/05/05,13:00:00,495.64,2087,4723,6810
2022/05/05,13:30:00,496.11,2136,4531,6667
2022/05/05,14:00:00,496.11,2142,4538,6680
2022/05/05,14:30:00,496.11,2120,4475,6595
2022/05/05,15:00:00,495.87,2091,4529,6620
2022/05/05,15:30:00,495.87,1817,4707,6524
2022/05/05,16:00:00,495.87,1817,4687,6504
2022/05/05,16:30:00,496.11,1707,4924,6631
2022/05/05,17:00:00,496.11,1449,5114,6563
2022/05/05,17:30:00,495.64,1088,5607,6695
2022/05/05,18:00:00,495.64,739,6070,6809
2022/05/05,18:30:00,495.87,488,6560,7048
2022/05/05,19:00:00,496.34,258,6940,7198
2022/05/05,19:30:00,495.64,165,7384,7549
2022/05/05,20:00:00,495.87,180,7564,7744
2022/05/05,20:30:00,496.11,182,7501,7683
2022/05/05,21:00:00,495.64,182,7448,7630
2022/05/05,21:30:00,495.64,152,7376,7528
2022/05/05,22:00:00,495.87,84,7256,7340
2022/05/05,22:30:00,495.64,82,7054,7136
2022/05/05,23:00:00,496.11,75,6859,6934
2022/05/05,23:30:00,495.64,67,6657,6724
2022/05/06,00:00:00,496.11,49,6395,6444
2022/05/06,00:30:00,496.58,48,6164,6212
2022/05/06,01:00:00,495.87,53,5965,6018
2022/05/06,01:30:00,495.87,53,5817,5870
2022/05/06,02:00:00,495.41,46,5663,5709
2022/05/06,02:30:00,495.87,39,5574,5613
2022/05/06,03:00:00,495.87,31,5478,5509
2022/05/06,03:30:00,496.11,51,5428,5479
2022/05/06,04:00:00,496.11,61,5431,5492
2022/05/06,04:30:00,496.11,81,5467,5548
2022/05/06,05:00:00,495.64,44,5559,5603
2022/05/06,05:30:00,495.87,19,5685,5704
2022/05/06,06:00:00,496.11,25,5681,5706
2022/05/06,06:30:00,496.34,35,5577,5612
2022/05/06,07:00:00,495.87,200,5628,5828
2022/05/06,07:30:00,495.87,446,5684,6130
2022/05/06,08:00:00,495.87,783,5519,6302
2022/05/06,08:30:00,496.34,992,5434,6426
2022/05/06,09:00:00,495.87,1298,5475,6773
2022/05/06,09:30:00,495.87,1315,5550,6865
2022/05/06,10:00:00,495.87,1584,5473,7057
2022/05/06,10:30:00,495.64,1732,5450,7182
2022/05/06,11:00:00,495.64,1810,5260,7070
2022/05/06,11:30:00,495.64,2020,5231,7251
2022/05/06,12:00:00,495.64,1952,5144,7096
2022/05/06,12:30:00,496.11,1956,5129,7085
2022/05/06,13:00:00,496.11,2087,4990,7077
2022/05/06,13:30:00,496.11,2176,4828,7004
2022/05/06,14:00:00,495.87,2283,4890,7173
2022/05/06,14:30:00,495.87,2305,4957,7262
2022/05/06,15:00:00,495.87,2214,4966,7180
2022/05/06,15:30:00,495.87,2040,5123,7163
2022/05/06,16:00:00,495.87,1900,5252,7152
2022/05/06,16:30:00,496.34,1741,5507,7248
2022/05/06,17:00:00,496.11,1469,5729,7198
2022/05/06,17:30:00,495.41,1117,6114,7231
2022/05/06,18:00:00,495.64,759,6622,7381
2022/05/06,18:30:00,496.11,542,7059,7601
2022/05/06,19:00:00,496.11,279,7217,7496
2022/05/06,19:30:00,496.11,174,7361,7535
2022/05/06,20:00:00,496.11,189,7413,7602
2022/05/06,20:30:00,496.11,174,7310,7484
2022/05/06,21:00:00,496.11,181,7166,7347
2022/05/06,21:30:00,496.11,169,6990,7159
2022/05/06,22:00:00,496.11,178,6894,7072
2022/05/06,22:30:00,495.64,189,6773,6962
2022/05/06,23:00:00,495.64,187,6573,6760
2022/05/06,23:30:00,496.11,169,6409,6578
2022/05/07,00:00:00,495.87,136,6292,6428
2022/05/07,00:30:00,495.87,147,6098,6245
2022/05/07,01:00:00,496.11,50,6018,6068
2022/05/07,01:30:00,495.87,44,5857,5901
2022/05/07,02:00:00,495.87,52,5763,5815
2022/05/07,02:30:00,496.11,42,5711,5753
2022/05/07,03:00:00,495.41,33,5648,5681
2022/05/07,03:30:00,495.64,41,5613,5654
2022/05/07,04:00:00,495.64,45,5562,5607
2022/05/07,04:30:00,495.64,40,5623,5663
2022/05/07,05:00:00,495.64,29,5677,5706
2022/05/07,05:30:00,495.87,33,5659,5692
2022/05/07,06:00:00,495.64,30,5543,5573
2022/05/07,06:30:00,495.64,40,5472,5512
2022/05/07,07:00:00,495.64,208,5298,5506
2022/05/07,07:30:00,495.87,524,5145,5669
2022/05/07,08:00:00,495.64,839,5014,5853
2022/05/07,08:30:00,495.87,1190,4812,6002
2022/05/07,09:00:00,495.87,1413,4810,6223
2022/05/07,09:30:00,495.87,1512,4695,6207
2022/05/07,10:00:00,495.64,1765,4553,6318
2022/05/07,10:30:00,495.64,2021,4557,6578
2022/05/07,11:00:00,495.64,2193,4419,6612
2022/05/07,11:30:00,495.64,2247,4385,6632
2022/05/07,12:00:00,495.64,2284,4303,6587
2022/05/07,12:30:00,495.64,2290,4276,6566
2022/05/07,13:00:00,495.64,2320,4186,6506
2022/05/07,13:30:00,495.41,2338,4171,6509
2022/05/07,14:00:00,495.64,2411,4145,6556
2022/05/07,14:30:00,495.87,2382,4149,6531
2022/05/07,15:00:00,495.64,2281,4197,6478
2022/05/07,15:30:00,495.87,2206,4396,6602
2022/05/07,16:00:00,495.87,1959,4644,6603
2022/05/07,16:30:00,495.64,1713,5019,6732
2022/05/07,17:00:00,495.64,1514,5322,6836
2022/05/07,17:30:00,495.87,1133,5450,6583
2022/05/07,18:00:00,495.64,758,5908,6666
2022/05/07,18:30:00,495.64,558,6386,6944
2022/05/07,19:00:00,495.64,268,6779,7047
2022/05/07,19:30:00,495.64,149,7212,7361
2022/05/07,20:00:00,487.02,145,7424,7569
2022/05/07,20:30:00,486.37,147,7642,7789
2022/05/07,21:00:00,485.94,150,7675,7825
2022/05/07,21:30:00,488.12,149,7584,7733
2022/05/07,22:00:00,495.64,144,7415,7559
2022/05/07,22:30:00,496.11,145,7241,7386
2022/05/07,23:00:00,495.64,133,7050,7183
2022/05/07,23:30:00,496.11,128,6729,6857
2022/05/08,00:00:00,495.64,128,6476,6604
2022/05/08,00:30:00,495.87,126,6203,6329
2022/05/08,01:00:00,495.87,124,5975,6099
2022/05/08,01:30:00,495.87,130,5775,5905
2022/05/08,02:00:00,496.34,129,5586,5715
2022/05/08,02:30:00,496.11,124,5493,5617
2022/05/08,03:00:00,496.11,5,5527,5532
2022/05/08,03:30:00,495.87,2,5534,5536
2022/05/08,04:00:00,495.64,2,5564,5566
2022/05/08,04:30:00,496.58,3,5593,5596
2022/05/08,05:00:00,496.11,7,5754,5761
2022/05/08,05:30:00,495.87,2,5915,5917
2022/05/08,06:00:00,496.11,3,5932,5935
2022/05/08,06:30:00,496.11,25,6075,6100
2022/05/08,07:00:00,495.87,248,6220,6468
2022/05/08,07:30:00,496.11,614,6148,6762
2022/05/08,08:00:00,495.41,1000,5917,6917
2022/05/08,08:30:00,495.87,1308,5879,7187
2022/05/08,09:00:00,495.87,1569,5775,7344
2022/05/08,09:30:00,495.87,1764,5635,7399
2022/05/08,10:00:00,495.87,1976,5490,7466
2022/05/08,10:30:00,496.11,2122,5401,7523
2022/05/08,11:00:00,496.11,2294,5405,7699
2022/05/08,11:30:00,496.11,2418,5306,7724
2022/05/08,12:00:00,496.11,2442,5335,7777
2022/05/08,12:30:00,496.11,2486,5365,7851
2022/05/08,13:00:00,495.87,2459,5402,7861
2022/05/08,13:30:00,496.58,2482,5468,7950
2022/05/08,14:00:00,496.34,2471,5521,7992
2022/05/08,14:30:00,496.11,2426,5564,7990
2022/05/08,15:00:00,495.64,2279,5674,7953
2022/05/08,15:30:00,496.11,2171,5637,7808
2022/05/08,16:00:00,494.01,1951,5719,7670
2022/05/08,16:30:00,495.64,1751,5917,7668
2022/05/08,17:00:00,496.11,1469,6190,7659
2022/05/08,17:30:00,496.11,1068,6578,7646
2022/05/08,18:00:00,496.11,732,6968,7700
2022/05/08,18:30:00,496.11,485,7343,7828
2022/05/08,19:00:00,496.11,261,7625,7886
2022/05/08,19:30:00,495.64,162,7934,8096
2022/05/08,20:00:00,480.89,158,8165,8323
2022/05/08,20:30:00,480.28,159,8160,8319
2022/05/08,21:00:00,479.88,152,7982,8134
2022/05/08,21:30:00,494.47,142,7901,8043
2022/05/08,22:00:00,495.64,136,7785,7921
2022/05/08,22:30:00,496.58,142,7552,7694
2022/05/08,23:00:00,496.11,135,7253,7388
2022/05/08,23:30:00,495.87,134,6959,7093
2022/05/09,00:00:00,496.34,132,6664,6796
2022/05/09,00:30:00,495.87,130,6351,6481
2022/05/09,01:00:00,495.87,126,6152,6278
2022/05/09,01:30:00,495.87,134,5980,6114
2022/05/09,02:00:00,496.11,95,5856,5951
2022/05/09,02:30:00,496.11,45,5801,5846
2022/05/09,03:00:00,496.34,6,5753,5759
2022/05/09,03:30:00,496.11,2,5719,5721
2022/05/09,04:00:00,496.34,2,5749,5751
2022/05/09,04:30:00,495.87,2,5820,5822
2022/05/09,05:00:00,496.34,2,5917,5919
2022/05/09,05:30:00,495.87,2,6118,6120
2022/05/09,06:00:00,496.34,2,6081,6083
2022/05/09,06:30:00,495.87,100,6317,6417
2022/05/09,07:00:00,495.41,218,6393,6611
2022/05/09,07:30:00,496.11,512,6486,6998
2022/05/09,08:00:00,496.34,781,6266,7047
2022/05/09,08:30:00,495.64,1061,6441,7502
2022/05/09,09:00:00,496.11,1416,6128,7544
2022/05/09,09:30:00,495.87,1704,5963,7667
2022/05/09,10:00:00,496.11,1914,5835,7749
2022/05/09,10:30:00,496.11,2079,5882,7961
2022/05/09,11:00:00,496.11,2203,5935,8138
2022/05/09,11:30:00,496.11,2302,5904,8206
2022/05/09,12:00:00,496.11,2394,5873,8267
2022/05/09,12:30:00,495.64,2415,5885,8300
2022/05/09,13:00:00,495.64,2439,5946,8385
2022/05/09,13:30:00,495.87,2389,6047,8436
2022/05/09,14:00:00,495.64,2386,6104,8490
2022/05/09,14:30:00,495.87,2305,6243,8548
2022/05/09,15:00:00,495.87,2056,6423,8479
2022/05/09,15:30:00,495.64,1981,6499,8480
2022/05/09,16:00:00,495.87,1741,6517,8258
2022/05/09,16:30:00,495.87,1526,6775,8301
2022/05/09,17:00:00,495.87,1211,6905,8116
2022/05/09,17:30:00,496.34,878,7219,8097
2022/05/09,18:00:00,496.34,598,7490,8088
2022/05/09,18:30:00,495.87,428,7722,8150
2022/05/09,19:00:00,496.34,234,7869,8103
2022/05/09,19:30:00,495.87,129,8171,8300
2022/05/09,20:00:00,496.34,137,8341,8478
2022/05/09,20:30:00,495.87,148,8268,8416
2022/05/09,21:00:00,496.34,145,8134,8279
2022/05/09,21:30:00,496.34,151,8003,8154
2022/05/09,22:00:00,496.34,134,7847,7981
2022/05/09,22:30:00,496.34,68,7700,7768
2022/05/09,23:00:00,495.64,18,7466,7484
2022/05/09,23:30:00,496.34,14,7233,7247
2022/05/10,00:00:00,495.87,14,6870,6884
2022/05/10,00:30:00,496.34,26,6635,6661
2022/05/10,01:00:00,496.11,35,6457,6492
2022/05/10,01:30:00,496.11,46,6246,6292
2022/05/10,02:00:00,496.11,69,6083,6152
2022/05/10,02:30:00,495.64,68,5986,6054
2022/05/10,03:00:00,496.11,58,5920,5978
2022/05/10,03:30:00,495.87,46,5875,5921
2022/05/10,04:00:00,496.34,33,5900,5933
2022/05/10,04:30:00,496.11,19,5980,5999
2022/05/10,05:00:00,496.11,16,6144,6160
2022/05/10,05:30:00,495.64,15,6304,6319
2022/05/10,06:00:00,496.34,18,6289,6307
2022/05/10,06:30:00,496.34,46,6410,6456
2022/05/10,07:00:00,496.81,226,6525,6751
2022/05/10,07:30:00,496.11,536,6510,7046
2022/05/10,08:00:00,496.11,817,6415,7232
2022/05/10,08:30:00,495.87,1216,6358,7574
2022/05/10,09:00:00,495.87,1606,6136,7742
2022/05/10,09:30:00,496.34,1842,6018,7860
2022/05/10,10:00:00,496.34,2103,5732,7835
2022/05/10,10:30:00,496.11,2302,5699,8001
2022/05/10,11:00:00,496.11,2432,5631,8063
2022/05/10,11:30:00,496.34,2563,5587,8150
2022/05/10,12:00:00,496.34,2635,5711,8346
2022/05/10,12:30:00,496.34,2662,5714,8376
2022/05/10,13:00:00,496.34,2665,5726,8391
2022/05/10,13:30:00,496.11,2659,5809,8468
2022/05/10,14:00:00,496.81,2623,5921,8544
2022/05/10,14:30:00,496.34,2596,5953,8549
2022/05/10,15:00:00,496.34,2411,6045,8456
2022/05/10,15:30:00,497.05,2297,6193,8490
2022/05/10,16:00:00,496.58,1976,6377,8353
2022/05/10,16:30:00,495.64,1740,6534,8274
2022/05/10,17:00:00,496.11,1520,6709,8229
2022/05/10,17:30:00,496.11,1192,6989,8181
2022/05/10,18:00:00,496.58,783,7153,7936
2022/05/10,18:30:00,496.58,596,7487,8083
2022/05/10,19:00:00,496.58,306,7693,7999
2022/05/10,19:30:00,496.58,190,8040,8230
2022/05/10,20:00:00,496.58,184,8229,8413
2022/05/10,20:30:00,496.58,190,8200,8390
2022/05/10,21:00:00,496.58,197,8050,8247
2022/05/10,21:30:00,496.11,196,7970,8166
2022/05/10,22:00:00,496.58,196,7782,7978
2022/05/10,22:30:00,495.87,196,7580,7776
2022/05/10,23:00:00,496.58,166,7347,7513
2022/05/10,23:30:00,495.87,162,7069,7231
2022/05/11,00:00:00,496.11,157,6725,6882
2022/05/11,00:30:00,496.11,157,6520,6677
2022/05/11,01:00:00,496.34,159,6282,6441
2022/05/11,01:30:00,496.34,167,6104,6271
2022/05/11,02:00:00,496.11,159,5942,6101
2022/05/11,02:30:00,496.34,96,5939,6035
2022/05/11,03:00:00,496.11,33,5913,5946
2022/05/11,03:30:00,496.11,35,5865,5900
2022/05/11,04:00:00,496.58,49,5862,5911
2022/05/11,04:30:00,496.11,54,5960,6014
2022/05/11,05:00:00,496.11,46,6078,6124
2022/05/11,05:30:00,496.11,65,6195,6260
2022/05/11,06:00:00,496.58,62,6094,6156
2022/05/11,06:30:00,496.58,60,6345,6405
2022/05/11,07:00:00,496.34,254,6426,6680
2022/05/11,07:30:00,496.34,488,6459,6947
2022/05/11,08:00:00,496.34,828,6214,7042
2022/05/11,08:30:00,496.11,1179,5945,7124
2022/05/11,09:00:00,496.11,1504,6208,7712
2022/05/11,09:30:00,495.17,1762,5967,7729
2022/05/11,10:00:00,493.78,1987,5918,7905
2022/05/11,10:30:00,493.78,2083,5968,8051
2022/05/11,11:00:00,494.24,2074,6010,8084
2022/05/11,11:30:00,493.55,2157,5929,8086
2022/05/11,12:00:00,493.78,2267,5962,8229
2022/05/11,12:30:00,494.24,2226,6010,8236
2022/05/11,13:00:00,494.01,2207,6067,8274
2022/05/11,13:30:00,495.41,2310,6152,8462
2022/05/11,14:00:00,494.94,2371,6063,8434
2022/05/11,14:30:00,495.17,2375,6064,8439
2022/05/11,15:00:00,495.41,2188,6139,8327
2022/05/11,15:30:00,494.94,2099,6166,8265
2022/05/11,16:00:00,495.41,1818,6265,8083
2022/05/11,16:30:00,494.94,1638,6406,8044
2022/05/11,17:00:00,495.41,1395,6648,8043
2022/05/11,17:30:00,490.58,993,6955,7948
2022/05/11,18:00:00,476.93,671,7342,8013
2022/05/11,18:30:00,476.74,498,7560,8058
2022/05/11,19:00:00,477.13,265,7869,8134
2022/05/11,19:30:00,462.78,110,8207,8317
2022/05/11,20:00:00,461.68,131,8400,8531
2022/05/11,20:30:00,461.68,136,8381,8517
2022/05/11,21:00:00,466.06,152,8217,8369
2022/05/11,21:30:00,474.19,164,8028,8192
2022/05/11,22:00:00,484.86,171,7875,8046
2022/05/11,22:30:00,495.87,166,7652,7818
2022/05/11,23:00:00,495.87,166,7378,7544
2022/05/11,23:30:00,496.58,169,7101,7270
2022/05/12,00:00:00,496.34,176,6784,6960
2022/05/12,00:30:00,496.34,182,6494,6676
2022/05/12,01:00:00,495.87,179,6297,6476
2022/05/12,01:30:00,495.87,136,6166,6302
2022/05/12,02:00:00,495.87,67,6050,6117
2022/05/12,02:30:00,495.87,65,5971,6036
2022/05/12,03:00:00,496.34,58,5921,5979
2022/05/12,03:30:00,496.34,56,5879,5935
2022/05/12,04:00:00,495.87,41,5902,5943
2022/05/12,04:30:00,495.87,28,5992,6020
2022/05/12,05:00:00,495.87,28,6102,6130
2022/05/12,05:30:00,495.87,28,6277,6305
2022/05/12,06:00:00,495.87,31,6215,6246
2022/05/12,06:30:00,495.87,46,6508,6554
2022/05/12,07:00:00,495.87,240,6627,6867
2022/05/12,07:30:00,495.41,565,6664,7229
2022/05/12,08:00:00,495.87,841,6413,7254
2022/05/12,08:30:00,495.64,1166,6262,7428
2022/05/12,09:00:00,495.64,1523,6007,7530
2022/05/12,09:30:00,496.34,1803,5812,7615
2022/05/12,10:00:00,495.87,2147,5671,7818
2022/05/12,10:30:00,495.87,2274,5567,7841
2022/05/12,11:00:00,495.87,2392,5645,8037
2022/05/12,11:30:00,495.64,2499,5646,8145
2022/05/12,12:00:00,495.87,2598,5595,8193
2022/05/12,12:30:00,495.87,2633,5419,8052
2022/05/12,13:00:00,495.87,2643,5672,8315
2022/05/12,13:30:00,496.34,2596,5747,8343
2022/05/12,14:00:00,495.87,2542,5663,8205
2022/05/12,14:30:00,495.87,2524,5747,8271
2022/05/12,15:00:00,495.87,2319,5868,8187
2022/05/12,15:30:00,495.87,2200,5995,8195
2022/05/12,16:00:00,495.87,1937,6113,8050
2022/05/12,16:30:00,495.87,1693,6252,7945
2022/05/12,17:00:00,495.87,1365,6460,7825
2022/05/12,17:30:00,495.87,1051,6823,7874
2022/05/12,18:00:00,495.17,754,7232,7986
2022/05/12,18:30:00,495.87,527,7424,7951
2022/05/12,19:00:00,495.87,325,7639,7964
2022/05/12,19:30:00,478.49,316,7848,8164
2022/05/12,20:00:00,470.33,200,8179,8379
2022/05/12,20:30:00,467.95,198,8122,8320
2022/05/12,21:00:00,467.95,169,8009,8178
2022/05/12,21:30:00,475.42,57,7958,8015
2022/05/12,22:00:00,495.17,51,7809,7860
2022/05/12,22:30:00,495.64,18,7678,7696
2022/05/12,23:00:00,496.58,22,7420,7442
2022/05/12,23:30:00,495.87,18,7129,7147
2022/05/13,00:00:00,496.34,9,6912,6921
2022/05/13,00:30:00,495.87,1,6700,6701
2022/05/13,01:00:00,496.11,0,6455,6455
2022/05/13,01:30:00,495.87,0,6295,6295
2022/05/13,02:00:00,495.87,0,6148,6148
2022/05/13,02:30:00,495.87,1,6042,6043
2022/05/13,03:00:00,496.34,3,5937,5940
2022/05/13,03:30:00,496.34,11,5844,5855
2022/05/13,04:00:00,495.87,8,5854,5862
2022/05/13,04:30:00,495.87,8,5885,5893
2022/05/13,05:00:00,496.11,14,5907,5921
2022/05/13,05:30:00,496.11,6,5971,5977
2022/05/13,06:00:00,496.11,6,5899,5905
2022/05/13,06:30:00,496.34,23,5886,5909
2022/05/13,07:00:00,496.34,228,5999,6227
2022/05/13,07:30:00,495.87,518,5954,6472
2022/05/13,08:00:00,495.87,748,5746,6494
2022/05/13,08:30:00,495.87,1071,5578,6649
2022/05/13,09:00:00,495.87,1446,5401,6847
2022/05/13,09:30:00,496.34,1742,5287,7029
2022/05/13,10:00:00,495.87,2004,5215,7219
2022/05/13,10:30:00,495.64,2170,5227,7397
2022/05/13,11:00:00,495.64,2299,5226,7525
2022/05/13,11:30:00,496.11,2370,5279,7649
2022/05/13,12:00:00,495.64,2427,5386,7813
2022/05/13,12:30:00,495.64,2453,5400,7853
2022/05/13,13:00:00,496.11,2453,5452,7905
2022/05/13,13:30:00,495.87,2431,5491,7922
2022/05/13,14:00:00,495.87,2365,5543,7908
2022/05/13,14:30:00,495.87,2281,5491,7772
2022/05/13,15:00:00,495.87,2091,5601,7692
2022/05/13,15:30:00,496.34,1956,5602,7558
2022/05/13,16:00:00,495.87,1737,5812,7549
2022/05/13,16:30:00,495.87,1473,6112,7585
2022/05/13,17:00:00,495.87,1107,6517,7624
2022/05/13,17:30:00,495.87,808,6967,7775
2022/05/13,18:00:00,481.71,524,7417,7941
2022/05/13,18:30:00,466.18,280,7795,8075
2022/05/13,19:00:00,463.84,117,7920,8037
2022/05/13,19:30:00,462.24,5,7969,7974
2022/05/13,20:00:00,461.68,3,8002,8005
2022/05/13,20:30:00,461.68,9,7871,7880
2022/05/13,21:00:00,466.27,2,7736,7738
2022/05/13,21:30:00,480.28,1,7570,7571
2022/05/13,22:00:00,494.71,1,7426,7427
2022/05/13,22:30:00,495.64,1,7298,7299
2022/05/13,23:00:00,495.64,1,7131,7132
2022/05/13,23:30:00,495.64,10,6934,6944
2022/05/14,00:00:00,495.17,9,6745,6754
2022/05/14,00:30:00,495.87,8,6634,6642
2022/05/14,01:00:00,495.64,11,6442,6453
2022/05/14,01:30:00,495.41,15,6351,6366
2022/05/14,02:00:00,495.64,20,6183,6203
2022/05/14,02:30:00,495.64,31,6140,6171
2022/05/14,03:00:00,495.41,43,6045,6088
2022/05/14,03:30:00,495.41,57,6060,6117
2022/05/14,04:00:00,495.41,59,6111,6170
2022/05/14,04:30:00,495.41,55,6141,6196
2022/05/14,05:00:00,495.64,60,6120,6180
2022/05/14,05:30:00,495.64,59,6129,6188
2022/05/14,06:00:00,495.64,62,6022,6084
2022/05/14,06:30:00,495.64,76,5922,5998
2022/05/14,07:00:00,495.64,255,5898,6153
2022/05/14,07:30:00,495.17,528,5854,6382
2022/05/14,08:00:00,495.87,719,5655,6374
2022/05/14,08:30:00,495.64,992,5670,6662
2022/05/14,09:00:00,495.64,1274,5539,6813
2022/05/14,09:30:00,495.17,1489,5607,7096
2022/05/14,10:00:00,495.87,1764,5617,7381
2022/05/14,10:30:00,495.87,1944,5706,7650
2022/05/14,11:00:00,495.87,2019,5796,7815
2022/05/14,11:30:00,496.11,2088,5854,7942
2022/05/14,12:00:00,495.64,2145,5892,8037
2022/05/14,12:30:00,495.41,2118,6171,8289
2022/05/14,13:00:00,495.87,1999,6375,8374
2022/05/14,13:30:00,495.41,2037,6525,8562
2022/05/14,14:00:00,485.72,2017,6698,8715
2022/05/14,14:30:00,481.3,1873,6791,8664
2022/05/14,15:00:00,470.99,1707,6960,8667
2022/05/14,15:30:00,468.25,1472,7140,8612
2022/05/14,16:00:00,467.95,1254,7353,8607
2022/05/14,16:30:00,467.95,1047,7415,8462
2022/05/14,17:00:00,467.95,782,7535,8317
2022/05/14,17:30:00,467,536,7721,8257
2022/05/14,18:00:00,463.79,377,7842,8219
2022/05/14,18:30:00,463.89,248,8025,8273
2022/05/14,19:00:00,463.84,80,8092,8172
2022/05/14,19:30:00,463.84,76,8296,8372
2022/05/14,20:00:00,463.84,77,8484,8561
2022/05/14,20:30:00,463.84,77,8528,8605
2022/05/14,21:00:00,463.84,82,8560,8642
2022/05/14,21:30:00,463.84,80,8540,8620
2022/05/14,22:00:00,463.84,79,8403,8482
2022/05/14,22:30:00,467.8,77,8220,8297
2022/05/14,23:00:00,477.32,88,7989,8077
2022/05/14,23:30:00,495.87,91,7751,7842
2022/05/15,00:00:00,496.34,91,7476,7567
2022/05/15,00:30:00,496.34,90,7225,7315
2022/05/15,01:00:00,496.58,92,7043,7135
2022/05/15,01:30:00,496.58,92,6884,6976
2022/05/15,02:00:00,496.34,89,6757,6846
2022/05/15,02:30:00,496.34,80,6639,6719
2022/05/15,03:00:00,496.58,80,6539,6619
2022/05/15,03:30:00,496.58,80,6453,6533
2022/05/15,04:00:00,496.58,72,6456,6528
2022/05/15,04:30:00,496.58,71,6451,6522
2022/05/15,05:00:00,496.58,71,6520,6591
2022/05/15,05:30:00,496.58,71,6606,6677
2022/05/15,06:00:00,496.58,72,6544,6616
2022/05/15,06:30:00,496.34,74,6742,6816
2022/05/15,07:00:00,496.34,226,6956,7182
2022/05/15,07:30:00,496.34,378,7208,7586
2022/05/15,08:00:00,496.11,550,7143,7693
2022/05/15,08:30:00,496.58,805,7215,8020
2022/05/15,09:00:00,496.58,1078,7102,8180
2022/05/15,09:30:00,496.34,1312,7172,8484
2022/05/15,10:00:00,496.34,1613,7130,8743
2022/05/15,10:30:00,496.81,1853,6905,8758
2022/05/15,11:00:00,496.58,2195,6708,8903
2022/05/15,11:30:00,496.11,2403,6566,8969
2022/05/15,12:00:00,496.11,2483,6450,8933
2022/05/15,12:30:00,496.58,2536,6451,8987
2022/05/15,13:00:00,496.81,2570,6439,9009
2022/05/15,13:30:00,496.34,2625,6418,9043
2022/05/15,14:00:00,496.34,2573,6432,9005
2022/05/15,14:30:00,496.34,2551,6450,9001
2022/05/15,15:00:00,496.34,2397,6469,8866
2022/05/15,15:30:00,496.81,2316,6606,8922
2022/05/15,16:00:00,496.34,2100,6717,8817
2022/05/15,16:30:00,496.34,1847,6914,8761
2022/05/15,17:00:00,496.11,1512,6936,8448
2022/05/15,17:30:00,496.34,1197,7137,8334
2022/05/15,18:00:00,480.48,849,7418,8267
2022/05/15,18:30:00,464.67,587,7696,8283
2022/05/15,19:00:00,463.79,331,7941,8272
2022/05/15,19:30:00,461.54,177,8210,8387
2022/05/15,20:00:00,461.68,193,8457,8650
2022/05/15,20:30:00,461.68,204,8391,8595
2022/05/15,21:00:00,463.73,207,8297,8504
2022/05/15,21:30:00,467.78,208,8192,8400
2022/05/15,22:00:00,467.94,207,7993,8200
2022/05/15,22:30:00,469.68,206,7756,7962
2022/05/15,23:00:00,479.08,206,7491,7697
2022/05/15,23:30:00,495.87,92,7312,7404
2022/05/16,00:00:00,496.34,91,7015,7106
2022/05/16,00:30:00,496.11,89,6756,6845
2022/05/16,01:00:00,496.11,90,6553,6643
2022/05/16,01:30:00,496.58,88,6367,6455
2022/05/16,02:00:00,496.11,86,6175,6261
2022/05/16,02:30:00,496.11,83,6107,6190
2022/05/16,03:00:00,496.58,84,6018,6102
2022/05/16,03:30:00,496.58,75,5981,6056
2022/05/16,04:00:00,496.11,64,6028,6092
2022/05/16,04:30:00,496.34,51,6073,6124
2022/05/16,05:00:00,496.34,44,6263,6307
2022/05/16,05:30:00,496.58,47,6288,6335
2022/05/16,06:00:00,496.58,46,6250,6296
2022/05/16,06:30:00,496.58,59,6362,6421
2022/05/16,07:00:00,496.58,268,6433,6701
2022/05/16,07:30:00,495.64,566,6523,7089
2022/05/16,08:00:00,496.58,869,6296,7165
2022/05/16,08:30:00,496.11,1114,6215,7329
2022/05/16,09:00:00,494.94,1455,6111,7566
2022/05/16,09:30:00,496.11,1785,5893,7678
2022/05/16,10:00:00,496.34,2120,5719,7839
2022/05/16,10:30:00,495.87,2241,5777,8018
2022/05/16,11:00:00,495.87,2290,5834,8124
2022/05/16,11:30:00,496.81,2419,5789,8208
2022/05/16,12:00:00,496.34,2590,5827,8417
2022/05/16,12:30:00,496.11,2526,5931,8457
2022/05/16,13:00:00,496.11,2388,6065,8453
2022/05/16,13:30:00,496.34,2199,6126,8325
2022/05/16,14:00:00,496.81,2055,6226,8281
2022/05/16,14:30:00,496.34,1912,6420,8332
2022/05/16,15:00:00,481.3,1780,6515,8295
2022/05/16,15:30:00,473.24,1663,6674,8337
2022/05/16,16:00:00,472.89,1607,6844,8451
2022/05/16,16:30:00,467.05,1144,7168,8312
2022/05/16,17:00:00,467.15,1014,7210,8224
2022/05/16,17:30:00,468.79,859,7311,8170
2022/05/16,18:00:00,471.16,640,7519,8159
2022/05/16,18:30:00,472.89,476,7717,8193
2022/05/16,19:00:00,472.89,287,7956,8243
2022/05/16,19:30:00,465.15,88,8247,8335
2022/05/16,20:00:00,462.92,93,8434,8527
2022/05/16,20:30:00,462.83,96,8517,8613
2022/05/16,21:00:00,462.78,83,8373,8456
2022/05/16,21:30:00,473.24,84,8231,8315
2022/05/16,22:00:00,476.36,63,8062,8125
2022/05/16,22:30:00,487.46,49,7867,7916
2022/05/16,23:00:00,495.87,46,7558,7604
2022/05/16,23:30:00,496.34,49,7283,7332
2022/05/17,00:00:00,496.34,56,6997,7053
2022/05/17,00:30:00,496.34,38,6738,6776
2022/05/17,01:00:00,496.34,14,6535,6549
2022/05/17,01:30:00,495.87,2,6389,6391
2022/05/17,02:00:00,496.34,3,6244,6247
2022/05/17,02:30:00,496.34,2,6330,6332
2022/05/17,03:00:00,496.81,1,6403,6404
2022/05/17,03:30:00,496.58,1,6365,6366
2022/05/17,04:00:00,496.11,2,6312,6314
2022/05/17,04:30:00,496.58,2,6450,6452
2022/05/17,05:00:00,495.87,3,6513,6516
2022/05/17,05:30:00,496.34,3,6695,6698
2022/05/17,06:00:00,496.34,3,6348,6351
2022/05/17,06:30:00,496.34,12,6540,6552
2022/05/17,07:00:00,496.11,199,6697,6896
2022/05/17,07:30:00,496.11,469,6752,7221
2022/05/17,08:00:00,496.34,740,6479,7219
2022/05/17,08:30:00,495.87,1068,6365,7433
2022/05/17,09:00:00,496.11,1543,6107,7650
2022/05/17,09:30:00,495.87,1766,6222,7988
2022/05/17,10:00:00,496.58,2076,6132,8208
2022/05/17,10:30:00,495.87,2032,6199,8231
2022/05/17,11:00:00,496.11,2350,6018,8368
2022/05/17,11:30:00,496.58,2472,5970,8442
2022/05/17,12:00:00,496.34,2599,5981,8580
2022/05/17,12:30:00,496.58,2629,5965,8594
2022/05/17,13:00:00,496.58,2628,6098,8726
2022/05/17,13:30:00,496.34,2652,6143,8795
2022/05/17,14:00:00,496.11,2655,6156,8811
2022/05/17,14:30:00,496.11,2596,6250,8846
2022/05/17,15:00:00,496.11,2414,6316,8730
2022/05/17,15:30:00,496.34,2373,6468,8841
2022/05/17,16:00:00,496.34,2155,6498,8653
2022/05/17,16:30:00,496.58,1859,6542,8401
2022/05/17,17:00:00,496.11,1479,6757,8236
2022/05/17,17:30:00,494.01,1218,7010,8228
2022/05/17,18:00:00,475.8,879,7397,8276
2022/05/17,18:30:00,468.56,602,7701,8303
2022/05/17,19:00:00,465.09,346,7924,8270
2022/05/17,19:30:00,463.53,184,8152,8336
2022/05/17,20:00:00,461.75,201,8399,8600
2022/05/17,20:30:00,461.79,222,8457,8679
2022/05/17,21:00:00,462.96,229,8316,8545
2022/05/17,21:30:00,468.88,209,8193,8402
2022/05/17,22:00:00,470.33,187,8015,8202
2022/05/17,22:30:00,478.88,196,7777,7973
2022/05/17,23:00:00,473.24,184,7517,7701
2022/05/17,23:30:00,489.68,180,7208,7388
2022/05/18,00:00:00,496.11,153,6908,7061
2022/05/18,00:30:00,496.58,146,6651,6797
2022/05/18,01:00:00,496.11,134,6465,6599
2022/05/18,01:30:00,495.87,129,6333,6462
2022/05/18,02:00:00,496.34,86,6171,6257
2022/05/18,02:30:00,496.11,35,6172,6207
2022/05/18,03:00:00,496.34,27,6094,6121
2022/05/18,03:30:00,496.34,24,6091,6115
2022/05/18,04:00:00,496.58,18,6247,6265
2022/05/18,04:30:00,496.34,12,6387,6399
2022/05/18,05:00:00,496.34,9,6531,6540
2022/05/18,05:30:00,496.34,11,6651,6662
2022/05/18,06:00:00,496.34,15,6622,6637
2022/05/18,06:30:00,496.34,23,6803,6826
2022/05/18,07:00:00,496.34,266,6890,7156
2022/05/18,07:30:00,496.34,594,6854,7448
2022/05/18,08:00:00,496.34,921,6572,7493
2022/05/18,08:30:00,495.64,1220,6426,7646
2022/05/18,09:00:00,496.58,1598,6247,7845
2022/05/18,09:30:00,496.34,1878,6139,8017
2022/05/18,10:00:00,496.58,2155,6092,8247
2022/05/18,10:30:00,496.11,2237,5974,8211
2022/05/18,11:00:00,496.11,2386,5964,8350
2022/05/18,11:30:00,496.58,2519,5983,8502
2022/05/18,12:00:00,496.58,2593,6017,8610
2022/05/18,12:30:00,496.58,2614,6035,8649
2022/05/18,13:00:00,496.58,2627,6090,8717
2022/05/18,13:30:00,496.11,2618,5917,8535
2022/05/18,14:00:00,496.58,2594,5946,8540
2022/05/18,14:30:00,496.34,2544,6026,8570
2022/05/18,15:00:00,496.34,2353,6117,8470
2022/05/18,15:30:00,496.11,2281,6276,8557
2022/05/18,16:00:00,496.34,2057,6383,8440
2022/05/18,16:30:00,496.34,1811,6637,8448
2022/05/18,17:00:00,496.34,1536,6807,8343
2022/05/18,17:30:00,484.43,1200,7133,8333
2022/05/18,18:00:00,468.56,836,7505,8341
2022/05/18,18:30:00,465.21,569,7766,8335
2022/05/18,19:00:00,464.94,313,7934,8247
2022/05/18,19:30:00,463.68,153,8134,8287
2022/05/18,20:00:00,463.84,154,8345,8499
2022/05/18,20:30:00,2393.09,161,8389,8550
2022/05/18,21:00:00,463.79,166,8262,8428
2022/05/18,21:30:00,471.16,155,8099,8254
2022/05/18,22:00:00,473.71,156,7870,8026
2022/05/18,22:30:00,477.51,163,7696,7859
2022/05/18,23:00:00,495.17,154,7497,7651
2022/05/18,23:30:00,496.11,150,7242,7392
2022/05/19,00:00:00,496.11,150,6992,7142
2022/05/19,00:30:00,496.11,150,6771,6921
2022/05/19,01:00:00,496.34,150,6555,6705
2022/05/19,01:30:00,496.11,140,6379,6519
2022/05/19,02:00:00,496.11,135,6245,6380
2022/05/19,02:30:00,495.87,136,6133,6269
2022/05/19,03:00:00,496.34,74,6119,6193
2022/05/19,03:30:00,496.34,15,6143,6158
2022/05/19,04:00:00,496.34,12,6127,6139
2022/05/19,04:30:00,495.64,17,6185,6202
2022/05/19,05:00:00,496.11,19,6235,6254
2022/05/19,05:30:00,496.11,22,6327,6349
2022/05/19,06:00:00,496.34,14,6413,6427
2022/05/19,06:30:00,495.87,15,6572,6587
2022/05/19,07:00:00,495.87,196,6654,6850
2022/05/19,07:30:00,495.87,422,6722,7144
2022/05/19,08:00:00,495.87,744,6494,7238
2022/05/19,08:30:00,495.87,1213,6372,7585
2022/05/19,09:00:00,496.34,1623,6214,7837
2022/05/19,09:30:00,495.87,1896,6164,8060
2022/05/19,10:00:00,495.87,2148,6137,8285
2022/05/19,10:30:00,495.87,2262,6107,8369
2022/05/19,11:00:00,495.87,2387,6112,8499
2022/05/19,11:30:00,496.34,2496,6110,8606
2022/05/19,12:00:00,495.87,2595,6144,8739
2022/05/19,12:30:00,495.87,2649,6151,8800
2022/05/19,13:00:00,496.11,2610,6201,8811
2022/05/19,13:30:00,496.11,2572,6269,8841
2022/05/19,14:00:00,495.64,2621,6290,8911
2022/05/19,14:30:00,495.64,2576,6369,8945
2022/05/19,15:00:00,496.11,2360,6353,8713
2022/05/19,15:30:00,496.11,2260,6448,8708
2022/05/19,16:00:00,495.64,2048,6433,8481
2022/05/19,16:30:00,496.11,1847,6641,8488
2022/05/19,17:00:00,495.87,1574,6832,8406
2022/05/19,17:30:00,480.28,1242,7191,8433
2022/05/19,18:00:00,466.32,842,7551,8393
2022/05/19,18:30:00,463.73,575,7845,8420
2022/05/19,19:00:00,2473.33,312,8032,8344
2022/05/19,19:30:00,2473.33,148,8195,8343
2022/05/19,20:00:00,2473.33,153,8413,8566
2022/05/19,20:30:00,2418.66,156,8434,8590
2022/05/19,21:00:00,2441.95,148,8285,8433
2022/05/19,21:30:00,463.79,147,8157,8304
2022/05/19,22:00:00,478.09,142,7907,8049
2022/05/19,22:30:00,494.47,149,7751,7900
2022/05/19,23:00:00,495.87,133,7532,7665
2022/05/19,23:30:00,496.34,139,7271,7410
2022/05/20,00:00:00,495.87,139,7041,7180
2022/05/20,00:30:00,495.87,35,6903,6938
2022/05/20,01:00:00,494.71,17,6715,6732
2022/05/20,01:30:00,495.64,13,6544,6557
2022/05/20,02:00:00,496.11,19,6364,6383
2022/05/20,02:30:00,495.64,25,6225,6250
2022/05/20,03:00:00,495.64,23,6160,6183
2022/05/20,03:30:00,496.11,30,6078,6108
2022/05/20,04:00:00,496.11,21,6073,6094
2022/05/20,04:30:00,496.11,15,6106,6121
2022/05/20,05:00:00,496.11,9,6145,6154
2022/05/20,05:30:00,496.11,1,6162,6163
2022/05/20,06:00:00,496.11,2,6042,6044
2022/05/20,06:30:00,496.11,21,6132,6153
2022/05/20,07:00:00,496.11,269,6037,6306
2022/05/20,07:30:00,496.11,616,6103,6719
2022/05/20,08:00:00,495.64,1029,5804,6833
2022/05/20,08:30:00,496.11,1325,5705,7030
2022/05/20,09:00:00,495.64,1651,5712,7363
2022/05/20,09:30:00,495.87,1892,5683,7575
2022/05/20,10:00:00,495.41,2102,5703,7805
2022/05/20,10:30:00,495.64,2139,5573,7712
2022/05/20,11:00:00,496.11,2275,5565,7840
2022/05/20,11:30:00,496.11,2416,5622,8038
2022/05/20,12:00:00,495.64,2437,5727,8164
2022/05/20,12:30:00,495.87,2422,5779,8201
2022/05/20,13:00:00,495.87,2488,5788,8276
2022/05/20,13:30:00,495.87,2408,5904,8312
2022/05/20,14:00:00,495.87,2296,6050,8346
2022/05/20,14:30:00,496.34,2224,6338,8562
2022/05/20,15:00:00,495.87,1858,6519,8377
2022/05/20,15:30:00,496.11,1636,6581,8217
2022/05/20,16:00:00,495.87,1491,6589,8080
2022/05/20,16:30:00,496.11,1354,6766,8120
2022/05/20,17:00:00,495.64,1089,7021,8110
2022/05/20,17:30:00,495.87,954,7314,8268
2022/05/20,18:00:00,495.87,689,7692,8381
2022/05/20,18:30:00,481.3,550,8027,8577
2022/05/20,19:00:00,475.61,284,8192,8476
2022/05/20,19:30:00,470,130,8229,8359
2022/05/20,20:00:00,469.68,135,8313,8448
2022/05/20,20:30:00,469.68,128,8182,8310
2022/05/20,21:00:00,488.79,122,8031,8153
2022/05/20,21:30:00,495.41,119,7910,8029
2022/05/20,22:00:00,496.58,146,7681,7827
2022/05/20,22:30:00,496.58,108,7606,7714
2022/05/20,23:00:00,496.34,19,7507,7526
2022/05/20,23:30:00,496.58,21,7367,7388
2022/05/21,00:00:00,496.58,35,7132,7167
2022/05/21,00:30:00,496.34,37,6969,7006
2022/05/21,01:00:00,496.58,41,6804,6845
2022/05/21,01:30:00,496.34,49,6630,6679
2022/05/21,02:00:00,496.11,50,6496,6546
2022/05/21,02:30:00,496.11,50,6451,6501
2022/05/21,03:00:00,496.34,58,6489,6547
2022/05/21,03:30:00,496.58,58,6631,6689
2022/05/21,04:00:00,496.34,81,6534,6615
2022/05/21,04:30:00,496.34,104,6494,6598
2022/05/21,05:00:00,496.11,106,6547,6653
2022/05/21,05:30:00,496.58,108,6538,6646
2022/05/21,06:00:00,496.58,128,6356,6484
2022/05/21,06:30:00,496.34,135,6205,6340
2022/05/21,07:00:00,496.58,331,6070,6401
2022/05/21,07:30:00,496.58,631,5901,6532
2022/05/21,08:00:00,496.34,936,5612,6548
2022/05/21,08:30:00,496.34,1299,5499,6798
2022/05/21,09:00:00,496.58,1641,5378,7019
2022/05/21,09:30:00,495.87,1777,5482,7259
2022/05/21,10:00:00,496.34,2013,5579,7592
2022/05/21,10:30:00,496.58,2202,5576,7778
2022/05/21,11:00:00,495.87,2315,5797,8112
2022/05/21,11:30:00,496.34,2346,5933,8279
2022/05/21,12:00:00,496.34,2277,6093,8370
2022/05/21,12:30:00,496.11,2154,6352,8506
2022/05/21,13:00:00,482.95,2088,6563,8651
2022/05/21,13:30:00,469.04,1917,6816,8733
2022/05/21,14:00:00,463.94,1699,6926,8625
2022/05/21,14:30:00,468.02,1760,6964,8724
2022/05/21,15:00:00,473.06,1488,6998,8486
2022/05/21,15:30:00,473.42,1213,7218,8431
2022/05/21,16:00:00,473.06,970,7356,8326
2022/05/21,16:30:00,472.89,793,7568,8361
2022/05/21,17:00:00,473.24,603,7667,8270
2022/05/21,17:30:00,473.78,522,7713,8235
2022/05/21,18:00:00,473.42,403,7918,8321
2022/05/21,18:30:00,470.16,249,8070,8319
2022/05/21,19:00:00,462.96,60,8198,8258
2022/05/21,19:30:00,2339.34,50,8330,8380
2022/05/21,20:00:00,2473.33,41,8582,8623
2022/05/21,20:30:00,2473.33,49,8616,8665
2022/05/21,21:00:00,2473.33,65,8615,8680
2022/05/21,21:30:00,2418.66,72,8561,8633
2022/05/21,22:00:00,2502.49,55,8447,8502
2022/05/21,22:30:00,463.53,69,8243,8312
2022/05/21,23:00:00,468.79,38,8040,8078
2022/05/21,23:30:00,469.04,33,7812,7845
2022/05/22,00:00:00,469.6,21,7508,7529
2022/05/22,00:30:00,487.02,18,7289,7307
2022/05/22,01:00:00,498.7,11,7057,7068
2022/05/22,01:30:00,498.47,12,6904,6916
2022/05/22,02:00:00,498.47,14,6661,6675
2022/05/22,02:30:00,498.47,16,6564,6580
2022/05/22,03:00:00,498.47,16,6523,6539
2022/05/22,03:30:00,498.23,21,6461,6482
2022/05/22,04:00:00,498.23,18,6396,6414
2022/05/22,04:30:00,498.47,20,6489,6509
2022/05/22,05:00:00,498.47,24,6506,6530
2022/05/22,05:30:00,498.23,41,6620,6661
2022/05/22,06:00:00,497.99,32,6621,6653
2022/05/22,06:30:00,498.23,47,6852,6899
2022/05/22,07:00:00,498.23,58,7100,7158
2022/05/22,07:30:00,487.46,470,7296,7766
2022/05/22,08:00:00,495.41,713,7256,7969
2022/05/22,08:30:00,496.58,930,7293,8223
2022/05/22,09:00:00,496.58,1202,7011,8213
2022/05/22,09:30:00,496.11,1463,6905,8368
2022/05/22,10:00:00,495.87,1740,6618,8358
2022/05/22,10:30:00,496.34,1970,6395,8365
2022/05/22,11:00:00,495.64,2213,6272,8485
2022/05/22,11:30:00,495.87,2296,6272,8568
2022/05/22,12:00:00,496.34,2359,6226,8585
2022/05/22,12:30:00,496.34,2470,6065,8535
2022/05/22,13:00:00,496.11,2587,6120,8707
2022/05/22,13:30:00,496.11,2584,6188,8772
2022/05/22,14:00:00,496.81,2546,6271,8817
2022/05/22,14:30:00,496.34,2504,6342,8846
2022/05/22,15:00:00,496.34,2358,6390,8748
2022/05/22,15:30:00,496.34,2215,6560,8775
2022/05/22,16:00:00,496.11,2025,6660,8685
2022/05/22,16:30:00,495.87,1819,6873,8692
2022/05/22,17:00:00,495.64,1520,6930,8450
2022/05/22,17:30:00,495.87,1194,7113,8307
2022/05/22,18:00:00,481.3,781,7484,8265
2022/05/22,18:30:00,481.09,587,7764,8351
2022/05/22,19:00:00,478.88,221,7963,8184
2022/05/22,19:30:00,479.88,196,8151,8347
2022/05/22,20:00:00,479.28,212,8410,8622
2022/05/22,20:30:00,466.61,230,8465,8695
2022/05/22,21:00:00,471.84,232,8335,8567
2022/05/22,21:30:00,486.37,231,8224,8455
2022/05/22,22:00:00,485.72,234,7963,8197
2022/05/22,22:30:00,487.24,219,7750,7969
2022/05/22,23:00:00,486.37,220,7557,7777
2022/05/22,23:30:00,496.81,224,7292,7516
2022/05/23,00:00:00,496.58,214,6962,7176
2022/05/23,00:30:00,496.11,222,6683,6905
2022/05/23,01:00:00,496.11,222,6487,6709
2022/05/23,01:30:00,496.11,167,6369,6536
2022/05/23,02:00:00,496.11,98,6284,6382
2022/05/23,02:30:00,496.34,92,6190,6282
2022/05/23,03:00:00,495.64,112,6146,6258
2022/05/23,03:30:00,495.64,99,6134,6233
2022/05/23,04:00:00,496.11,110,6094,6204
2022/05/23,04:30:00,496.34,112,6211,6323
2022/05/23,05:00:00,496.11,120,6290,6410
2022/05/23,05:30:00,496.34,124,6396,6520
2022/05/23,06:00:00,496.11,125,6326,6451
2022/05/23,06:30:00,496.11,144,6477,6621
2022/05/23,07:00:00,495.64,432,6526,6958
2022/05/23,07:30:00,495.87,769,6509,7278
2022/05/23,08:00:00,496.11,1114,6575,7689
2022/05/23,08:30:00,495.87,1361,6535,7896
2022/05/23,09:00:00,495.87,1673,6466,8139
2022/05/23,09:30:00,496.58,1894,6406,8300
2022/05/23,10:00:00,495.41,2114,6298,8412
2022/05/23,10:30:00,493.78,2250,6237,8487
2022/05/23,11:00:00,492.63,2394,6123,8517
2022/05/23,11:30:00,492.86,2519,6177,8696
2022/05/23,12:00:00,493.09,2617,6193,8810
2022/05/23,12:30:00,492.63,2659,6132,8791
2022/05/23,13:00:00,493.09,2656,6162,8818
2022/05/23,13:30:00,492.63,2628,6192,8820
2022/05/23,14:00:00,493.09,2615,6240,8855
2022/05/23,14:30:00,493.09,2569,6338,8907
2022/05/23,15:00:00,492.63,2390,6430,8820
2022/05/23,15:30:00,492.63,2275,6589,8864
2022/05/23,16:00:00,492.63,2070,6754,8824
2022/05/23,16:30:00,493.09,1836,6865,8701
2022/05/23,17:00:00,493.09,1508,6946,8454
2022/05/23,17:30:00,492.86,1150,7259,8409
2022/05/23,18:00:00,492.86,756,7615,8371
2022/05/23,18:30:00,492.86,475,7931,8406
2022/05/23,19:00:00,492.86,160,8132,8292
2022/05/23,19:30:00,479.68,113,8328,8441
2022/05/23,20:00:00,472.89,141,8584,8725
2022/05/23,20:30:00,473.06,142,8658,8800
2022/05/23,21:00:00,473.24,140,8506,8646
2022/05/23,21:30:00,475.98,137,8373,8510
2022/05/23,22:00:00,491.03,126,8192,8318
2022/05/23,22:30:00,491.49,130,7899,8029
2022/05/23,23:00:00,491.72,141,7613,7754
2022/05/23,23:30:00,491.26,144,7325,7469
2022/05/24,00:00:00,491.94,140,7049,7189
2022/05/24,00:30:00,491.94,134,6807,6941
2022/05/24,01:00:00,491.49,132,6557,6689
2022/05/24,01:30:00,491.49,131,6379,6510
2022/05/24,02:00:00,491.49,133,6284,6417
2022/05/24,02:30:00,491.49,16,6224,6240
2022/05/24,03:00:00,491.49,10,6222,6232
2022/05/24,03:30:00,491.49,11,6175,6186
2022/05/24,04:00:00,492.17,10,6141,6151
2022/05/24,04:30:00,491.72,7,6205,6212
2022/05/24,05:00:00,491.72,5,6347,6352
2022/05/24,05:30:00,491.72,2,6439,6441
2022/05/24,06:00:00,491.49,1,6420,6421
2022/05/24,06:30:00,491.49,24,6568,6592
2022/05/24,07:00:00,491.72,343,6537,6880
2022/05/24,07:30:00,491.72,701,6516,7217
2022/05/24,08:00:00,491.49,1092,6443,7535
2022/05/24,08:30:00,491.72,1385,6421,7806
2022/05/24,09:00:00,491.72,1652,6499,8151
2022/05/24,09:30:00,491.72,1851,6413,8264
2022/05/24,10:00:00,491.72,2074,6338,8412
2022/05/24,10:30:00,492.4,2198,6314,8512
2022/05/24,11:00:00,492.17,2363,6249,8612
2022/05/24,11:30:00,491.26,2536,6274,8810
2022/05/24,12:00:00,491.72,2573,6284,8857
2022/05/24,12:30:00,491.72,2603,6324,8927
2022/05/24,13:00:00,491.94,2606,6401,9007
2022/05/24,13:30:00,491.72,2625,6422,9047
2022/05/24,14:00:00,491.72,2587,6641,9228
2022/05/24,14:30:00,491.49,2558,6738,9296
2022/05/24,15:00:00,491.72,2388,6649,9037
2022/05/24,15:30:00,491.94,2237,6797,9034
2022/05/24,16:00:00,491.94,2023,6930,8953
2022/05/24,16:30:00,491.72,1807,6955,8762
2022/05/24,17:00:00,489.01,1490,7174,8664
2022/05/24,17:30:00,472.71,1174,7433,8607
2022/05/24,18:00:00,472.89,789,7749,8538
2022/05/24,18:30:00,463.34,558,8042,8600
2022/05/24,19:00:00,462.96,195,8226,8421
2022/05/24,19:30:00,2415.21,171,8361,8532
2022/05/24,20:00:00,2339.34,169,8651,8820
2022/05/24,20:30:00,2418.66,162,8688,8850
2022/05/24,21:00:00,461.82,166,8574,8740
2022/05/24,21:30:00,462.48,151,8499,8650
2022/05/24,22:00:00,464.61,139,8246,8385
2022/05/24,22:30:00,478.88,132,8039,8171
2022/05/24,23:00:00,496.34,133,7809,7942
2022/05/24,23:30:00,496.34,134,7496,7630
2022/05/25,00:00:00,496.81,129,7166,7295
2022/05/25,00:30:00,496.34,131,6925,7056
2022/05/25,01:00:00,496.34,127,6683,6810
2022/05/25,01:30:00,496.11,128,6576,6704
2022/05/25,02:00:00,496.81,126,6412,6538
2022/05/25,02:30:00,496.34,98,6262,6360
2022/05/25,03:00:00,495.87,23,6315,6338
2022/05/25,03:30:00,496.34,3,6293,6296
2022/05/25,04:00:00,497.05,0,6272,6272
2022/05/25,04:30:00,496.34,8,6360,6368
2022/05/25,05:00:00,496.58,11,6445,6456
2022/05/25,05:30:00,496.34,20,6469,6489
2022/05/25,06:00:00,496.58,21,6439,6460
2022/05/25,06:30:00,496.34,37,6653,6690
2022/05/25,07:00:00,496.11,328,6726,7054
2022/05/25,07:30:00,496.11,658,6727,7385
2022/05/25,08:00:00,496.81,1013,6487,7500
2022/05/25,08:30:00,496.11,1326,6541,7867
2022/05/25,09:00:00,496.11,1671,6433,8104
2022/05/25,09:30:00,496.11,1889,6501,8390
2022/05/25,10:00:00,496.11,2110,6438,8548
2022/05/25,10:30:00,496.34,2233,6448,8681
2022/05/25,11:00:00,495.64,2391,6448,8839
2022/05/25,11:30:00,496.34,2541,6416,8957
2022/05/25,12:00:00,496.34,2581,6475,9056
2022/05/25,12:30:00,496.34,2577,6568,9145
2022/05/25,13:00:00,496.58,2567,6621,9188
2022/05/25,13:30:00,496.34,2582,6771,9353
2022/05/25,14:00:00,496.58,2550,6840,9390
2022/05/25,14:30:00,496.11,2513,6971,9484
2022/05/25,15:00:00,496.11,2338,6957,9295
2022/05/25,15:30:00,496.58,2196,7058,9254
2022/05/25,16:00:00,496.11,2016,7178,9194
2022/05/25,16:30:00,496.34,1778,7441,9219
2022/05/25,17:00:00,496.11,1471,7474,8945
2022/05/25,17:30:00,496.81,1147,7747,8894
2022/05/25,18:00:00,496.34,784,8043,8827
2022/05/25,18:30:00,496.34,527,8358,8885
2022/05/25,19:00:00,496.34,175,8500,8675
2022/05/25,19:30:00,496.81,120,8629,8749
2022/05/25,20:00:00,496.34,127,8875,9002
2022/05/25,20:30:00,496.34,128,8896,9024
2022/05/25,21:00:00,496.34,126,8796,8922
2022/05/25,21:30:00,496.34,121,8653,8774
2022/05/25,22:00:00,495.87,119,8391,8510
2022/05/25,22:30:00,496.34,118,8178,8296
2022/05/25,23:00:00,496.34,125,7916,8041
2022/05/25,23:30:00,496.34,133,7612,7745
2022/05/26,00:00:00,495.87,150,7346,7496
2022/05/26,00:30:00,496.58,150,7056,7206
2022/05/26,01:00:00,496.11,153,6843,6996
2022/05/26,01:30:00,496.11,156,6683,6839
2022/05/26,02:00:00,496.58,156,6508,6664
2022/05/26,02:30:00,496.11,125,6449,6574
2022/05/26,03:00:00,496.11,39,6447,6486
2022/05/26,03:30:00,497.05,19,6424,6443
2022/05/26,04:00:00,496.81,14,6412,6426
2022/05/26,04:30:00,496.34,10,6478,6488
2022/05/26,05:00:00,496.34,10,6521,6531
2022/05/26,05:30:00,496.34,12,6579,6591
2022/05/26,06:00:00,496.58,11,6548,6559
2022/05/26,06:30:00,496.11,31,6703,6734
2022/05/26,07:00:00,496.11,287,6834,7121
2022/05/26,07:30:00,496.34,581,6887,7468
2022/05/26,08:00:00,495.87,869,6773,7642
2022/05/26,08:30:00,496.58,1207,6710,7917
2022/05/26,09:00:00,496.11,1626,6708,8334
2022/05/26,09:30:00,496.58,1863,6821,8684
2022/05/26,10:00:00,496.11,2106,6759,8865
2022/05/26,10:30:00,496.11,2271,6756,9027
2022/05/26,11:00:00,496.58,2416,6762,9178
2022/05/26,11:30:00,496.58,2572,6764,9336
2022/05/26,12:00:00,496.58,2590,6796,9386
2022/05/26,12:30:00,496.11,2606,6872,9478
2022/05/26,13:00:00,496.11,2596,6953,9549
2022/05/26,13:30:00,496.11,2583,7064,9647
2022/05/26,14:00:00,496.11,2544,7181,9725
2022/05/26,14:30:00,496.34,2499,7345,9844
2022/05/26,15:00:00,496.58,2315,7449,9764
2022/05/26,15:30:00,496.34,2168,7457,9625
2022/05/26,16:00:00,496.34,1947,7533,9480
2022/05/26,16:30:00,490.36,1703,7752,9455
2022/05/26,17:00:00,472.54,1381,7902,9283
2022/05/26,17:30:00,468.41,1063,8226,9289
2022/05/26,18:00:00,467.64,699,8446,9145
2022/05/26,18:30:00,463.73,507,8680,9187
2022/05/26,19:00:00,461.71,121,8754,8875
2022/05/26,19:30:00,461.71,125,8828,8953
2022/05/26,20:00:00,461.68,124,9020,9144
2022/05/26,20:30:00,2445.39,125,9002,9127
2022/05/26,21:00:00,2502.49,123,8834,8957
2022/05/26,21:30:00,465.9,122,8650,8772
2022/05/26,22:00:00,468.41,121,8452,8573
2022/05/26,22:30:00,476.74,121,8271,8392
2022/05/26,23:00:00,493.09,122,7980,8102
2022/05/26,23:30:00,494.01,121,7734,7855
2022/05/27,00:00:00,494.01,122,7498,7620
2022/05/27,00:30:00,493.55,123,7263,7386
2022/05/27,01:00:00,494.01,147,7049,7196
2022/05/27,01:30:00,494.01,159,6839,6998
2022/05/27,02:00:00,494.01,94,6729,6823
2022/05/27,02:30:00,493.55,32,6649,6681
2022/05/27,03:00:00,494.01,29,6576,6605
2022/05/27,03:30:00,493.55,33,6495,6528
2022/05/27,04:00:00,494.24,34,6439,6473
2022/05/27,04:30:00,493.78,34,6445,6479
2022/05/27,05:00:00,493.78,39,6479,6518
2022/05/27,05:30:00,493.78,55,6436,6491
2022/05/27,06:00:00,494.01,59,6356,6415
2022/05/27,06:30:00,494.01,80,6480,6560
2022/05/27,07:00:00,493.78,352,6469,6821
2022/05/27,07:30:00,493.78,571,6564,7135
2022/05/27,08:00:00,494.01,836,6487,7323
2022/05/27,08:30:00,494.01,1123,6435,7558
2022/05/27,09:00:00,494.01,1528,6342,7870
2022/05/27,09:30:00,495.87,1747,6312,8059
2022/05/27,10:00:00,495.87,2004,6265,8269
2022/05/27,10:30:00,496.11,2169,6328,8497
2022/05/27,11:00:00,496.58,2300,6363,8663
2022/05/27,11:30:00,496.34,2410,6405,8815
2022/05/27,12:00:00,496.34,2502,6418,8920
2022/05/27,12:30:00,496.34,2533,6514,9047
2022/05/27,13:00:00,496.34,2542,6557,9099
2022/05/27,13:30:00,496.34,2515,6688,9203
2022/05/27,14:00:00,496.34,2480,6772,9252
2022/05/27,14:30:00,496.11,2417,6866,9283
2022/05/27,15:00:00,496.58,2201,7019,9220
2022/05/27,15:30:00,496.34,2044,7161,9205
2022/05/27,16:00:00,496.34,1801,7365,9166
2022/05/27,16:30:00,496.34,1571,7596,9167
2022/05/27,17:00:00,484.22,1239,7858,9097
2022/05/27,17:30:00,468.25,958,8209,9167
2022/05/27,18:00:00,465.48,657,8502,9159
2022/05/27,18:30:00,461.36,437,8641,9078
2022/05/27,19:00:00,461.36,81,8765,8846
2022/05/27,19:30:00,461.36,21,8799,8820
2022/05/27,20:00:00,470.83,22,8828,8850
2022/05/27,20:30:00,489.01,25,8717,8742
2022/05/27,21:00:00,495.87,25,8567,8592
2022/05/27,21:30:00,496.34,21,8357,8378
2022/05/27,22:00:00,495.87,19,8233,8252
2022/05/27,22:30:00,496.34,11,8049,8060
2022/05/27,23:00:00,496.34,7,7906,7913
2022/05/27,23:30:00,495.87,5,7722,7727
2022/05/28,00:00:00,496.11,4,7587,7591
2022/05/28,00:30:00,496.11,5,7352,7357
2022/05/28,01:00:00,496.11,3,7235,7238
2022/05/28,01:30:00,495.64,2,7042,7044
2022/05/28,02:00:00,496.11,9,6974,6983
2022/05/28,02:30:00,496.11,14,6847,6861
2022/05/28,03:00:00,495.87,11,6745,6756
2022/05/28,03:30:00,495.87,13,6661,6674
2022/05/28,04:00:00,496.34,13,6636,6649
2022/05/28,04:30:00,496.34,12,6631,6643
2022/05/28,05:00:00,496.34,12,6599,6611
2022/05/28,05:30:00,495.87,15,6554,6569
2022/05/28,06:00:00,496.34,17,6415,6432
2022/05/28,06:30:00,496.34,34,6302,6336
2022/05/28,07:00:00,496.34,321,6264,6585
2022/05/28,07:30:00,496.11,544,6307,6851
2022/05/28,08:00:00,495.87,740,6197,6937
2022/05/28,08:30:00,495.87,1075,6018,7093
2022/05/28,09:00:00,496.11,1507,5919,7426
2022/05/28,09:30:00,495.87,1780,5790,7570
2022/05/28,10:00:00,496.11,2017,5818,7835
2022/05/28,10:30:00,496.11,2193,5862,8055
2022/05/28,11:00:00,495.64,2352,5938,8290
2022/05/28,11:30:00,495.64,2480,5967,8447
2022/05/28,12:00:00,496.11,2515,5997,8512
2022/05/28,12:30:00,496.11,2524,6102,8626
2022/05/28,13:00:00,496.11,2517,6197,8714
2022/05/28,13:30:00,495.64,2516,6199,8715
2022/05/28,14:00:00,495.87,2501,6297,8798
2022/05/28,14:30:00,496.11,2426,6308,8734
2022/05/28,15:00:00,496.11,2230,6432,8662
2022/05/28,15:30:00,496.11,2077,6675,8752
2022/05/28,16:00:00,495.64,1867,6900,8767
2022/05/28,16:30:00,496.11,1627,7190,8817
2022/05/28,17:00:00,496.58,1305,7419,8724
2022/05/28,17:30:00,495.87,1014,7752,8766
2022/05/28,18:00:00,495.87,678,8022,8700
2022/05/28,18:30:00,495.87,468,8206,8674
2022/05/28,19:00:00,495.87,144,8352,8496
2022/05/28,19:30:00,496.11,142,8430,8572
2022/05/28,20:00:00,496.11,143,8728,8871
2022/05/28,20:30:00,496.11,146,8751,8897
2022/05/28,21:00:00,495.64,142,8805,8947
2022/05/28,21:30:00,496.11,126,8698,8824
2022/05/28,22:00:00,496.34,132,8609,8741
2022/05/28,22:30:00,496.34,67,8544,8611
2022/05/28,23:00:00,496.11,5,8359,8364
2022/05/28,23:30:00,495.87,4,8109,8113
2022/05/29,00:00:00,495.87,6,7783,7789
2022/05/29,00:30:00,495.87,19,7575,7594
2022/05/29,01:00:00,496.11,19,7289,7308
2022/05/29,01:30:00,496.11,22,7168,7190
2022/05/29,02:00:00,496.34,13,6973,6986
2022/05/29,02:30:00,496.34,12,6864,6876
2022/05/29,03:00:00,495.87,11,6756,6767
2022/05/29,03:30:00,496.58,8,6693,6701
2022/05/29,04:00:00,496.11,8,6631,6639
2022/05/29,04:30:00,495.64,7,6708,6715
2022/05/29,05:00:00,495.87,8,6730,6738
2022/05/29,05:30:00,495.87,4,6827,6831
2022/05/29,06:00:00,495.87,7,6896,6903
2022/05/29,06:30:00,496.11,27,7063,7090
2022/05/29,07:00:00,496.34,292,7267,7559
2022/05/29,07:30:00,496.11,498,7463,7961
2022/05/29,08:00:00,495.87,724,7449,8173
2022/05/29,08:30:00,495.87,1125,7495,8620
2022/05/29,09:00:00,496.58,1560,7414,8974
2022/05/29,09:30:00,495.64,1804,7513,9317
2022/05/29,10:00:00,496.11,2038,7518,9556
2022/05/29,10:30:00,495.87,2201,7563,9764
2022/05/29,11:00:00,496.34,2382,7611,9993
2022/05/29,11:30:00,495.64,2519,7647,10166
2022/05/29,12:00:00,496.11,2556,7665,10221
2022/05/29,12:30:00,495.87,2557,7764,10321
2022/05/29,13:00:00,496.34,2566,7899,10465
2022/05/29,13:30:00,496.11,2570,8039,10609
2022/05/29,14:00:00,496.11,2531,8234,10765
2022/05/29,14:30:00,496.11,2487,8279,10766
2022/05/29,15:00:00,495.87,2198,8375,10573
2022/05/29,15:30:00,495.87,2137,8479,10616
2022/05/29,16:00:00,495.64,1799,8701,10500
2022/05/29,16:30:00,495.64,1544,8895,10439
2022/05/29,17:00:00,482.33,1286,9013,10299
2022/05/29,17:30:00,469.5,987,9163,10150
2022/05/29,18:00:00,469.32,679,9352,10031
2022/05/29,18:30:00,470.56,509,9407,9916
2022/05/29,19:00:00,2473.33,164,9381,9545
2022/05/29,19:30:00,2445.39,155,9415,9570
2022/05/29,20:00:00,2445.39,168,9596,9764
2022/05/29,20:30:00,2418.66,167,9611,9778
2022/05/29,21:00:00,470.26,162,9517,9679
2022/05/29,21:30:00,475.19,155,9411,9566
2022/05/29,22:00:00,476.55,154,9154,9308
2022/05/29,22:30:00,494.94,149,8892,9041
2022/05/29,23:00:00,495.41,130,8620,8750
2022/05/29,23:30:00,494.94,7,8456,8463
2022/05/30,00:00:00,495.41,7,8153,8160
2022/05/30,00:30:00,497.99,8,7893,7901
2022/05/30,01:00:00,496.81,8,7615,7623
2022/05/30,01:30:00,495.64,11,7450,7461
2022/05/30,02:00:00,495.41,9,7304,7313
2022/05/30,02:30:00,495.87,11,7329,7340
2022/05/30,03:00:00,492.17,11,7173,7184
2022/05/30,03:30:00,496.34,14,7276,7290
2022/05/30,04:00:00,495.41,20,7266,7286
2022/05/30,04:30:00,494.47,24,7263,7287
2022/05/30,05:00:00,499.18,30,7304,7334
2022/05/30,05:30:00,497.99,34,7353,7387
2022/05/30,06:00:00,497.52,36,7302,7338
2022/05/30,06:30:00,493.09,77,7441,7518
2022/05/30,07:00:00,494.94,347,7564,7911
2022/05/30,07:30:00,493.55,593,7742,8335
2022/05/30,08:00:00,495.41,913,7637,8550
2022/05/30,08:30:00,474.81,1298,7616,8914
2022/05/30,09:00:00,492.4,1657,7549,9206
2022/05/30,09:30:00,495.87,1898,7600,9498
2022/05/30,10:00:00,496.34,2125,7606,9731
2022/05/30,10:30:00,496.34,2251,7581,9832
2022/05/30,11:00:00,496.58,2426,7568,9994
2022/05/30,11:30:00,496.81,2535,7659,10194
2022/05/30,12:00:00,496.81,2575,7747,10322
2022/05/30,12:30:00,496.81,2557,7895,10452
2022/05/30,13:00:00,496.58,2563,7881,10444
2022/05/30,13:30:00,496.11,2543,7933,10476
2022/05/30,14:00:00,496.34,2559,8116,10675
2022/05/30,14:30:00,496.34,2532,8248,10780
2022/05/30,15:00:00,496.58,2315,8330,10645
2022/05/30,15:30:00,496.58,2187,8445,10632
2022/05/30,16:00:00,479.68,1930,8583,10513
2022/05/30,16:30:00,480.89,1727,8767,10494
2022/05/30,17:00:00,480.69,1426,8860,10286
2022/05/30,17:30:00,480.69,1124,9103,10227
2022/05/30,18:00:00,472.19,738,9309,10047
2022/05/30,18:30:00,470.46,532,9438,9970
2022/05/30,19:00:00,2445.39,178,9469,9647
2022/05/30,19:30:00,2393.09,151,9505,9656
2022/05/30,20:00:00,2445.39,170,9693,9863
2022/05/30,20:30:00,2445.39,170,9678,9848
2022/05/30,21:00:00,470.36,158,9524,9682
2022/05/30,21:30:00,470.26,155,9370,9525
2022/05/30,22:00:00,474.44,157,9135,9292
2022/05/30,22:30:00,489.46,161,8980,9141
2022/05/30,23:00:00,496.11,156,8695,8851
2022/05/30,23:30:00,496.34,152,8379,8531
2022/05/31,00:00:00,496.34,133,8081,8214
2022/05/31,00:30:00,496.58,120,7852,7972
2022/05/31,01:00:00,496.11,120,7578,7698
2022/05/31,01:30:00,496.58,93,7367,7460
2022/05/31,02:00:00,496.58,5,7311,7316
2022/05/31,02:30:00,496.58,1,7187,7188
2022/05/31,03:00:00,496.11,2,7045,7047
2022/05/31,03:30:00,496.58,2,7042,7044
2022/05/31,04:00:00,496.58,2,7005,7007
2022/05/31,04:30:00,496.58,2,6962,6964
2022/05/31,05:00:00,496.34,1,7058,7059
2022/05/31,05:30:00,496.58,2,7089,7091
2022/05/31,06:00:00,496.11,2,7049,7051
2022/05/31,06:30:00,496.58,21,7147,7168
2022/05/31,07:00:00,496.11,314,7385,7699
2022/05/31,07:30:00,496.34,652,7550,8202
2022/05/31,08:00:00,496.34,1024,7480,8504
2022/05/31,08:30:00,496.11,1349,7556,8905
2022/05/31,09:00:00,496.11,1664,7509,9173
2022/05/31,09:30:00,496.58,1839,7574,9413
2022/05/31,10:00:00,496.11,2101,7586,9687
2022/05/31,10:30:00,496.58,2241,7612,9853
2022/05/31,11:00:00,496.58,2343,7664,10007
2022/05/31,11:30:00,496.58,2493,7674,10167
2022/05/31,12:00:00,496.34,2544,7659,10203
2022/05/31,12:30:00,496.11,2574,7792,10366
2022/05/31,13:00:00,496.11,2594,7903,10497
2022/05/31,13:30:00,482.54,2557,8053,10610
2022/05/31,14:00:00,483.37,2553,8153,10706
2022/05/31,14:30:00,489.01,2504,8279,10783
2022/05/31,15:00:00,496.34,2336,8393,10729
2022/05/31,15:30:00,495.87,2189,8434,10623
2022/05/31,16:00:00,495.87,1999,8528,10527
2022/05/31,16:30:00,496.34,1792,8714,10506
2022/05/31,17:00:00,496.34,1466,8824,10290
2022/05/31,17:30:00,487.9,1151,9000,10151
2022/05/31,18:00:00,481.3,785,9217,10002
2022/05/31,18:30:00,478.09,527,9375,9902
2022/05/31,19:00:00,473.83,190,9380,9570
2022/05/31,19:30:00,474.94,165,9380,9545
2022/05/31,20:00:00,474.94,183,9594,9777
2022/05/31,20:30:00,475.06,177,9635,9812
2022/05/31,21:00:00,474.94,192,9510,9702
2022/05/31,21:30:00,479.68,199,9371,9570
2022/05/31,22:00:00,495.64,201,9143,9344
2022/05/31,22:30:00,496.11,192,8950,9142
2022/05/31,23:00:00,496.58,199,8631,8830
2022/05/31,23:30:00,496.58,180,8392,8572
2022/06/01,00:00:00,480.07,169,8039,8208
2022/06/01,00:30:00,480.07,169,7745,7914
2022/06/01,01:00:00,480.07,172,7556,7728
2022/06/01,01:30:00,480.07,159,7354,7513
2022/06/01,02:00:00,480.3,153,7168,7321
2022/06/01,02:30:00,480.3,104,7076,7180
2022/06/01,03:00:00,480.07,71,6980,7051
2022/06/01,03:30:00,480.07,65,6956,7021
2022/06/01,04:00:00,480.07,64,6959,7023
2022/06/01,04:30:00,480.07,19,7027,7046
2022/06/01,05:00:00,480.07,15,7092,7107
2022/06/01,05:30:00,479.84,11,7076,7087
2022/06/01,06:00:00,479.62,8,7323,7331
2022/06/01,06:30:00,480.07,26,7465,7491
2022/06/01,07:00:00,480.07,220,7600,7820
2022/06/01,07:30:00,480.07,527,7776,8303
2022/06/01,08:00:00,480.07,837,7699,8536
2022/06/01,08:30:00,480.3,1034,7794,8828
2022/06/01,09:00:00,479.84,1534,7518,9052
2022/06/01,09:30:00,479.84,1918,7334,9252
2022/06/01,10:00:00,480.3,2115,7259,9374
2022/06/01,10:30:00,479.84,2363,7302,9665
2022/06/01,11:00:00,480.07,2495,7274,9769
2022/06/01,11:30:00,480.07,2493,7315,9808
2022/06/01,12:00:00,480.07,2542,7295,9837
2022/06/01,12:30:00,480.3,2574,7401,9975
2022/06/01,13:00:00,479.84,2584,7492,10076
2022/06/01,13:30:00,480.07,2583,7589,10172
2022/06/01,14:00:00,480.07,2451,7777,10228
2022/06/01,14:30:00,480.3,2280,7876,10156
2022/06/01,15:00:00,480.07,2162,7882,10044
2022/06/01,15:30:00,480.07,1761,8033,9794
2022/06/01,16:00:00,480.07,1565,8153,9718
2022/06/01,16:30:00,480.75,1736,8201,9937
2022/06/01,17:00:00,480.3,1432,8348,9780
2022/06/01,17:30:00,479.84,1093,8557,9650
2022/06/01,18:00:00,480.3,735,8813,9548
2022/06/01,18:30:00,479.84,522,8955,9477
2022/06/01,19:00:00,479.84,156,9001,9157
2022/06/01,19:30:00,479.84,139,9070,9209
2022/06/01,20:00:00,479.62,154,9262,9416
2022/06/01,20:30:00,480.07,148,9328,9476
2022/06/01,21:00:00,479.84,137,9206,9343
2022/06/01,21:30:00,479.84,137,9098,9235
2022/06/01,22:00:00,480.52,135,8851,8986
2022/06/01,22:30:00,480.07,139,8682,8821
2022/06/01,23:00:00,480.07,156,8380,8536
2022/06/01,23:30:00,480.07,162,8102,8264
2022/06/02,00:00:00,480.07,160,7814,7974
2022/06/02,00:30:00,480.07,162,7560,7722
2022/06/02,01:00:00,480.07,138,7336,7474
2022/06/02,01:30:00,480.3,122,7128,7250
2022/06/02,02:00:00,479.84,120,6972,7092
2022/06/02,02:30:00,480.07,94,6880,6974
2022/06/02,03:00:00,480.52,56,6846,6902
2022/06/02,03:30:00,480.3,44,6795,6839
2022/06/02,04:00:00,480.07,31,6786,6817
2022/06/02,04:30:00,479.84,6,6845,6851
2022/06/02,05:00:00,479.84,6,6891,6897
2022/06/02,05:30:00,479.62,5,6892,6897
2022/06/02,06:00:00,480.07,5,6871,6876
2022/06/02,06:30:00,480.07,22,7155,7177
2022/06/02,07:00:00,479.84,318,7119,7437
2022/06/02,07:30:00,480.3,559,7416,7975
2022/06/02,08:00:00,480.07,893,7351,8244
2022/06/02,08:30:00,480.07,1197,7394,8591
2022/06/02,09:00:00,464.41,1551,7254,8805
2022/06/02,09:30:00,463.61,1820,7235,9055
2022/06/02,10:00:00,464.41,2091,7221,9312
2022/06/02,10:30:00,464.01,2237,7229,9466
2022/06/02,11:00:00,464.01,2424,7162,9586
2022/06/02,11:30:00,463.22,2574,7125,9699
2022/06/02,12:00:00,464.01,2539,7164,9703
2022/06/02,12:30:00,459.02,2635,7208,9843
2022/06/02,13:00:00,459.99,2632,7308,9940
2022/06/02,13:30:00,460.32,2622,7419,10041
2022/06/02,14:00:00,459.34,2595,7533,10128
2022/06/02,14:30:00,461.72,2546,7509,10055
2022/06/02,15:00:00,479.84,2349,7576,9925
2022/06/02,15:30:00,479.84,2204,7771,9975
2022/06/02,16:00:00,480.52,2032,7743,9775
2022/06/02,16:30:00,479.84,1807,7963,9770
2022/06/02,17:00:00,480.3,1480,8073,9553
2022/06/02,17:30:00,480.3,1162,8330,9492
2022/06/02,18:00:00,479.84,813,8581,9394
2022/06/02,18:30:00,480.75,515,8790,9305
2022/06/02,19:00:00,479.62,174,8884,9058
2022/06/02,19:30:00,480.07,150,8945,9095
2022/06/02,20:00:00,480.52,159,9084,9243
2022/06/02,20:30:00,480.3,161,9167,9328
2022/06/02,21:00:00,480.52,161,9043,9204
2022/06/02,21:30:00,480.52,176,8889,9065
2022/06/02,22:00:00,480.3,171,8693,8864
2022/06/02,22:30:00,480.3,163,8480,8643
2022/06/02,23:00:00,480.3,147,8290,8437
2022/06/02,23:30:00,480.07,145,8025,8170
2022/06/03,00:00:00,480.07,137,7764,7901
2022/06/03,00:30:00,480.07,134,7511,7645
2022/06/03,01:00:00,480.07,133,7262,7395
2022/06/03,01:30:00,480.07,143,7038,7181
2022/06/03,02:00:00,481.2,140,6855,6995
2022/06/03,02:30:00,480.07,124,6728,6852
2022/06/03,03:00:00,480.3,38,6682,6720
2022/06/03,03:30:00,480.75,14,6645,6659
2022/06/03,04:00:00,480.07,21,6573,6594
2022/06/03,04:30:00,479.84,17,6561,6578
2022/06/03,05:00:00,480.3,19,6595,6614
2022/06/03,05:30:00,479.84,25,6546,6571
2022/06/03,06:00:00,480.75,17,6637,6654
2022/06/03,06:30:00,480.52,39,6560,6599
2022/06/03,07:00:00,481.43,331,6671,7002
2022/06/03,07:30:00,480.3,656,6632,7288
2022/06/03,08:00:00,465.23,984,6469,7453
2022/06/03,08:30:00,464.82,1332,6428,7760
2022/06/03,09:00:00,480.07,1620,6405,8025
2022/06/03,09:30:00,480.98,1870,6444,8314
2022/06/03,10:00:00,480.07,2073,6474,8547
2022/06/03,10:30:00,480.75,2240,6503,8743
2022/06/03,11:00:00,480.3,2445,6542,8987
2022/06/03,11:30:00,480.3,2535,6612,9147
2022/06/03,12:00:00,480.3,2574,6655,9229
2022/06/03,12:30:00,480.52,2618,6733,9351
2022/06/03,13:00:00,480.07,2607,6797,9404
2022/06/03,13:30:00,479.62,2603,6905,9508
2022/06/03,14:00:00,480.75,2543,6976,9519
2022/06/03,14:30:00,479.62,2573,7030,9603
2022/06/03,15:00:00,479.84,2353,7110,9463
2022/06/03,15:30:00,480.3,2204,7222,9426
2022/06/03,16:00:00,479.84,1976,7246,9222
2022/06/03,16:30:00,479.84,1755,7439,9194
2022/06/03,17:00:00,480.07,1442,7707,9149
2022/06/03,17:30:00,480.07,1137,8044,9181
2022/06/03,18:00:00,480.07,806,8242,9048
2022/06/03,18:30:00,480.52,500,8607,9107
2022/06/03,19:00:00,479.62,164,8759,8923
2022/06/03,19:30:00,479.62,152,8628,8780
2022/06/03,20:00:00,480.52,147,8767,8914
2022/06/03,20:30:00,480.07,148,8684,8832
2022/06/03,21:00:00,480.52,147,8502,8649
2022/06/03,21:30:00,480.52,145,8327,8472
2022/06/03,22:00:00,480.3,141,8120,8261
2022/06/03,22:30:00,480.3,142,7984,8126
2022/06/03,23:00:00,480.52,139,7785,7924
2022/06/03,23:30:00,480.98,147,7564,7711
2022/06/04,00:00:00,480.3,154,7355,7509
2022/06/04,00:30:00,480.07,151,7177,7328
2022/06/04,01:00:00,480.3,155,6978,7133
2022/06/04,01:30:00,481.43,163,6787,6950
2022/06/04,02:00:00,480.3,164,6807,6971
2022/06/04,02:30:00,480.07,170,6844,7014
2022/06/04,03:00:00,479.39,103,6820,6923
2022/06/04,03:30:00,480.52,53,6800,6853
2022/06/04,04:00:00,480.07,55,6728,6783
2022/06/04,04:30:00,479.62,66,6714,6780
2022/06/04,05:00:00,480.52,65,6689,6754
2022/06/04,05:30:00,480.52,60,6612,6672
2022/06/04,06:00:00,480.3,68,6437,6505
2022/06/04,06:30:00,480.3,77,6345,6422
2022/06/04,07:00:00,480.3,371,6170,6541
2022/06/04,07:30:00,480.3,702,5903,6605
2022/06/04,08:00:00,462.46,1077,5523,6600
2022/06/04,08:30:00,480.98,1422,5249,6671
2022/06/04,09:00:00,479.84,1731,5194,6925
2022/06/04,09:30:00,481.2,1915,5202,7117
2022/06/04,10:00:00,480.52,2166,5226,7392
2022/06/04,10:30:00,479.84,2291,5324,7615
2022/06/04,11:00:00,480.52,2468,5349,7817
2022/06/04,11:30:00,480.52,2583,5436,8019
2022/06/04,12:00:00,480.07,2615,5524,8139
2022/06/04,12:30:00,480.07,2630,5599,8229
2022/06/04,13:00:00,480.52,2636,5676,8312
2022/06/04,13:30:00,479.84,2619,5785,8404
2022/06/04,14:00:00,480.52,2583,5872,8455
2022/06/04,14:30:00,480.3,2547,6013,8560
2022/06/04,15:00:00,480.3,2378,6143,8521
2022/06/04,15:30:00,480.3,2223,6327,8550
2022/06/04,16:00:00,480.3,2031,6603,8634
2022/06/04,16:30:00,480.07,1813,6889,8702
2022/06/04,17:00:00,480.52,1493,7122,8615
2022/06/04,17:30:00,480.07,1160,7439,8599
2022/06/04,18:00:00,480.3,805,7769,8574
2022/06/04,18:30:00,479.84,506,8053,8559
2022/06/04,19:00:00,479.84,176,8194,8370
2022/06/04,19:30:00,480.3,158,8207,8365
2022/06/04,20:00:00,480.52,159,8390,8549
2022/06/04,20:30:00,479.84,166,8416,8582
2022/06/04,21:00:00,479.84,164,8290,8454
2022/06/04,21:30:00,480.3,157,8244,8401
2022/06/04,22:00:00,480.52,167,8049,8216
2022/06/04,22:30:00,480.75,175,7953,8128
2022/06/04,23:00:00,480.3,180,7755,7935
2022/06/04,23:30:00,481.2,183,7583,7766
2022/06/05,00:00:00,479.84,198,7373,7571
2022/06/05,00:30:00,480.75,193,7185,7378
2022/06/05,01:00:00,480.07,201,7011,7212
2022/06/05,01:30:00,480.52,201,6824,7025
2022/06/05,02:00:00,480.3,206,6637,6843
2022/06/05,02:30:00,480.3,197,6531,6728
2022/06/05,03:00:00,480.3,144,6491,6635
2022/06/05,03:30:00,480.3,59,6543,6602
2022/06/05,04:00:00,481.2,56,6498,6554
2022/06/05,04:30:00,480.3,73,6461,6534
2022/06/05,05:00:00,480.3,56,6461,6517
2022/06/05,05:30:00,480.52,38,6430,6468
2022/06/05,06:00:00,480.52,24,6281,6305
2022/06/05,06:30:00,480.52,41,6230,6271
2022/06/05,07:00:00,480.52,345,6058,6403
2022/06/05,07:30:00,481.66,626,5916,6542
2022/06/05,08:00:00,480.75,995,5834,6829
2022/06/05,08:30:00,480.3,1241,5769,7010
2022/06/05,09:00:00,480.3,1512,5688,7200
2022/06/05,09:30:00,480.52,1665,5760,7425
2022/06/05,10:00:00,480.07,2060,5660,7720
2022/06/05,10:30:00,480.52,2198,5705,7903
2022/06/05,11:00:00,479.84,2356,5888,8244
2022/06/05,11:30:00,479.62,2477,6034,8511
2022/06/05,12:00:00,480.52,2548,6083,8631
2022/06/05,12:30:00,479.84,2572,6145,8717
2022/06/05,13:00:00,480.3,2601,6177,8778
2022/06/05,13:30:00,480.07,2628,6228,8856
2022/06/05,14:00:00,480.52,2616,6294,8910
2022/06/05,14:30:00,480.75,2587,6380,8967
2022/06/05,15:00:00,479.62,2354,6528,8882
2022/06/05,15:30:00,480.52,2185,6636,8821
2022/06/05,16:00:00,479.84,1914,6924,8838
2022/06/05,16:30:00,480.75,1736,7013,8749
2022/06/05,17:00:00,480.07,1473,7275,8748
2022/06/05,17:30:00,480.07,1181,7509,8690
2022/06/05,18:00:00,480.52,839,7870,8709
2022/06/05,18:30:00,479.84,527,8172,8699
2022/06/05,19:00:00,480.3,189,8289,8478
2022/06/05,19:30:00,480.07,139,8442,8581
2022/06/05,20:00:00,478.94,137,8667,8804
2022/06/05,20:30:00,480.3,144,8709,8853
2022/06/05,21:00:00,480.07,138,8746,8884
2022/06/05,21:30:00,480.07,133,8752,8885
2022/06/05,22:00:00,480.3,127,8725,8852
2022/06/05,22:30:00,480.3,128,8532,8660
2022/06/05,23:00:00,479.84,126,8292,8418
2022/06/05,23:30:00,481.2,129,8013,8142
2022/06/06,00:00:00,480.07,137,7717,7854
2022/06/06,00:30:00,480.07,142,7429,7571
2022/06/06,01:00:00,480.07,144,7241,7385
2022/06/06,01:30:00,480.07,142,7027,7169
2022/06/06,02:00:00,480.07,87,6867,6954
2022/06/06,02:30:00,480.52,39,6853,6892
2022/06/06,03:00:00,479.62,38,6840,6878
2022/06/06,03:30:00,480.52,43,6830,6873
2022/06/06,04:00:00,479.84,44,6782,6826
2022/06/06,04:30:00,480.52,45,6806,6851
2022/06/06,05:00:00,480.98,51,6884,6935
2022/06/06,05:30:00,479.84,38,6902,6940
2022/06/06,06:00:00,464.41,64,6843,6907
2022/06/06,06:30:00,479.84,67,6978,7045
2022/06/06,07:00:00,481.43,337,7142,7479
2022/06/06,07:30:00,480.75,588,7356,7944
2022/06/06,08:00:00,480.52,749,7626,8375
2022/06/06,08:30:00,480.07,1219,7474,8693
2022/06/06,09:00:00,481.43,1633,7339,8972
2022/06/06,09:30:00,480.75,1821,7430,9251
2022/06/06,10:00:00,480.3,2096,7407,9503
2022/06/06,10:30:00,480.07,2238,7336,9574
2022/06/06,11:00:00,481.43,2422,7332,9754
2022/06/06,11:30:00,464.82,2522,7395,9917
2022/06/06,12:00:00,480.3,2515,7502,10017
2022/06/06,12:30:00,480.52,2581,7597,10178
2022/06/06,13:00:00,479.62,2574,7658,10232
2022/06/06,13:30:00,480.75,2587,7713,10300
2022/06/06,14:00:00,480.07,2548,7777,10325
2022/06/06,14:30:00,479.84,2518,7792,10310
2022/06/06,15:00:00,479.84,2395,7885,10280
2022/06/06,15:30:00,480.07,2329,8086,10415
2022/06/06,16:00:00,481.2,2031,8204,10235
2022/06/06,16:30:00,480.52,1839,8424,10263
2022/06/06,17:00:00,480.07,1453,8534,9987
2022/06/06,17:30:00,480.07,1143,8793,9936
2022/06/06,18:00:00,479.84,734,9045,9779
2022/06/06,18:30:00,479.84,511,9169,9680
2022/06/06,19:00:00,480.3,164,9252,9416
2022/06/06,19:30:00,479.84,141,9313,9454
2022/06/06,20:00:00,480.3,144,9478,9622
2022/06/06,20:30:00,480.3,152,9490,9642
2022/06/06,21:00:00,480.3,157,9357,9514
2022/06/06,21:30:00,480.3,163,9223,9386
2022/06/06,22:00:00,479.62,168,9036,9204
2022/06/06,22:30:00,480.52,177,8828,9005
2022/06/06,23:00:00,480.52,181,8573,8754
2022/06/06,23:30:00,480.52,183,8243,8426
2022/06/07,00:00:00,479.84,188,7920,8108
2022/06/07,00:30:00,480.3,193,7648,7841
2022/06/07,01:00:00,480.07,194,7373,7567
2022/06/07,01:30:00,479.84,190,7170,7360
2022/06/07,02:00:00,480.52,189,7177,7366
2022/06/07,02:30:00,479.62,144,7052,7196
2022/06/07,03:00:00,480.07,86,7062,7148
2022/06/07,03:30:00,480.52,76,6973,7049
2022/06/07,04:00:00,480.52,53,7044,7097
2022/06/07,04:30:00,480.52,41,7050,7091
2022/06/07,05:00:00,480.07,30,7087,7117
2022/06/07,05:30:00,480.3,26,7125,7151
2022/06/07,06:00:00,480.07,19,7144,7163
2022/06/07,06:30:00,480.3,34,7279,7313
2022/06/07,07:00:00,480.75,309,7419,7728
2022/06/07,07:30:00,480.07,582,7642,8224
2022/06/07,08:00:00,480.3,918,7623,8541
2022/06/07,08:30:00,480.75,1147,7747,8894
2022/06/07,09:00:00,479.84,1467,7697,9164
2022/06/07,09:30:00,480.3,1782,7672,9454
2022/06/07,10:00:00,465.23,2043,7537,9580
2022/06/07,10:30:00,480.52,2242,7552,9794
2022/06/07,11:00:00,464.41,2415,7499,9914
2022/06/07,11:30:00,464.01,2533,7504,10037
2022/06/07,12:00:00,463.61,2527,7544,10071
2022/06/07,12:30:00,463.22,2594,7723,10317
2022/06/07,13:00:00,464.82,2567,7860,10427
2022/06/07,13:30:00,463.61,2545,7988,10533
2022/06/07,14:00:00,464.01,2554,8073,10627
2022/06/07,14:30:00,464.41,2549,8175,10724
2022/06/07,15:00:00,464.82,2351,8284,10635
2022/06/07,15:30:00,464.01,2221,8319,10540
2022/06/07,16:00:00,463.61,1934,8557,10491
2022/06/07,16:30:00,463.61,1764,8736,10500
2022/06/07,17:00:00,463.61,1498,8874,10372
2022/06/07,17:30:00,463.22,1170,9043,10213
2022/06/07,18:00:00,481.2,807,9306,10113
2022/06/07,18:30:00,481.2,549,9453,10002
2022/06/07,19:00:00,480.52,183,9532,9715
2022/06/07,19:30:00,480.75,145,9560,9705
2022/06/07,20:00:00,481.9,151,9743,9894
2022/06/07,20:30:00,486.17,155,9721,9876
2022/06/07,21:00:00,480.98,160,9584,9744
2022/06/07,21:30:00,480.75,167,9399,9566
2022/06/07,22:00:00,480.75,183,9170,9353
2022/06/07,22:30:00,480.3,182,8946,9128
2022/06/07,23:00:00,480.75,171,8693,8864
2022/06/07,23:30:00,480.75,168,8419,8587
2022/06/08,00:00:00,480.75,166,8075,8241
2022/06/08,00:30:00,480.75,179,7768,7947
2022/06/08,01:00:00,480.75,175,7523,7698
2022/06/08,01:30:00,481.2,165,7334,7499
2022/06/08,02:00:00,480.75,165,7094,7259
2022/06/08,02:30:00,480.75,155,7057,7212
2022/06/08,03:00:00,480.75,134,6944,7078
2022/06/08,03:30:00,480.98,45,6957,7002
2022/06/08,04:00:00,480.75,43,6959,7002
2022/06/08,04:30:00,480.52,49,6994,7043
2022/06/08,05:00:00,480.52,42,6972,7014
2022/06/08,05:30:00,480.98,36,6973,7009
2022/06/08,06:00:00,480.75,30,6995,7025
2022/06/08,06:30:00,480.98,43,7104,7147
2022/06/08,07:00:00,480.52,337,7225,7562
2022/06/08,07:30:00,480.52,633,7434,8067
2022/06/08,08:00:00,480.98,982,7608,8590
2022/06/08,08:30:00,480.3,1321,7718,9039
2022/06/08,09:00:00,480.75,1653,7771,9424
2022/06/08,09:30:00,480.52,1882,7773,9655
2022/06/08,10:00:00,479.39,2094,7769,9863
2022/06/08,10:30:00,480.75,2262,7607,9869
2022/06/08,11:00:00,479.84,2443,7595,10038
2022/06/08,11:30:00,480.07,2521,7699,10220
2022/06/08,12:00:00,480.07,2569,7926,10495
2022/06/08,12:30:00,480.3,2597,8034,10631
2022/06/08,13:00:00,479.84,2632,8151,10783
2022/06/08,13:30:00,479.62,2602,8310,10912
2022/06/08,14:00:00,476.27,2545,8465,11010
2022/06/08,14:30:00,463.61,2570,8634,11204
2022/06/08,15:00:00,461.72,2356,8774,11130
2022/06/08,15:30:00,457.78,2207,8950,11157
2022/06/08,16:00:00,458.65,2025,9032,11057
2022/06/08,16:30:00,457.44,1818,9223,11041
2022/06/08,17:00:00,456.27,1507,9211,10718
2022/06/08,17:30:00,449.27,1181,9452,10633
2022/06/08,18:00:00,449.05,830,9520,10350
2022/06/08,18:30:00,449.27,512,9725,10237
2022/06/08,19:00:00,449.35,173,9788,9961
2022/06/08,19:30:00,449.51,141,9732,9873
2022/06/08,20:00:00,449.19,134,9874,10008
2022/06/08,20:30:00,449.19,147,9828,9975
2022/06/08,21:00:00,450.93,148,9667,9815
2022/06/08,21:30:00,466.09,155,9526,9681
2022/06/08,22:00:00,469.61,147,9264,9411
2022/06/08,22:30:00,471.08,148,9034,9182
2022/06/08,23:00:00,480.3,150,8766,8916
2022/06/08,23:30:00,480.75,143,8439,8582
2022/06/09,00:00:00,480.07,151,8119,8270
2022/06/09,00:30:00,480.07,161,7824,7985
2022/06/09,01:00:00,480.07,163,7568,7731
2022/06/09,01:30:00,480.07,148,7359,7507
2022/06/09,02:00:00,480.07,43,7265,7308
2022/06/09,02:30:00,480.3,22,7300,7322
2022/06/09,03:00:00,479.84,13,7205,7218
2022/06/09,03:30:00,480.98,13,7129,7142
2022/06/09,04:00:00,482.58,12,7074,7086
2022/06/09,04:30:00,480.07,12,7110,7122
2022/06/09,05:00:00,480.07,14,7152,7166
2022/06/09,05:30:00,480.07,18,7155,7173
2022/06/09,06:00:00,482.35,21,7134,7155
2022/06/09,06:30:00,480.07,38,7258,7296
2022/06/09,07:00:00,480.07,348,7386,7734
2022/06/09,07:30:00,481.2,687,7500,8187
2022/06/09,08:00:00,480.3,1078,7613,8691
2022/06/09,08:30:00,480.07,1390,7758,9148
2022/06/09,09:00:00,479.39,1670,7829,9499
2022/06/09,09:30:00,478.04,1781,7962,9743
2022/06/09,10:00:00,479.39,2024,7977,10001
2022/06/09,10:30:00,479.84,2180,8079,10259
2022/06/09,11:00:00,479.84,2392,7811,10203
2022/06/09,11:30:00,480.3,2579,7817,10396
2022/06/09,12:00:00,480.07,2620,7879,10499
2022/06/09,12:30:00,480.07,2644,7972,10616
2022/06/09,13:00:00,480.07,2634,8091,10725
2022/06/09,13:30:00,480.07,2620,8241,10861
2022/06/09,14:00:00,480.07,2606,8392,10998
2022/06/09,14:30:00,480.07,2588,8599,11187
2022/06/09,15:00:00,480.07,2409,8731,11140
2022/06/09,15:30:00,480.3,2269,8859,11128
2022/06/09,16:00:00,480.3,2018,9007,11025
2022/06/09,16:30:00,478.72,1798,9230,11028
2022/06/09,17:00:00,480.52,1503,9374,10877
2022/06/09,17:30:00,468.58,1176,9619,10795
2022/06/09,18:00:00,465.66,801,9943,10744
2022/06/09,18:30:00,453.12,519,10155,10674
2022/06/09,19:00:00,448.81,161,10180,10341
2022/06/09,19:30:00,448.23,121,10104,10225
2022/06/09,20:00:00,449.19,110,10237,10347
2022/06/09,20:30:00,448.47,116,10178,10294
2022/06/09,21:00:00,456.96,119,10018,10137
2022/06/09,21:30:00,465.23,123,9836,9959
2022/06/09,22:00:00,465.23,126,9585,9711
2022/06/09,22:30:00,485.71,120,9325,9445
2022/06/09,23:00:00,479.17,123,9092,9215
2022/06/09,23:30:00,479.84,121,8808,8929
2022/06/10,00:00:00,479.84,126,8533,8659
2022/06/10,00:30:00,479.84,126,8248,8374
2022/06/10,01:00:00,480.3,122,8018,8140
2022/06/10,01:30:00,479.84,124,7797,7921
2022/06/10,02:00:00,479.84,120,7633,7753
2022/06/10,02:30:00,480.52,69,7539,7608
2022/06/10,03:00:00,480.07,10,7629,7639
2022/06/10,03:30:00,480.52,14,7510,7524
2022/06/10,04:00:00,480.07,19,7457,7476
2022/06/10,04:30:00,479.84,27,7449,7476
2022/06/10,05:00:00,479.84,37,7401,7438
2022/06/10,05:30:00,480.3,37,7354,7391
2022/06/10,06:00:00,480.07,26,7242,7268
2022/06/10,06:30:00,479.84,36,7253,7289
2022/06/10,07:00:00,479.84,319,7267,7586
2022/06/10,07:30:00,480.07,645,7415,8060
2022/06/10,08:00:00,480.07,1005,7315,8320
2022/06/10,08:30:00,480.07,1341,7296,8637
2022/06/10,09:00:00,480.07,1665,7319,8984
2022/06/10,09:30:00,480.07,1908,7387,9295
2022/06/10,10:00:00,480.52,2137,7384,9521
2022/06/10,10:30:00,480.3,2295,7512,9807
2022/06/10,11:00:00,480.3,2495,7610,10105
2022/06/10,11:30:00,479.84,2596,7697,10293
2022/06/10,12:00:00,479.84,2644,7730,10374
2022/06/10,12:30:00,480.52,2658,7763,10421
2022/06/10,13:00:00,480.07,2678,7894,10572
2022/06/10,13:30:00,480.07,2671,7971,10642
2022/06/10,14:00:00,479.84,2648,8049,10697
2022/06/10,14:30:00,480.07,2607,8101,10708
2022/06/10,15:00:00,480.07,2423,8189,10612
2022/06/10,15:30:00,480.07,2297,8260,10557
2022/06/10,16:00:00,480.07,2088,8287,10375
2022/06/10,16:30:00,479.84,1893,8485,10378
2022/06/10,17:00:00,480.07,1581,8716,10297
2022/06/10,17:30:00,480.52,1263,9051,10314
2022/06/10,18:00:00,468.78,890,9413,10303
2022/06/10,18:30:00,455.16,564,9790,10354
2022/06/10,19:00:00,448.93,224,9953,10177
2022/06/10,19:30:00,448.23,181,9873,10054
2022/06/10,20:00:00,448.25,188,9832,10020
2022/06/10,20:30:00,448.25,200,9734,9934
2022/06/10,21:00:00,448.24,198,9544,9742
2022/06/10,21:30:00,457.44,186,9350,9536
2022/06/10,22:00:00,485.91,182,9176,9358
2022/06/10,22:30:00,485.91,176,8995,9171
2022/06/10,23:00:00,485.91,177,8853,9030
2022/06/10,23:30:00,480.3,181,8631,8812
2022/06/11,00:00:00,480.52,184,8400,8584
2022/06/11,00:30:00,480.52,174,8172,8346
2022/06/11,01:00:00,480.3,176,7894,8070
2022/06/11,01:30:00,480.3,176,7743,7919
2022/06/11,02:00:00,480.52,187,7551,7738
2022/06/11,02:30:00,480.52,190,7431,7621
2022/06/11,03:00:00,480.52,123,7350,7473
2022/06/11,03:30:00,480.52,52,7306,7358
2022/06/11,04:00:00,480.52,42,7274,7316
2022/06/11,04:30:00,480.52,57,7364,7421
2022/06/11,05:00:00,480.52,56,7335,7391
2022/06/11,05:30:00,480.07,57,7190,7247
2022/06/11,06:00:00,480.07,53,7125,7178
2022/06/11,06:30:00,480.07,72,7023,7095
2022/06/11,07:00:00,480.52,384,6821,7205
2022/06/11,07:30:00,481.2,765,6588,7353
2022/06/11,08:00:00,480.52,1132,6366,7498
2022/06/11,08:30:00,479.84,1394,6345,7739
2022/06/11,09:00:00,480.75,1716,6342,8058
2022/06/11,09:30:00,480.3,1896,6415,8311
2022/06/11,10:00:00,480.3,2160,6498,8658
2022/06/11,10:30:00,480.52,2281,6693,8974
2022/06/11,11:00:00,480.3,2474,6808,9282
2022/06/11,11:30:00,480.3,2588,6922,9510
2022/06/11,12:00:00,480.3,2597,7066,9663
2022/06/11,12:30:00,480.3,2608,7251,9859
2022/06/11,13:00:00,480.98,2612,7439,10051
2022/06/11,13:30:00,480.3,2579,7622,10201
2022/06/11,14:00:00,480.3,2547,7785,10332
2022/06/11,14:30:00,480.75,2491,7904,10395
2022/06/11,15:00:00,480.07,2318,8098,10416
2022/06/11,15:30:00,471.93,2174,8348,10522
2022/06/11,16:00:00,470.45,1903,8602,10505
2022/06/11,16:30:00,472.14,1700,8612,10312
2022/06/11,17:00:00,463.61,1366,8865,10231
2022/06/11,17:30:00,452.82,1066,9181,10247
2022/06/11,18:00:00,455.13,717,9432,10149
2022/06/11,18:30:00,453.73,481,9626,10107
2022/06/11,19:00:00,453.27,266,9642,9908
2022/06/11,19:30:00,458.3,131,9664,9795
2022/06/11,20:00:00,449.12,137,9846,9983
2022/06/11,20:30:00,450.04,140,9909,10049
2022/06/11,21:00:00,452.97,144,9887,10031
2022/06/11,21:30:00,452.68,144,9843,9987
2022/06/11,22:00:00,458.13,143,9741,9884
2022/06/11,22:30:00,468.78,139,9591,9730
2022/06/11,23:00:00,471.71,130,9364,9494
2022/06/11,23:30:00,473,127,9053,9180
2022/06/12,00:00:00,480.52,125,8812,8937
2022/06/12,00:30:00,480.52,124,8512,8636
2022/06/12,01:00:00,480.98,121,8277,8398
2022/06/12,01:30:00,480.98,120,8050,8170
2022/06/12,02:00:00,480.52,70,7923,7993
2022/06/12,02:30:00,480.98,6,7825,7831
2022/06/12,03:00:00,480.3,15,7692,7707
2022/06/12,03:30:00,480.3,18,7646,7664
2022/06/12,04:00:00,480.3,17,7561,7578
2022/06/12,04:30:00,480.3,29,7578,7607
2022/06/12,05:00:00,480.07,27,7686,7713
2022/06/12,05:30:00,480.75,28,7644,7672
2022/06/12,06:00:00,479.84,33,7768,7801
2022/06/12,06:30:00,480.07,59,7963,8022
2022/06/12,07:00:00,480.52,335,8148,8483
2022/06/12,07:30:00,480.52,576,8454,9030
2022/06/12,08:00:00,480.52,858,8547,9405
2022/06/12,08:30:00,480.07,1172,8836,10008
2022/06/12,09:00:00,480.52,1503,8937,10440
2022/06/12,09:30:00,480.52,1788,8905,10693
2022/06/12,10:00:00,480.3,2063,8816,10879
2022/06/12,10:30:00,480.3,2256,8789,11045
2022/06/12,11:00:00,480.52,2434,8730,11164
2022/06/12,11:30:00,480.3,2561,8677,11238
2022/06/12,12:00:00,480.3,2614,8652,11266
2022/06/12,12:30:00,480.3,2633,8675,11308
2022/06/12,13:00:00,480.52,2625,8647,11272
2022/06/12,13:30:00,480.52,2626,8758,11384
2022/06/12,14:00:00,480.52,2600,8787,11387
2022/06/12,14:30:00,480.07,2610,8847,11457
2022/06/12,15:00:00,480.3,2413,8954,11367
2022/06/12,15:30:00,480.3,2301,9032,11333
2022/06/12,16:00:00,480.75,2055,9131,11186
2022/06/12,16:30:00,480.52,1811,9253,11064
2022/06/12,17:00:00,478.27,1497,9303,10800
2022/06/12,17:30:00,465.66,1205,9437,10642
2022/06/12,18:00:00,464.41,847,9614,10461
2022/06/12,18:30:00,464.82,578,9745,10323
2022/06/12,19:00:00,464.82,295,9816,10111
2022/06/12,19:30:00,464.41,189,9777,9966
2022/06/12,20:00:00,464.82,186,9944,10130
2022/06/12,20:30:00,464.41,190,9964,10154
2022/06/12,21:00:00,464.82,176,9910,10086
2022/06/12,21:30:00,466.09,170,9763,9933
2022/06/12,22:00:00,469.2,169,9567,9736
2022/06/12,22:30:00,464.77,181,9319,9500
2022/06/12,23:00:00,479.84,183,9028,9211
2022/06/12,23:30:00,480.52,183,8751,8934
2022/06/13,00:00:00,480.3,185,8452,8637
2022/06/13,00:30:00,479.39,182,8154,8336
2022/06/13,01:00:00,480.3,181,7967,8148
2022/06/13,01:30:00,480.75,177,7704,7881
2022/06/13,02:00:00,480.52,73,7671,7744
2022/06/13,02:30:00,480.52,73,7529,7602
2022/06/13,03:00:00,480.98,74,7553,7627
2022/06/13,03:30:00,480.75,74,7510,7584
2022/06/13,04:00:00,480.07,74,7490,7564
2022/06/13,04:30:00,480.07,73,7517,7590
2022/06/13,05:00:00,480.52,74,7544,7618
2022/06/13,05:30:00,480.52,76,7709,7785
2022/06/13,06:00:00,480.52,69,7730,7799
2022/06/13,06:30:00,480.52,78,7899,7977
2022/06/13,07:00:00,480.3,368,8007,8375
2022/06/13,07:30:00,480.52,561,8221,8782
2022/06/13,08:00:00,479.84,755,8339,9094
2022/06/13,08:30:00,480.52,927,8351,9278
2022/06/13,09:00:00,480.07,1251,8411,9662
2022/06/13,09:30:00,480.52,1296,8534,9830
2022/06/13,10:00:00,480.07,1612,8279,9891
2022/06/13,10:30:00,480.52,1929,8262,10191
2022/06/13,11:00:00,480.07,1976,8133,10109
2022/06/13,11:30:00,480.07,2228,8173,10401
2022/06/13,12:00:00,480.07,2273,8140,10413
2022/06/13,12:30:00,480.52,2226,8280,10506
2022/06/13,13:00:00,480.3,2155,8264,10419
2022/06/13,13:30:00,479.84,2376,8227,10603
2022/06/13,14:00:00,480.3,2296,8315,10611
2022/06/13,14:30:00,480.07,2228,8348,10576
2022/06/13,15:00:00,478.49,2186,8376,10562
2022/06/13,15:30:00,480.3,2205,8465,10670
2022/06/13,16:00:00,480.3,2065,8587,10652
2022/06/13,16:30:00,480.3,1798,8658,10456
2022/06/13,17:00:00,480.98,1539,8761,10300
2022/06/13,17:30:00,479.84,1208,8924,10132
2022/06/13,18:00:00,479.62,863,9173,10036
2022/06/13,18:30:00,480.07,535,9317,9852
2022/06/13,19:00:00,480.07,321,9459,9780
2022/06/13,19:30:00,479.62,137,9516,9653
2022/06/13,20:00:00,480.52,157,9642,9799
2022/06/13,20:30:00,480.3,151,9709,9860
2022/06/13,21:00:00,480.3,150,9636,9786
2022/06/13,21:30:00,480.07,147,9564,9711
2022/06/13,22:00:00,480.07,145,9317,9462
2022/06/13,22:30:00,480.07,140,9176,9316
2022/06/13,23:00:00,480.07,133,8923,9056
2022/06/13,23:30:00,480.3,156,8601,8757
2022/06/14,00:00:00,480.3,123,8327,8450
2022/06/14,00:30:00,481.2,129,8064,8193
2022/06/14,01:00:00,481.2,77,7807,7884
2022/06/14,01:30:00,480.52,29,7712,7741
2022/06/14,02:00:00,479.84,25,7707,7732
2022/06/14,02:30:00,480.52,17,7564,7581
2022/06/14,03:00:00,480.98,19,7427,7446
2022/06/14,03:30:00,480.98,12,7324,7336
2022/06/14,04:00:00,480.52,14,7286,7300
2022/06/14,04:30:00,480.52,20,7325,7345
2022/06/14,05:00:00,480.75,20,7405,7425
2022/06/14,05:30:00,479.84,16,7415,7431
2022/06/14,06:00:00,480.75,13,7396,7409
2022/06/14,06:30:00,479.84,36,7588,7624
2022/06/14,07:00:00,480.52,345,7798,8143
2022/06/14,07:30:00,480.07,664,7969,8633
2022/06/14,08:00:00,480.07,1032,7888,8920
2022/06/14,08:30:00,480.07,1343,7989,9332
2022/06/14,09:00:00,480.52,1686,7996,9682
2022/06/14,09:30:00,480.3,1841,7994,9835
2022/06/14,10:00:00,480.52,2128,7908,10036
2022/06/14,10:30:00,480.07,2256,7989,10245
2022/06/14,11:00:00,480.75,2441,7893,10334
2022/06/14,11:30:00,480.75,2539,7889,10428
2022/06/14,12:00:00,480.52,2546,7877,10423
2022/06/14,12:30:00,480.07,2546,7819,10365
2022/06/14,13:00:00,479.62,2480,7885,10365
2022/06/14,13:30:00,480.3,2524,7983,10507
2022/06/14,14:00:00,480.98,2537,8167,10704
2022/06/14,14:30:00,480.3,2561,8265,10826
2022/06/14,15:00:00,480.3,2356,8374,10730
2022/06/14,15:30:00,480.3,2233,8483,10716
2022/06/14,16:00:00,480.75,1970,8672,10642
2022/06/14,16:30:00,480.07,1715,8922,10637
2022/06/14,17:00:00,480.3,1526,8931,10457
2022/06/14,17:30:00,480.07,1215,9119,10334
2022/06/14,18:00:00,480.52,871,9358,10229
2022/06/14,18:30:00,480.07,556,9513,10069
2022/06/14,19:00:00,480.07,331,9572,9903
2022/06/14,19:30:00,480.52,167,9630,9797
2022/06/14,20:00:00,480.3,171,9732,9903
2022/06/14,20:30:00,480.52,148,9783,9931
2022/06/14,21:00:00,480.07,152,9720,9872
2022/06/14,21:30:00,479.62,141,9650,9791
2022/06/14,22:00:00,480.07,138,9390,9528
2022/06/14,22:30:00,480.07,137,9226,9363
2022/06/14,23:00:00,480.07,134,8970,9104
2022/06/14,23:30:00,480.07,130,8668,8798
2022/06/15,00:00:00,480.52,123,8352,8475
2022/06/15,00:30:00,480.07,125,8084,8209
2022/06/15,01:00:00,480.07,126,7804,7930
2022/06/15,01:30:00,480.3,133,7593,7726
2022/06/15,02:00:00,479.84,148,7429,7577
2022/06/15,02:30:00,480.98,117,7452,7569
2022/06/15,03:00:00,480.3,63,7397,7460
2022/06/15,03:30:00,480.3,24,7303,7327
2022/06/15,04:00:00,480.3,26,7281,7307
2022/06/15,04:30:00,480.98,33,7269,7302
2022/06/15,05:00:00,480.07,35,7316,7351
2022/06/15,05:30:00,480.52,29,7306,7335
2022/06/15,06:00:00,479.39,27,7288,7315
2022/06/15,06:30:00,480.3,50,7436,7486
2022/06/15,07:00:00,479.84,333,7583,7916
2022/06/15,07:30:00,480.3,611,7738,8349
2022/06/15,08:00:00,480.3,1041,7629,8670
2022/06/15,08:30:00,479.84,1296,7861,9157
2022/06/15,09:00:00,480.75,1534,8018,9552
2022/06/15,09:30:00,480.3,1771,8026,9797
2022/06/15,10:00:00,480.07,1985,7996,9981
2022/06/15,10:30:00,480.98,2192,8074,10266
2022/06/15,11:00:00,480.3,2343,8015,10358
2022/06/15,11:30:00,480.75,2516,7997,10513
2022/06/15,12:00:00,480.07,2552,8005,10557
2022/06/15,12:30:00,480.3,2604,8072,10676
2022/06/15,13:00:00,479.62,2619,8053,10672
2022/06/15,13:30:00,480.07,2588,8080,10668
2022/06/15,14:00:00,480.75,2592,8212,10804
2022/06/15,14:30:00,480.98,2575,8339,10914
2022/06/15,15:00:00,480.52,2395,8457,10852
2022/06/15,15:30:00,480.07,2244,8582,10826
2022/06/15,16:00:00,479.84,2069,8648,10717
2022/06/15,16:30:00,480.52,1857,8808,10665
2022/06/15,17:00:00,478.27,1560,8946,10506
2022/06/15,17:30:00,471.08,1258,9140,10398
2022/06/15,18:00:00,486.16,892,9391,10283
2022/06/15,18:30:00,486.16,582,9583,10165
2022/06/15,19:00:00,471.93,332,9653,9985
2022/06/15,19:30:00,471.5,158,9664,9822
2022/06/15,20:00:00,471.08,165,9792,9957
2022/06/15,20:30:00,486.16,162,9800,9962
2022/06/15,21:00:00,486.16,160,9716,9876
2022/06/15,21:30:00,470.24,156,9572,9728
2022/06/15,22:00:00,471.5,153,9354,9507
2022/06/15,22:30:00,474.73,153,9159,9312
2022/06/15,23:00:00,479.62,146,8899,9045
2022/06/15,23:30:00,480.07,139,8614,8753
2022/06/16,00:00:00,480.3,132,8319,8451
2022/06/16,00:30:00,479.84,121,8030,8151
2022/06/16,01:00:00,464.41,122,7780,7902
2022/06/16,01:30:00,464.41,121,7572,7693
2022/06/16,02:00:00,463.61,120,7398,7518
2022/06/16,02:30:00,464.01,119,7270,7389
2022/06/16,03:00:00,463.22,58,7208,7266
2022/06/16,03:30:00,463.61,0,7226,7226
2022/06/16,04:00:00,458.1,0,7179,7179
2022/06/16,04:30:00,456.68,1,7207,7208
2022/06/16,05:00:00,464.41,0,7245,7245
2022/06/16,05:30:00,465.66,0,7230,7230
2022/06/16,06:00:00,464.01,0,7204,7204
2022/06/16,06:30:00,464.41,23,7321,7344
2022/06/16,07:00:00,464.01,303,7484,7787
2022/06/16,07:30:00,464.41,606,7664,8270
2022/06/16,08:00:00,464.82,979,7910,8889
2022/06/16,08:30:00,465.23,1312,8054,9366
2022/06/16,09:00:00,465.23,1604,8025,9629
2022/06/16,09:30:00,464.41,1841,8037,9878
2022/06/16,10:00:00,465.23,2097,7991,10088
2022/06/16,10:30:00,464.82,2253,8072,10325
2022/06/16,11:00:00,465.66,2411,8083,10494
2022/06/16,11:30:00,466.09,2540,8168,10708
2022/06/16,12:00:00,464.41,2592,8254,10846
2022/06/16,12:30:00,465.66,2583,8407,10990
2022/06/16,13:00:00,464.01,2606,8564,11170
2022/06/16,13:30:00,464.41,2612,8761,11373
2022/06/16,14:00:00,464.01,2576,8820,11396
2022/06/16,14:30:00,464.01,2559,9019,11578
2022/06/16,15:00:00,464.41,2347,9038,11385
2022/06/16,15:30:00,464.01,2210,9152,11362
2022/06/16,16:00:00,464.41,1980,9273,11253
2022/06/16,16:30:00,463.61,1746,9453,11199
2022/06/16,17:00:00,463.22,1443,9566,11009
2022/06/16,17:30:00,497.13,1138,9752,10890
2022/06/16,18:00:00,493.68,771,10000,10771
2022/06/16,18:30:00,480.76,476,10135,10611
2022/06/16,19:00:00,477.73,247,10181,10428
2022/06/16,19:30:00,487.05,104,10091,10195
2022/06/16,20:00:00,490.32,128,10187,10315
2022/06/16,20:30:00,480.76,129,10159,10288
2022/06/16,21:00:00,483.87,126,10003,10129
2022/06/16,21:30:00,477.73,129,9841,9970
2022/06/16,22:00:00,480.76,131,9622,9753
2022/06/16,22:30:00,463.22,132,9368,9500
2022/06/16,23:00:00,463.22,129,9147,9276
2022/06/16,23:30:00,463.61,131,8853,8984
2022/06/17,00:00:00,463.22,134,8624,8758
2022/06/17,00:30:00,463.22,137,8362,8499
2022/06/17,01:00:00,463.61,146,8159,8305
2022/06/17,01:30:00,462.46,150,7980,8130
2022/06/17,02:00:00,462.46,148,7796,7944
2022/06/17,02:30:00,462.46,86,7712,7798
2022/06/17,03:00:00,462.46,8,7631,7639
2022/06/17,03:30:00,460.66,15,7535,7550
2022/06/17,04:00:00,461.01,16,7466,7482
2022/06/17,04:30:00,460.66,28,7427,7455
2022/06/17,05:00:00,461.01,22,7439,7461
2022/06/17,05:30:00,462.09,26,7320,7346
2022/06/17,06:00:00,460.32,21,7342,7363
2022/06/17,06:30:00,460.66,139,7484,7623
2022/06/17,07:00:00,461.01,305,7539,7844
2022/06/17,07:30:00,461.72,531,7610,8141
2022/06/17,08:00:00,460.66,794,7605,8399
2022/06/17,08:30:00,461.72,1065,7649,8714
2022/06/17,09:00:00,461.36,1425,7649,9074
2022/06/17,09:30:00,462.46,1798,7523,9321
2022/06/17,10:00:00,460.66,2058,7467,9525
2022/06/17,10:30:00,461.36,2204,7513,9717
2022/06/17,11:00:00,460.66,2414,7622,10036
2022/06/17,11:30:00,460.66,2552,7752,10304
2022/06/17,12:00:00,461.01,2586,7802,10388
2022/06/17,12:30:00,461.01,2596,7975,10571
2022/06/17,13:00:00,461.01,2616,8110,10726
2022/06/17,13:30:00,460.66,2591,8202,10793
2022/06/17,14:00:00,460.66,2595,8245,10840
2022/06/17,14:30:00,461.36,2542,8371,10913
2022/06/17,15:00:00,461.01,2333,8497,10830
2022/06/17,15:30:00,460.66,2186,8648,10834
2022/06/17,16:00:00,461.36,1923,8652,10575
2022/06/17,16:30:00,462.46,1682,8730,10412
2022/06/17,17:00:00,461.01,1386,8987,10373
2022/06/17,17:30:00,462.09,1097,9309,10406
2022/06/17,18:00:00,493.84,746,9569,10315
2022/06/17,18:30:00,497.29,539,9803,10342
2022/06/17,19:00:00,497.29,288,9926,10214
2022/06/17,19:30:00,493.84,150,9800,9950
2022/06/17,20:00:00,498.31,178,9791,9969
2022/06/17,20:30:00,490.51,179,9774,9953
2022/06/17,21:00:00,484,181,9620,9801
2022/06/17,21:30:00,497.29,160,9436,9596
2022/06/17,22:00:00,461.01,144,9280,9424
2022/06/17,22:30:00,461.01,160,9102,9262
2022/06/17,23:00:00,461.36,144,8931,9075
2022/06/17,23:30:00,461.01,144,8737,8881
2022/06/18,00:00:00,461.36,154,8541,8695
2022/06/18,00:30:00,461.01,125,8326,8451
2022/06/18,01:00:00,462.84,34,8143,8177
2022/06/18,01:30:00,460.32,14,8035,8049
2022/06/18,02:00:00,462.09,13,7839,7852
2022/06/18,02:30:00,465.23,10,7696,7706
2022/06/18,03:00:00,464.41,10,7657,7667
2022/06/18,03:30:00,465.66,15,7576,7591
2022/06/18,04:00:00,464.01,16,7531,7547
2022/06/18,04:30:00,465.23,10,7632,7642
2022/06/18,05:00:00,464.82,9,7670,7679
2022/06/18,05:30:00,464.41,12,7599,7611
2022/06/18,06:00:00,464.82,13,7374,7387
2022/06/18,06:30:00,464.82,26,7333,7359
2022/06/18,07:00:00,464.01,311,7207,7518
2022/06/18,07:30:00,465.66,518,7153,7671
2022/06/18,08:00:00,463.22,712,7005,7717
2022/06/18,08:30:00,464.41,920,7010,7930
2022/06/18,09:00:00,464.01,1357,6825,8182
2022/06/18,09:30:00,465.23,1664,6811,8475
2022/06/18,10:00:00,462.84,2030,6747,8777
2022/06/18,10:30:00,464.01,2215,6852,9067
2022/06/18,11:00:00,464.41,2405,6853,9258
2022/06/18,11:30:00,465.23,2554,6869,9423
2022/06/18,12:00:00,464.41,2609,6934,9543
2022/06/18,12:30:00,464.01,2631,7051,9682
2022/06/18,13:00:00,463.22,2635,7169,9804
2022/06/18,13:30:00,464.01,2629,7292,9921
2022/06/18,14:00:00,463.61,2586,7298,9884
2022/06/18,14:30:00,464.01,2596,7315,9911
2022/06/18,15:00:00,463.61,2367,7432,9799
2022/06/18,15:30:00,463.61,2242,7567,9809
2022/06/18,16:00:00,464.41,2031,7784,9815
2022/06/18,16:30:00,463.61,1832,8074,9906
2022/06/18,17:00:00,464.82,1554,8245,9799
2022/06/18,17:30:00,462.84,1244,8530,9774
2022/06/18,18:00:00,464.82,876,8819,9695
2022/06/18,18:30:00,462.84,576,9063,9639
2022/06/18,19:00:00,464.01,339,9258,9597
2022/06/18,19:30:00,462.84,165,9364,9529
2022/06/18,20:00:00,463.61,174,9535,9709
2022/06/18,20:30:00,463.61,169,9669,9838
2022/06/18,21:00:00,464.82,174,9684,9858
2022/06/18,21:30:00,464.82,182,9623,9805
2022/06/18,22:00:00,464.41,181,9472,9653
2022/06/18,22:30:00,464.01,195,9338,9533
2022/06/18,23:00:00,461.36,205,9120,9325
2022/06/18,23:30:00,465.23,200,8808,9008
2022/06/19,00:00:00,464.41,213,8453,8666
2022/06/19,00:30:00,464.01,216,8132,8348
2022/06/19,01:00:00,463.22,209,7917,8126
2022/06/19,01:30:00,464.41,215,7655,7870
2022/06/19,02:00:00,463.61,213,7477,7690
2022/06/19,02:30:00,463.61,204,7308,7512
2022/06/19,03:00:00,464.01,163,7233,7396
2022/06/19,03:30:00,464.41,101,7365,7466
2022/06/19,04:00:00,465.66,93,7424,7517
2022/06/19,04:30:00,464.41,90,7518,7608
2022/06/19,05:00:00,464.41,68,7546,7614
2022/06/19,05:30:00,465.66,71,7501,7572
2022/06/19,06:00:00,464.82,61,7461,7522
2022/06/19,06:30:00,465.23,77,7709,7786
2022/06/19,07:00:00,465.23,351,7899,8250
2022/06/19,07:30:00,464.01,609,8198,8807
2022/06/19,08:00:00,464.82,816,8338,9154
2022/06/19,08:30:00,465.23,1067,8498,9565
2022/06/19,09:00:00,465.23,1434,8380,9814
2022/06/19,09:30:00,465.23,1820,8234,10054
2022/06/19,10:00:00,464.82,2120,8027,10147
2022/06/19,10:30:00,464.41,2278,7998,10276
2022/06/19,11:00:00,464.82,2469,7998,10467
2022/06/19,11:30:00,464.82,2564,7894,10458
2022/06/19,12:00:00,464.01,2643,7873,10516
2022/06/19,12:30:00,464.82,2661,7996,10657
2022/06/19,13:00:00,464.82,2658,8107,10765
2022/06/19,13:30:00,464.41,2672,8254,10926
2022/06/19,14:00:00,464.82,2630,8395,11025
2022/06/19,14:30:00,464.41,2644,8572,11216
2022/06/19,15:00:00,463.61,2455,8689,11144
2022/06/19,15:30:00,464.01,2303,8788,11091
2022/06/19,16:00:00,464.41,2111,8865,10976
2022/06/19,16:30:00,464.01,1891,9017,10908
2022/06/19,17:00:00,487.13,1616,9121,10737
2022/06/19,17:30:00,462.84,1307,9300,10607
2022/06/19,18:00:00,464.41,927,9523,10450
2022/06/19,18:30:00,462.46,610,9677,10287
2022/06/19,19:00:00,464.41,365,9789,10154
2022/06/19,19:30:00,462.09,188,9725,9913
2022/06/19,20:00:00,464.01,197,9882,10079
2022/06/19,20:30:00,462.46,204,9888,10092
2022/06/19,21:00:00,462.84,203,9811,10014
2022/06/19,21:30:00,463.22,207,9641,9848
2022/06/19,22:00:00,463.22,198,9450,9648
2022/06/19,22:30:00,462.84,191,9232,9423
2022/06/19,23:00:00,463.61,189,8945,9134
2022/06/19,23:30:00,464.01,192,8624,8816
2022/06/20,00:00:00,462.46,189,8342,8531
2022/06/20,00:30:00,463.61,194,8020,8214
2022/06/20,01:00:00,463.22,191,7688,7879
2022/06/20,01:30:00,465.66,180,7518,7698
2022/06/20,02:00:00,462.84,174,7394,7568
2022/06/20,02:30:00,463.22,180,7260,7440
2022/06/20,03:00:00,462.09,130,7284,7414
2022/06/20,03:30:00,465.66,74,7245,7319
2022/06/20,04:00:00,465.66,90,7229,7319
2022/06/20,04:30:00,464.41,89,7409,7498
2022/06/20,05:00:00,464.01,95,7422,7517
2022/06/20,05:30:00,464.82,85,7391,7476
2022/06/20,06:00:00,464.82,84,7436,7520
2022/06/20,06:30:00,465.23,103,7500,7603
2022/06/20,07:00:00,464.01,375,7730,8105
2022/06/20,07:30:00,465.23,567,7993,8560
2022/06/20,08:00:00,465.23,860,8023,8883
2022/06/20,08:30:00,465.66,1282,8027,9309
2022/06/20,09:00:00,466.09,1692,7888,9580
2022/06/20,09:30:00,465.23,1924,7874,9798
2022/06/20,10:00:00,464.82,2229,7694,9923
2022/06/20,10:30:00,465.66,2340,7676,10016
2022/06/20,11:00:00,460.66,2517,7698,10215
2022/06/20,11:30:00,464.82,2653,7656,10309
2022/06/20,12:00:00,463.61,2716,7684,10400
2022/06/20,12:30:00,463.61,2733,7842,10575
2022/06/20,13:00:00,463.61,2753,7781,10534
2022/06/20,13:30:00,463.61,2694,7946,10640
2022/06/20,14:00:00,463.61,2688,7970,10658
2022/06/20,14:30:00,462.46,2687,8126,10813
2022/06/20,15:00:00,463.22,2555,8193,10748
2022/06/20,15:30:00,462.46,2370,8333,10703
2022/06/20,16:00:00,462.84,2184,8388,10572
2022/06/20,16:30:00,462.84,1941,8591,10532
2022/06/20,17:00:00,462.46,1648,8759,10407
2022/06/20,17:30:00,490.06,1341,8930,10271
2022/06/20,18:00:00,463.22,977,9156,10133
2022/06/20,18:30:00,490.06,630,9344,9974
2022/06/20,19:00:00,463.22,388,9437,9825
2022/06/20,19:30:00,463.22,189,9460,9649
2022/06/20,20:00:00,497.85,198,9626,9824
2022/06/20,20:30:00,497.85,188,9644,9832
2022/06/20,21:00:00,462.84,184,9567,9751
2022/06/20,21:30:00,462.84,186,9419,9605
2022/06/20,22:00:00,463.22,179,9258,9437
2022/06/20,22:30:00,463.22,192,9038,9230
2022/06/20,23:00:00,463.22,187,8760,8947
2022/06/20,23:30:00,461.72,183,8449,8632
2022/06/21,00:00:00,463.22,187,8173,8360
2022/06/21,00:30:00,463.61,189,7941,8130
2022/06/21,01:00:00,464.82,177,7651,7828
2022/06/21,01:30:00,461.01,185,7515,7700
2022/06/21,02:00:00,461.72,191,7325,7516
2022/06/21,02:30:00,460.66,188,7259,7447
2022/06/21,03:00:00,461.36,172,7186,7358
2022/06/21,03:30:00,460.66,72,7199,7271
2022/06/21,04:00:00,460.32,77,7097,7174
2022/06/21,04:30:00,461.72,94,7092,7186
2022/06/21,05:00:00,461.36,85,7151,7236
2022/06/21,05:30:00,459.66,88,7191,7279
2022/06/21,06:00:00,457.23,89,7310,7399
2022/06/21,06:30:00,456.42,105,7578,7683
2022/06/21,07:00:00,458.4,431,7716,8147
2022/06/21,07:30:00,457.81,642,7954,8596
2022/06/21,08:00:00,464.01,907,8080,8987
2022/06/21,08:30:00,465.23,1177,8055,9232
2022/06/21,09:00:00,464.41,1440,8022,9462
2022/06/21,09:30:00,465.23,1762,7932,9694
2022/06/21,10:00:00,465.23,2143,7686,9829
2022/06/21,10:30:00,464.01,2371,7842,10213
2022/06/21,11:00:00,464.82,2516,7798,10314
2022/06/21,11:30:00,464.82,2653,7736,10389
2022/06/21,12:00:00,465.23,2703,7800,10503
2022/06/21,12:30:00,465.23,2745,7776,10521
2022/06/21,13:00:00,465.23,2745,7776,10521
2022/06/21,13:30:00,463.61,2740,7705,10445
2022/06/21,14:00:00,464.82,2733,7846,10579
2022/06/21,14:30:00,464.82,2682,8004,10686
2022/06/21,15:00:00,465.23,2484,8100,10584
2022/06/21,15:30:00,465.23,2370,8159,10529
2022/06/21,16:00:00,464.82,2203,8218,10421
2022/06/21,16:30:00,463.22,1921,8454,10375
2022/06/21,17:00:00,464.82,1652,8502,10154
2022/06/21,17:30:00,463.61,1307,8657,9964
2022/06/21,18:00:00,464.82,949,8875,9824
2022/06/21,18:30:00,463.61,663,9026,9689
2022/06/21,19:00:00,463.22,415,9127,9542
2022/06/21,19:30:00,463.61,231,9192,9423
2022/06/21,20:00:00,462.84,222,9359,9581
2022/06/21,20:30:00,463.61,205,9399,9604
2022/06/21,21:00:00,463.61,215,9298,9513
2022/06/21,21:30:00,464.01,224,9106,9330
2022/06/21,22:00:00,464.41,210,9012,9222
2022/06/21,22:30:00,462.84,195,8807,9002
2022/06/21,23:00:00,462.46,178,8599,8777
2022/06/21,23:30:00,463.22,184,8324,8508
2022/06/22,00:00:00,463.61,171,8066,8237
2022/06/22,00:30:00,464.82,162,7781,7943
2022/06/22,01:00:00,463.22,164,7597,7761
2022/06/22,01:30:00,464.01,162,7525,7687
2022/06/22,02:00:00,465.66,149,7414,7563
2022/06/22,02:30:00,465.66,84,7361,7445
2022/06/22,03:00:00,464.82,34,7263,7297
2022/06/22,03:30:00,464.82,33,7247,7280
2022/06/22,04:00:00,464.41,30,7247,7277
2022/06/22,04:30:00,466.52,27,7228,7255
2022/06/22,05:00:00,465.23,33,7276,7309
2022/06/22,05:30:00,463.61,27,7293,7320
2022/06/22,06:00:00,465.66,21,7335,7356
2022/06/22,06:30:00,464.01,50,7372,7422
2022/06/22,07:00:00,464.41,332,7498,7830
2022/06/22,07:30:00,465.23,573,7704,8277
2022/06/22,08:00:00,465.23,796,7856,8652
2022/06/22,08:30:00,464.82,1028,7958,8986
2022/06/22,09:00:00,465.23,1221,8218,9439
2022/06/22,09:30:00,464.01,1302,8216,9518
2022/06/22,10:00:00,465.66,1425,8117,9542
2022/06/22,10:30:00,464.82,1437,8134,9571
2022/06/22,11:00:00,464.82,1674,8088,9762
2022/06/22,11:30:00,464.41,1846,8094,9940
2022/06/22,12:00:00,464.41,1889,8136,10025
2022/06/22,12:30:00,464.41,2090,8139,10229
2022/06/22,13:00:00,464.41,2108,8250,10358
2022/06/22,13:30:00,465.23,2305,8250,10555
2022/06/22,14:00:00,463.61,2358,8371,10729
2022/06/22,14:30:00,465.23,2407,8443,10850
2022/06/22,15:00:00,465.23,2359,8480,10839
2022/06/22,15:30:00,465.23,2234,8568,10802
2022/06/22,16:00:00,463.61,2101,8647,10748
2022/06/22,16:30:00,465.23,1887,8867,10754
2022/06/22,17:00:00,464.41,1615,9001,10616
2022/06/22,17:30:00,462.84,1329,9199,10528
2022/06/22,18:00:00,463.61,944,9452,10396
2022/06/22,18:30:00,463.61,612,9663,10275
2022/06/22,19:00:00,464.01,387,9744,10131
2022/06/22,19:30:00,462.84,205,9825,10030
2022/06/22,20:00:00,463.61,196,9959,10155
2022/06/22,20:30:00,463.61,186,10009,10195
2022/06/22,21:00:00,463.22,111,10035,10146
2022/06/22,21:30:00,462.84,45,9957,10002
2022/06/22,22:00:00,463.61,41,9540,9581
2022/06/22,22:30:00,462.84,28,9528,9556
2022/06/22,23:00:00,462.46,16,9270,9286
2022/06/22,23:30:00,462.84,23,9005,9028
2022/06/23,00:00:00,462.84,19,8703,8722
2022/06/23,00:30:00,462.84,13,8402,8415
2022/06/23,01:00:00,460.66,12,8111,8123
2022/06/23,01:30:00,463.22,11,7911,7922
2022/06/23,02:00:00,462.46,9,7730,7739
2022/06/23,02:30:00,460.32,8,7593,7601
2022/06/23,03:00:00,461.36,7,7606,7613
2022/06/23,03:30:00,457.81,4,7570,7574
2022/06/23,04:00:00,460.32,2,7639,7641
2022/06/23,04:30:00,460.32,1,7646,7647
2022/06/23,05:00:00,460.32,1,7701,7702
2022/06/23,05:30:00,460.66,1,7678,7679
2022/06/23,06:00:00,460.66,0,7672,7672
2022/06/23,06:30:00,460.32,15,7780,7795
2022/06/23,07:00:00,460.32,291,7923,8214
2022/06/23,07:30:00,460.32,531,8178,8709
2022/06/23,08:00:00,459.99,793,8285,9078
2022/06/23,08:30:00,460.32,1317,8229,9546
2022/06/23,09:00:00,464.01,1675,8226,9901
2022/06/23,09:30:00,464.82,1893,8277,10170
2022/06/23,10:00:00,464.41,2150,8289,10439
2022/06/23,10:30:00,464.41,2308,8332,10640
2022/06/23,11:00:00,464.01,2476,8394,10870
2022/06/23,11:30:00,464.01,2615,8492,11107
2022/06/23,12:00:00,464.01,2660,8580,11240
2022/06/23,12:30:00,464.01,2639,8757,11396
2022/06/23,13:00:00,464.82,2640,8900,11540
2022/06/23,13:30:00,463.22,2649,8930,11579
2022/06/23,14:00:00,464.82,2657,8952,11609
2022/06/23,14:30:00,464.82,2671,9095,11766
2022/06/23,15:00:00,464.82,2427,9180,11607
2022/06/23,15:30:00,464.41,2319,9299,11618
2022/06/23,16:00:00,464.01,2108,9339,11447
2022/06/23,16:30:00,464.41,1933,9485,11418
2022/06/23,17:00:00,464.01,1613,9590,11203
2022/06/23,17:30:00,464.01,1313,9775,11088
2022/06/23,18:00:00,464.01,939,9979,10918
2022/06/23,18:30:00,464.41,607,10123,10730
2022/06/23,19:00:00,498.13,366,10240,10606
2022/06/23,19:30:00,497.22,178,10193,10371
2022/06/23,20:00:00,494.13,202,10279,10481
2022/06/23,20:30:00,490.94,214,10232,10446
2022/06/23,21:00:00,494.03,207,10117,10324
2022/06/23,21:30:00,464.41,195,9929,10124
2022/06/23,22:00:00,464.01,169,9707,9876
2022/06/23,22:30:00,457.81,168,9472,9640
2022/06/23,23:00:00,458.4,166,9209,9375
2022/06/23,23:30:00,459.99,183,8866,9049
2022/06/24,00:00:00,459.66,174,8648,8822
2022/06/24,00:30:00,457.52,163,8381,8544
2022/06/24,01:00:00,459.34,168,8133,8301
2022/06/24,01:30:00,459.66,175,7914,8089
2022/06/24,02:00:00,461.36,176,7707,7883
2022/06/24,02:30:00,457.81,191,7556,7747
2022/06/24,03:00:00,456.96,165,7581,7746
2022/06/24,03:30:00,458.4,18,7609,7627
2022/06/24,04:00:00,458.4,14,7566,7580
2022/06/24,04:30:00,458.71,13,7511,7524
2022/06/24,05:00:00,458.4,8,7511,7519
2022/06/24,05:30:00,459.99,7,7444,7451
2022/06/24,06:00:00,457.52,6,7462,7468
2022/06/24,06:30:00,459.02,25,7467,7492
2022/06/24,07:00:00,458.71,321,7424,7745
2022/06/24,07:30:00,464.41,637,7430,8067
2022/06/24,08:00:00,465.23,1019,7317,8336
2022/06/24,08:30:00,463.22,1347,7309,8656
2022/06/24,09:00:00,463.22,1670,7387,9057
2022/06/24,09:30:00,463.22,1911,7472,9383
2022/06/24,10:00:00,463.61,2115,7557,9672
2022/06/24,10:30:00,463.61,2275,7657,9932
2022/06/24,11:00:00,464.01,2494,7794,10288
2022/06/24,11:30:00,463.22,2623,7957,10580
2022/06/24,12:00:00,463.61,2661,8066,10727
2022/06/24,12:30:00,462.84,2688,8312,11000
2022/06/24,13:00:00,463.61,2677,8294,10971
2022/06/24,13:30:00,463.61,2684,8281,10965
2022/06/24,14:00:00,463.22,2676,8350,11026
2022/06/24,14:30:00,463.61,2685,8412,11097
2022/06/24,15:00:00,463.61,2468,8440,10908
2022/06/24,15:30:00,463.61,2318,8552,10870
2022/06/24,16:00:00,463.22,2101,8708,10809
2022/06/24,16:30:00,463.61,1927,8857,10784
2022/06/24,17:00:00,463.61,1600,9122,10722
2022/06/24,17:30:00,463.61,1309,9411,10720
2022/06/24,18:00:00,463.22,940,9756,10696
2022/06/24,18:30:00,463.61,596,10111,10707
2022/06/24,19:00:00,483.61,364,10248,10612
2022/06/24,19:30:00,490.06,165,10164,10329
2022/06/24,20:00:00,493.41,169,10130,10299
2022/06/24,20:30:00,496.86,159,10090,10249
2022/06/24,21:00:00,480.51,180,9892,10072
2022/06/24,21:30:00,462.84,187,9698,9885
2022/06/24,22:00:00,464.41,185,9519,9704
2022/06/24,22:30:00,462.46,191,9333,9524
2022/06/24,23:00:00,463.22,173,9174,9347
2022/06/24,23:30:00,463.22,160,8977,9137
2022/06/25,00:00:00,462.84,180,8712,8892
2022/06/25,00:30:00,463.22,181,8456,8637
2022/06/25,01:00:00,462.84,151,8303,8454
2022/06/25,01:30:00,462.84,136,8055,8191
2022/06/25,02:00:00,463.61,138,7888,8026
2022/06/25,02:30:00,461.36,130,7814,7944
2022/06/25,03:00:00,462.84,127,7694,7821
2022/06/25,03:30:00,462.09,32,7618,7650
2022/06/25,04:00:00,463.22,9,7660,7669
2022/06/25,04:30:00,462.84,12,7554,7566
2022/06/25,05:00:00,463.22,12,7535,7547
2022/06/25,05:30:00,463.22,5,7438,7443
2022/06/25,06:00:00,462.46,3,7263,7266
2022/06/25,06:30:00,462.09,24,7136,7160
2022/06/25,07:00:00,461.01,298,7299,7597
2022/06/25,07:30:00,463.61,584,7148,7732
2022/06/25,08:00:00,462.84,920,6952,7872
2022/06/25,08:30:00,464.41,1275,6907,8182
2022/06/25,09:00:00,462.09,1616,6887,8503
2022/06/25,09:30:00,464.41,1814,6930,8744
2022/06/25,10:00:00,462.84,2069,6975,9044
2022/06/25,10:30:00,464.41,2215,7103,9318
2022/06/25,11:00:00,462.84,2389,7231,9620
2022/06/25,11:30:00,464.41,2500,7279,9779
2022/06/25,12:00:00,462.84,2541,7389,9930
2022/06/25,12:30:00,464.82,2555,7451,10006
2022/06/25,13:00:00,462.84,2416,7682,10098
2022/06/25,13:30:00,464.01,2479,7667,10146
2022/06/25,14:00:00,463.22,2481,7666,10147
2022/06/25,14:30:00,463.22,2456,7693,10149
2022/06/25,15:00:00,463.61,2402,7745,10147
2022/06/25,15:30:00,465.23,2195,7863,10058
2022/06/25,16:00:00,465.66,2000,7981,9981
2022/06/25,16:30:00,461.72,1775,8194,9969
2022/06/25,17:00:00,464.82,1583,8354,9937
2022/06/25,17:30:00,463.61,1199,8601,9800
2022/06/25,18:00:00,465.23,861,8888,9749
2022/06/25,18:30:00,463.22,589,9081,9670
2022/06/25,19:00:00,466.09,355,8951,9306
2022/06/25,19:30:00,463.61,190,8982,9172
2022/06/25,20:00:00,466.09,226,9121,9347
2022/06/25,20:30:00,462.09,229,9222,9451
2022/06/25,21:00:00,463.61,212,9184,9396
2022/06/25,21:30:00,463.22,193,9178,9371
2022/06/25,22:00:00,463.61,189,9081,9270
2022/06/25,22:30:00,462.84,171,9036,9207
2022/06/25,23:00:00,464.01,170,8815,8985
2022/06/25,23:30:00,462.46,164,8585,8749
2022/06/26,00:00:00,462.84,158,8402,8560
2022/06/26,00:30:00,462.84,184,8111,8295
2022/06/26,01:00:00,463.61,187,7865,8052
2022/06/26,01:30:00,463.22,181,7670,7851
2022/06/26,02:00:00,463.61,195,7430,7625
2022/06/26,02:30:00,463.22,130,7343,7473
2022/06/26,03:00:00,463.22,81,7273,7354
2022/06/26,03:30:00,461.72,76,7225,7301
2022/06/26,04:00:00,462.46,54,7154,7208
2022/06/26,04:30:00,462.84,49,7252,7301
2022/06/26,05:00:00,463.22,34,7274,7308
2022/06/26,05:30:00,462.46,40,7309,7349
2022/06/26,06:00:00,463.22,28,7274,7302
2022/06/26,06:30:00,464.82,39,7382,7421
2022/06/26,07:00:00,464.01,313,7727,8040
2022/06/26,07:30:00,463.22,583,8009,8592
2022/06/26,08:00:00,463.61,950,8089,9039
2022/06/26,08:30:00,463.22,1198,8282,9480
2022/06/26,09:00:00,463.22,1515,8310,9825
2022/06/26,09:30:00,464.01,1741,8185,9926
2022/06/26,10:00:00,464.01,2165,8018,10183
2022/06/26,10:30:00,464.41,2337,8048,10385
2022/06/26,11:00:00,463.22,2471,8149,10620
2022/06/26,11:30:00,462.46,2660,8251,10911
2022/06/26,12:00:00,463.22,2668,8202,10870
2022/06/26,12:30:00,462.84,2666,8265,10931
2022/06/26,13:00:00,463.61,2703,8313,11016
2022/06/26,13:30:00,463.22,2711,8459,11170
2022/06/26,14:00:00,463.22,2754,8594,11348
2022/06/26,14:30:00,462.84,2688,8647,11335
2022/06/26,15:00:00,465.66,2523,8650,11173
2022/06/26,15:30:00,462.46,2378,8747,11125
2022/06/26,16:00:00,485.8,2165,8882,11047
2022/06/26,16:30:00,463.61,1974,9075,11049
2022/06/26,17:00:00,456.68,1660,9305,10965
2022/06/26,17:30:00,448.23,1345,9443,10788
2022/06/26,18:00:00,449.41,971,9707,10678
2022/06/26,18:30:00,484.66,642,9951,10593
2022/06/26,19:00:00,449.68,368,10063,10431
2022/06/26,19:30:00,449.66,188,10074,10262
2022/06/26,20:00:00,449.73,179,10223,10402
2022/06/26,20:30:00,449.81,171,10294,10465
2022/06/26,21:00:00,449.73,162,10203,10365
2022/06/26,21:30:00,449.75,156,10098,10254
2022/06/26,22:00:00,449.24,158,9872,10030
2022/06/26,22:30:00,448.71,148,9640,9788
2022/06/26,23:00:00,464.41,133,9341,9474
2022/06/26,23:30:00,463.22,128,8997,9125
2022/06/27,00:00:00,462.84,129,8717,8846
2022/06/27,00:30:00,462.09,129,8427,8556
2022/06/27,01:00:00,462.46,124,8183,8307
2022/06/27,01:30:00,459.34,123,7909,8032
2022/06/27,02:00:00,463.61,127,7742,7869
2022/06/27,02:30:00,462.09,117,7594,7711
2022/06/27,03:00:00,462.09,55,7714,7769
2022/06/27,03:30:00,463.61,5,7658,7663
2022/06/27,04:00:00,462.09,6,7681,7687
2022/06/27,04:30:00,461.72,3,7620,7623
2022/06/27,05:00:00,461.72,1,7666,7667
2022/06/27,05:30:00,462.09,1,7663,7664
2022/06/27,06:00:00,463.22,2,7633,7635
2022/06/27,06:30:00,462.46,25,7915,7940
2022/06/27,07:00:00,462.46,306,8095,8401
2022/06/27,07:30:00,462.84,595,8287,8882
2022/06/27,08:00:00,462.46,980,8292,9272
2022/06/27,08:30:00,462.84,1339,8391,9730
2022/06/27,09:00:00,462.46,1682,8403,10085
2022/06/27,09:30:00,462.84,1890,8377,10267
2022/06/27,10:00:00,461.36,2145,8368,10513
2022/06/27,10:30:00,461.72,2308,8362,10670
2022/06/27,11:00:00,461.01,2471,8439,10910
2022/06/27,11:30:00,462.46,2583,8440,11023
2022/06/27,12:00:00,462.09,2646,8528,11174
2022/06/27,12:30:00,461.01,2626,8621,11247
2022/06/27,13:00:00,461.72,2656,8796,11452
2022/06/27,13:30:00,463.61,2607,8848,11455
2022/06/27,14:00:00,462.84,2603,8991,11594
2022/06/27,14:30:00,463.61,2594,9008,11602
2022/06/27,15:00:00,463.61,2445,9088,11533
2022/06/27,15:30:00,463.22,2290,9242,11532
2022/06/27,16:00:00,462.84,1967,9414,11381
2022/06/27,16:30:00,453.41,1835,9524,11359
2022/06/27,17:00:00,487.2,1590,9632,11222
2022/06/27,17:30:00,497.81,1270,9819,11089
2022/06/27,18:00:00,487.6,908,10033,10941
2022/06/27,18:30:00,490.66,585,10170,10755
2022/06/27,19:00:00,481.9,347,10206,10553
2022/06/27,19:30:00,482.48,162,10167,10329
2022/06/27,20:00:00,497.81,158,10304,10462
2022/06/27,20:30:00,497.81,150,10378,10528
2022/06/27,21:00:00,490.75,135,10297,10432
2022/06/27,21:30:00,484.63,138,10133,10271
2022/06/27,22:00:00,449.12,132,9927,10059
2022/06/27,22:30:00,487.43,131,9716,9847
2022/06/27,23:00:00,493.28,130,9416,9546
2022/06/27,23:30:00,462.84,134,9155,9289
2022/06/28,00:00:00,461.72,129,8793,8922
2022/06/28,00:30:00,462.46,125,8551,8676
2022/06/28,01:00:00,455.9,133,8231,8364
2022/06/28,01:30:00,457.23,134,7981,8115
2022/06/28,02:00:00,457.23,132,7872,8004
2022/06/28,02:30:00,457.23,108,7751,7859
2022/06/28,03:00:00,457.52,7,7696,7703
2022/06/28,03:30:00,456.96,6,7762,7768
2022/06/28,04:00:00,457.23,7,7705,7712
2022/06/28,04:30:00,456.96,6,7750,7756
2022/06/28,05:00:00,457.23,4,7716,7720
2022/06/28,05:30:00,457.23,2,7713,7715
2022/06/28,06:00:00,457.81,1,7668,7669
2022/06/28,06:30:00,457.52,19,7945,7964
2022/06/28,07:00:00,457.23,289,8038,8327
2022/06/28,07:30:00,457.81,581,8258,8839
2022/06/28,08:00:00,464.82,983,8225,9208
2022/06/28,08:30:00,465.66,1281,8390,9671
2022/06/28,09:00:00,465.66,1626,8453,10079
2022/06/28,09:30:00,464.41,1794,8494,10288
2022/06/28,10:00:00,460.66,2069,8476,10545
2022/06/28,10:30:00,461.36,2153,8510,10663
2022/06/28,11:00:00,461.01,2314,8486,10800
2022/06/28,11:30:00,459.02,2564,8555,11119
2022/06/28,12:00:00,458.71,2564,8643,11207
2022/06/28,12:30:00,461.72,2584,8666,11250
2022/06/28,13:00:00,459.02,2593,8797,11390
2022/06/28,13:30:00,459.34,2571,8825,11396
2022/06/28,14:00:00,459.02,2565,9007,11572
2022/06/28,14:30:00,458.71,2585,9126,11711
2022/06/28,15:00:00,458.4,2393,9283,11676
2022/06/28,15:30:00,458.4,2305,9397,11702
2022/06/28,16:00:00,458.71,2066,9548,11614
2022/06/28,16:30:00,452.84,1860,9679,11539
2022/06/28,17:00:00,448.87,1504,9823,11327
2022/06/28,17:30:00,2512.99,1276,9901,11177
2022/06/28,18:00:00,2484.69,919,10126,11045
2022/06/28,18:30:00,2484.69,582,10321,10903
2022/06/28,19:00:00,2484.69,345,10360,10705
2022/06/28,19:30:00,2512.99,157,10339,10496
2022/06/28,20:00:00,2512.99,156,10440,10596
2022/06/28,20:30:00,2512.99,163,10436,10599
2022/06/28,21:00:00,2512.99,163,10362,10525
2022/06/28,21:30:00,498.1,160,10223,10383
2022/06/28,22:00:00,498.1,158,10026,10184
2022/06/28,22:30:00,487.84,153,9849,10002
2022/06/28,23:00:00,464.41,148,9528,9676
2022/06/28,23:30:00,465.23,144,9216,9360
2022/06/29,00:00:00,464.01,139,8917,9056
2022/06/29,00:30:00,463.61,144,8597,8741
2022/06/29,01:00:00,464.41,126,8319,8445
2022/06/29,01:30:00,464.01,124,8104,8228
2022/06/29,02:00:00,463.61,124,7913,8037
2022/06/29,02:30:00,464.41,124,7763,7887
2022/06/29,03:00:00,462.46,78,7836,7914
2022/06/29,03:30:00,464.41,3,7798,7801
2022/06/29,04:00:00,465.23,4,7778,7782
2022/06/29,04:30:00,465.66,3,7745,7748
2022/06/29,05:00:00,464.82,3,7783,7786
2022/06/29,05:30:00,464.82,2,7755,7757
2022/06/29,06:00:00,464.82,2,7686,7688
2022/06/29,06:30:00,464.01,22,7950,7972
2022/06/29,07:00:00,464.01,283,8094,8377
2022/06/29,07:30:00,464.01,555,8289,8844
2022/06/29,08:00:00,464.82,837,8395,9232
2022/06/29,08:30:00,464.41,1115,8570,9685
2022/06/29,09:00:00,463.61,1621,8469,10090
2022/06/29,09:30:00,464.41,1899,8411,10310
2022/06/29,10:00:00,464.41,2164,8383,10547
2022/06/29,10:30:00,464.82,2298,8414,10712
2022/06/29,11:00:00,464.01,2492,8409,10901
2022/06/29,11:30:00,464.41,2587,8469,11056
2022/06/29,12:00:00,464.01,2638,8542,11180
2022/06/29,12:30:00,464.41,2653,8642,11295
2022/06/29,13:00:00,464.01,2676,8766,11442
2022/06/29,13:30:00,464.01,2685,8957,11642
2022/06/29,14:00:00,464.01,2653,9158,11811
2022/06/29,14:30:00,464.01,2623,9202,11825
2022/06/29,15:00:00,464.82,2412,9152,11564
2022/06/29,15:30:00,465.23,2298,9317,11615
2022/06/29,16:00:00,464.41,2113,9422,11535
2022/06/29,16:30:00,487.64,1929,9574,11503
2022/06/29,17:00:00,497.89,1631,9686,11317
2022/06/29,17:30:00,497.89,1333,9889,11222
2022/06/29,18:00:00,497.89,962,10098,11060
2022/06/29,18:30:00,490.83,617,10278,10895
2022/06/29,19:00:00,487.8,384,10320,10704
2022/06/29,19:30:00,497.89,200,10306,10506
2022/06/29,20:00:00,497.89,194,10381,10575
2022/06/29,20:30:00,484.92,178,10396,10574
2022/06/29,21:00:00,487.72,179,10310,10489
2022/06/29,21:30:00,464.82,171,10168,10339
2022/06/29,22:00:00,465.66,163,9866,10029
2022/06/29,22:30:00,464.82,156,9734,9890
2022/06/29,23:00:00,464.82,150,9441,9591
2022/06/29,23:30:00,464.01,147,9126,9273
2022/06/30,00:00:00,464.82,148,8834,8982
2022/06/30,00:30:00,464.82,141,8557,8698
2022/06/30,01:00:00,464.41,138,8293,8431
2022/06/30,01:30:00,464.41,135,8040,8175
2022/06/30,02:00:00,464.41,131,7869,8000
2022/06/30,02:30:00,464.01,77,7736,7813
2022/06/30,03:00:00,465.23,4,7852,7856
2022/06/30,03:30:00,464.01,2,7762,7764
2022/06/30,04:00:00,464.41,1,7695,7696
2022/06/30,04:30:00,464.41,1,7675,7676
2022/06/30,05:00:00,464.01,2,7691,7693
2022/06/30,05:30:00,465.23,2,7697,7699
2022/06/30,06:00:00,464.41,1,7737,7738
2022/06/30,06:30:00,464.01,23,7878,7901
2022/06/30,07:00:00,464.41,269,8020,8289
2022/06/30,07:30:00,464.41,553,8221,8774
2022/06/30,08:00:00,464.82,944,8166,9110
2022/06/30,08:30:00,464.01,1318,8304,9622
2022/06/30,09:00:00,464.82,1669,8339,10008
2022/06/30,09:30:00,464.41,1881,8372,10253
2022/06/30,10:00:00,464.82,2151,8379,10530
2022/06/30,10:30:00,464.01,2306,8405,10711
2022/06/30,11:00:00,463.61,2506,8411,10917
2022/06/30,11:30:00,463.61,2589,8423,11012
2022/06/30,12:00:00,464.41,2674,8446,11120
2022/06/30,12:30:00,464.41,2649,8625,11274
2022/06/30,13:00:00,464.01,2702,8640,11342
2022/06/30,13:30:00,464.01,2688,8679,11367
2022/06/30,14:00:00,464.41,2654,8765,11419
2022/06/30,14:30:00,464.01,2653,8961,11614
2022/06/30,15:00:00,464.9,2467,9040,11507
2022/06/30,15:30:00,464.01,2350,9188,11538
2022/06/30,16:00:00,464.01,2151,9243,11394
2022/06/30,16:30:00,464.82,1942,9469,11411
2022/06/30,17:00:00,464.82,1636,9588,11224
2022/06/30,17:30:00,464.82,1332,9788,11120
2022/06/30,18:00:00,464.41,961,10040,11001
2022/06/30,18:30:00,496.65,637,10211,10848
2022/06/30,19:00:00,493.56,400,10290,10690
2022/06/30,19:30:00,487.64,217,10261,10478
2022/06/30,20:00:00,497.56,214,10309,10523
2022/06/30,20:30:00,487.53,218,10322,10540
2022/06/30,21:00:00,497.56,210,10177,10387
2022/06/30,21:30:00,497.56,196,9974,10170
2022/06/30,22:00:00,490.42,176,9772,9948
2022/06/30,22:30:00,484.45,172,9575,9747
2022/06/30,23:00:00,497.56,179,9295,9474
2022/06/30,23:30:00,467.34,170,9048,9218
2022/07/01,00:00:00,489,174,8766,8940
2022/07/01,00:30:00,487.73,177,8524,8701
2022/07/01,01:00:00,488.57,181,8279,8460
2022/07/01,01:30:00,488.57,177,8090,8267
2022/07/01,02:00:00,488.57,185,7862,8047
2022/07/01,02:30:00,489,192,7700,7892
2022/07/01,03:00:00,488.57,87,7656,7743
2022/07/01,03:30:00,487.32,90,7537,7627
2022/07/01,04:00:00,488.15,81,7462,7543
2022/07/01,04:30:00,488.57,77,7586,7663
2022/07/01,05:00:00,488.15,82,7521,7603
2022/07/01,05:30:00,487.32,89,7456,7545
2022/07/01,06:00:00,487.32,78,7335,7413
2022/07/01,06:30:00,487.73,97,7294,7391
2022/07/01,07:00:00,488.57,355,7414,7769
2022/07/01,07:30:00,487.32,623,7441,8064
2022/07/01,08:00:00,488.15,956,7343,8299
2022/07/01,08:30:00,487.32,1280,7372,8652
2022/07/01,09:00:00,486.91,1669,7352,9021
2022/07/01,09:30:00,487.73,1881,7414,9295
2022/07/01,10:00:00,489,2160,7375,9535
2022/07/01,10:30:00,489,2307,7453,9760
2022/07/01,11:00:00,489.44,2511,7522,10033
2022/07/01,11:30:00,489.44,2560,7605,10165
2022/07/01,12:00:00,489.44,2669,7707,10376
2022/07/01,12:30:00,489.44,2681,7790,10471
2022/07/01,13:00:00,488.57,2678,7900,10578
2022/07/01,13:30:00,489,2673,8002,10675
2022/07/01,14:00:00,489.44,2663,8106,10769
2022/07/01,14:30:00,489,2659,8206,10865
2022/07/01,15:00:00,487.32,2425,8285,10710
2022/07/01,15:30:00,487.32,2303,8417,10720
2022/07/01,16:00:00,484.21,2069,8671,10740
2022/07/01,16:30:00,484.62,1807,8982,10789
2022/07/01,17:00:00,484.26,1650,9136,10786
2022/07/01,17:30:00,497.94,1332,9280,10612
2022/07/01,18:00:00,490.79,965,9518,10483
2022/07/01,18:30:00,487.82,649,9813,10462
2022/07/01,19:00:00,489.44,404,10012,10416
2022/07/01,19:30:00,497.94,213,10183,10396
2022/07/01,20:00:00,487.73,233,10150,10383
2022/07/01,20:30:00,490.91,227,10069,10296
2022/07/01,21:00:00,487.82,226,9752,9978
2022/07/01,21:30:00,486.91,216,9508,9724
2022/07/01,22:00:00,486.12,207,9342,9549
2022/07/01,22:30:00,486.52,216,9212,9428
2022/07/01,23:00:00,486.91,220,9070,9290
2022/07/01,23:30:00,486.52,214,8870,9084
2022/07/02,00:00:00,486.91,222,8598,8820
2022/07/02,00:30:00,484.99,216,8399,8615
2022/07/02,01:00:00,484.74,205,8290,8495
2022/07/02,01:30:00,490.34,197,8099,8296
2022/07/02,02:00:00,489.44,194,7867,8061
2022/07/02,02:30:00,484.21,195,7750,7945
2022/07/02,03:00:00,483.69,82,7703,7785
2022/07/02,03:30:00,490.34,82,7649,7731
2022/07/02,04:00:00,487.73,88,7563,7651
2022/07/02,04:30:00,490.34,100,7501,7601
2022/07/02,05:00:00,487.73,79,7518,7597
2022/07/02,05:30:00,489.44,79,7354,7433
2022/07/02,06:00:00,487.73,81,7255,7336
2022/07/02,06:30:00,487.32,91,7241,7332
2022/07/02,07:00:00,485.74,363,7118,7481
2022/07/02,07:30:00,488.15,575,7006,7581
2022/07/02,08:00:00,488.15,861,6939,7800
2022/07/02,08:30:00,488.15,1155,7015,8170
2022/07/02,09:00:00,487.73,1595,6924,8519
2022/07/02,09:30:00,486.52,1890,6836,8726
2022/07/02,10:00:00,487.73,2169,6869,9038
2022/07/02,10:30:00,487.73,2299,6928,9227
2022/07/02,11:00:00,487.32,2442,6964,9406
2022/07/02,11:30:00,487.32,2556,7022,9578
2022/07/02,12:00:00,487.73,2666,7076,9742
2022/07/02,12:30:00,486.91,2727,7189,9916
2022/07/02,13:00:00,487.73,2713,7252,9965
2022/07/02,13:30:00,486.91,2695,7331,10026
2022/07/02,14:00:00,486.91,2674,7414,10088
2022/07/02,14:30:00,487.32,2672,7478,10150
2022/07/02,15:00:00,486.52,2469,7508,9977
2022/07/02,15:30:00,486.91,2334,7654,9988
2022/07/02,16:00:00,486.91,2063,7994,10057
2022/07/02,16:30:00,486.91,1957,8121,10078
2022/07/02,17:00:00,487.73,1659,8401,10060
2022/07/02,17:30:00,486.91,1379,8693,10072
2022/07/02,18:00:00,487.32,984,9008,9992
2022/07/02,18:30:00,487.32,661,9315,9976
2022/07/02,19:00:00,486.12,415,9496,9911
2022/07/02,19:30:00,486.91,220,9502,9722
2022/07/02,20:00:00,486.91,232,9699,9931
2022/07/02,20:30:00,487.73,225,9803,10028
2022/07/02,21:00:00,487.73,223,9787,10010
2022/07/02,21:30:00,486.91,211,9758,9969
2022/07/02,22:00:00,487.32,212,9671,9883
2022/07/02,22:30:00,486.91,214,9503,9717
2022/07/02,23:00:00,486.52,208,9343,9551
2022/07/02,23:30:00,487.73,206,9044,9250
2022/07/03,00:00:00,487.32,205,8751,8956
2022/07/03,00:30:00,487.73,195,8484,8679
2022/07/03,01:00:00,488.57,190,8201,8391
2022/07/03,01:30:00,488.57,188,7915,8103
2022/07/03,02:00:00,486.91,198,7689,7887
2022/07/03,02:30:00,486.91,196,7741,7937
2022/07/03,03:00:00,486.52,196,7591,7787
2022/07/03,03:30:00,487.32,76,7660,7736
2022/07/03,04:00:00,486.91,70,7561,7631
2022/07/03,04:30:00,485.36,63,7587,7650
2022/07/03,05:00:00,486.52,57,7626,7683
2022/07/03,05:30:00,486.52,52,7631,7683
2022/07/03,06:00:00,487.32,54,7625,7679
2022/07/03,06:30:00,486.91,66,7813,7879
2022/07/03,07:00:00,487.32,344,7916,8260
2022/07/03,07:30:00,486.91,692,8104,8796
2022/07/03,08:00:00,487.73,1056,8205,9261
2022/07/03,08:30:00,487.73,1359,8391,9750
2022/07/03,09:00:00,487.32,1647,8565,10212
2022/07/03,09:30:00,487.73,1838,8607,10445
2022/07/03,10:00:00,487.32,2122,8632,10754
2022/07/03,10:30:00,486.52,2269,8701,10970
2022/07/03,11:00:00,486.91,2449,8704,11153
2022/07/03,11:30:00,487.73,2585,8736,11321
2022/07/03,12:00:00,488.15,2668,8783,11451
2022/07/03,12:30:00,487.32,2688,8936,11624
2022/07/03,13:00:00,486.52,2679,9024,11703
2022/07/03,13:30:00,487.32,2686,9175,11861
2022/07/03,14:00:00,486.91,2546,9461,12007
2022/07/03,14:30:00,488.15,2615,9512,12127
2022/07/03,15:00:00,487.32,2389,9600,11989
2022/07/03,15:30:00,488.15,2178,9793,11971
2022/07/03,16:00:00,487.73,2101,9795,11896
2022/07/03,16:30:00,498.05,1892,9998,11890
2022/07/03,17:00:00,490.92,1596,10051,11647
2022/07/03,17:30:00,487.96,1312,10204,11516
2022/07/03,18:00:00,491.07,952,10429,11381
2022/07/03,18:30:00,498.05,641,10548,11189
2022/07/03,19:00:00,498.05,382,10631,11013
2022/07/03,19:30:00,491.18,195,10626,10821
2022/07/03,20:00:00,498.05,190,10717,10907
2022/07/03,20:30:00,488.24,188,10736,10924
2022/07/03,21:00:00,481.69,174,10676,10850
2022/07/03,21:30:00,498.05,174,10551,10725
2022/07/03,22:00:00,487.73,161,10310,10471
2022/07/03,22:30:00,489,160,10022,10182
2022/07/03,23:00:00,489.44,159,9670,9829
2022/07/03,23:30:00,489,156,9382,9538
2022/07/04,00:00:00,489,140,9052,9192
2022/07/04,00:30:00,487.32,88,8774,8862
2022/07/04,01:00:00,488.57,26,8608,8634
2022/07/04,01:30:00,487.73,31,8344,8375
2022/07/04,02:00:00,488.57,32,8179,8211
2022/07/04,02:30:00,485.74,36,8043,8079
2022/07/04,03:00:00,488.15,28,7865,7893
2022/07/04,03:30:00,486.91,21,7831,7852
2022/07/04,04:00:00,486.52,18,7791,7809
2022/07/04,04:30:00,489,18,7699,7717
2022/07/04,05:00:00,487.32,17,7775,7792
2022/07/04,05:30:00,487.73,17,7749,7766
2022/07/04,06:00:00,482.89,19,7676,7695
2022/07/04,06:30:00,485.36,35,7912,7947
2022/07/04,07:00:00,484.26,306,8064,8370
2022/07/04,07:30:00,484.26,613,8202,8815
2022/07/04,08:00:00,484.99,1046,8235,9281
2022/07/04,08:30:00,484.99,1315,8385,9700
2022/07/04,09:00:00,483.18,1671,8734,10405
2022/07/04,09:30:00,482.68,1874,8839,10713
2022/07/04,10:00:00,482.68,2143,8858,11001
2022/07/04,10:30:00,483.69,2271,8850,11121
2022/07/04,11:00:00,482.68,2428,8898,11326
2022/07/04,11:30:00,483.18,2538,9036,11574
2022/07/04,12:00:00,483.18,2551,9160,11711
2022/07/04,12:30:00,482.89,2590,9197,11787
2022/07/04,13:00:00,486.12,2687,9236,11923
2022/07/04,13:30:00,485.36,2673,9533,12206
2022/07/04,14:00:00,474.46,2669,9706,12375
2022/07/04,14:30:00,472.38,2639,9821,12460
2022/07/04,15:00:00,472.62,2444,9933,12377
2022/07/04,15:30:00,472.62,2347,10059,12406
2022/07/04,16:00:00,471.43,2083,10136,12219
2022/07/04,16:30:00,471.74,1936,10201,12137
2022/07/04,17:00:00,472.4,1643,10211,11854
2022/07/04,17:30:00,488.02,1311,10437,11748
2022/07/04,18:00:00,472.23,961,10649,11610
2022/07/04,18:30:00,497.9,622,10787,11409
2022/07/04,19:00:00,497.9,369,10868,11237
2022/07/04,19:30:00,497.9,192,10833,11025
2022/07/04,20:00:00,488.34,193,10894,11087
2022/07/04,20:30:00,497.9,202,10908,11110
2022/07/04,21:00:00,497.9,200,10842,11042
2022/07/04,21:30:00,485.3,189,10705,10894
2022/07/04,22:00:00,488.13,195,10514,10709
2022/07/04,22:30:00,484.74,196,10221,10417
2022/07/04,23:00:00,485.27,192,9883,10075
2022/07/04,23:30:00,485.27,198,9543,9741
2022/07/05,00:00:00,489.88,187,9236,9423
2022/07/05,00:30:00,489,180,8939,9119
2022/07/05,01:00:00,488.57,171,8633,8804
2022/07/05,01:30:00,489,177,8415,8592
2022/07/05,02:00:00,489.88,178,8210,8388
2022/07/05,02:30:00,489.44,170,8206,8376
2022/07/05,03:00:00,489.88,116,8298,8414
2022/07/05,03:30:00,489,57,8210,8267
2022/07/05,04:00:00,489.44,58,8133,8191
2022/07/05,04:30:00,489.44,58,8113,8171
2022/07/05,05:00:00,489.44,56,8098,8154
2022/07/05,05:30:00,489,73,8087,8160
2022/07/05,06:00:00,489.44,81,8022,8103
2022/07/05,06:30:00,489.44,92,8219,8311
2022/07/05,07:00:00,489.44,349,8328,8677
2022/07/05,07:30:00,489.44,663,8526,9189
2022/07/05,08:00:00,489,1070,8557,9627
2022/07/05,08:30:00,489.44,1293,8821,10114
2022/07/05,09:00:00,489.44,1692,8821,10513
2022/07/05,09:30:00,488.57,1912,8936,10848
2022/07/05,10:00:00,488.57,2139,8911,11050
2022/07/05,10:30:00,489,2328,8868,11196
2022/07/05,11:00:00,488.57,2458,8865,11323
2022/07/05,11:30:00,489,2645,8999,11644
2022/07/05,12:00:00,489.44,2681,9048,11729
2022/07/05,12:30:00,489.88,2714,9024,11738
2022/07/05,13:00:00,489.44,2767,9128,11895
2022/07/05,13:30:00,489,2766,9212,11978
2022/07/05,14:00:00,488.15,2628,9448,12076
2022/07/05,14:30:00,488.15,2689,9478,12167
2022/07/05,15:00:00,488.15,2488,9580,12068
2022/07/05,15:30:00,488.15,2348,9643,11991
2022/07/05,16:00:00,488.57,2164,9743,11907
2022/07/05,16:30:00,481.3,1922,9982,11904
2022/07/05,17:00:00,472.24,1658,10106,11764
2022/07/05,17:30:00,471.42,1339,10340,11679
2022/07/05,18:00:00,472.43,961,10546,11507
2022/07/05,18:30:00,472.63,775,10703,11478
2022/07/05,19:00:00,482.63,379,10766,11145
2022/07/05,19:30:00,488.2,207,10695,10902
2022/07/05,20:00:00,482.75,200,10817,11017
2022/07/05,20:30:00,488.2,200,10799,10999
2022/07/05,21:00:00,491.13,195,10702,10897
2022/07/05,21:30:00,491.07,199,10617,10816
2022/07/05,22:00:00,489.44,212,10392,10604
2022/07/05,22:30:00,488.15,214,10103,10317
2022/07/05,23:00:00,483.18,198,9871,10069
2022/07/05,23:30:00,487.73,190,9645,9835
2022/07/06,00:00:00,483.69,188,9255,9443
2022/07/06,00:30:00,486.12,176,8985,9161
2022/07/06,01:00:00,487.73,178,8691,8869
2022/07/06,01:30:00,486.12,185,8582,8767
2022/07/06,02:00:00,488.15,179,8389,8568
2022/07/06,02:30:00,485.36,177,8218,8395
2022/07/06,03:00:00,488.57,126,8131,8257
2022/07/06,03:30:00,486.12,66,8213,8279
2022/07/06,04:00:00,488.57,58,8161,8219
2022/07/06,04:30:00,485.36,58,8141,8199
2022/07/06,05:00:00,488.15,59,8166,8225
2022/07/06,05:30:00,485.36,60,8135,8195
2022/07/06,06:00:00,488.57,65,8101,8166
2022/07/06,06:30:00,486.12,75,8279,8354
2022/07/06,07:00:00,488.15,336,8454,8790
2022/07/06,07:30:00,488.15,591,8675,9266
2022/07/06,08:00:00,488.15,990,8700,9690
2022/07/06,08:30:00,489,1322,8807,10129
2022/07/06,09:00:00,488.15,1671,8808,10479
2022/07/06,09:30:00,488.15,1857,8851,10708
2022/07/06,10:00:00,487.73,2185,8800,10985
2022/07/06,10:30:00,488.15,2355,8765,11120
2022/07/06,11:00:00,488.57,2484,8626,11110
2022/07/06,11:30:00,488.57,2639,8673,11312
2022/07/06,12:00:00,489,2683,8632,11315
2022/07/06,12:30:00,488.15,2713,8691,11404
2022/07/06,13:00:00,488.15,2703,8828,11531
2022/07/06,13:30:00,488.15,2721,9013,11734
2022/07/06,14:00:00,487.73,2726,9062,11788
2022/07/06,14:30:00,488.15,2695,9164,11859
2022/07/06,15:00:00,489,2464,9299,11763
2022/07/06,15:30:00,489,2368,9361,11729
2022/07/06,16:00:00,498.22,2169,9454,11623
2022/07/06,16:30:00,498.22,1977,9660,11637
2022/07/06,17:00:00,498.22,1674,9765,11439
2022/07/06,17:30:00,498.22,1366,9999,11365
2022/07/06,18:00:00,498.22,987,10249,11236
2022/07/06,18:30:00,491.33,660,10401,11061
2022/07/06,19:00:00,498.22,411,10456,10867
2022/07/06,19:30:00,498.22,184,10510,10694
2022/07/06,20:00:00,498.22,177,10635,10812
2022/07/06,20:30:00,498.22,195,10601,10796
2022/07/06,21:00:00,498.22,210,10515,10725
2022/07/06,21:30:00,498.22,216,10457,10673
2022/07/06,22:00:00,483.18,217,10235,10452
2022/07/06,22:30:00,482.68,209,9975,10184
2022/07/06,23:00:00,483.69,203,9662,9865
2022/07/06,23:30:00,488.15,199,9522,9721
2022/07/07,00:00:00,488.15,202,9172,9374
2022/07/07,00:30:00,488.57,190,8922,9112
2022/07/07,01:00:00,489.44,178,8656,8834
2022/07/07,01:30:00,489.44,166,8440,8606
2022/07/07,02:00:00,489.44,167,8193,8360
2022/07/07,02:30:00,488.15,171,8035,8206
2022/07/07,03:00:00,488.57,171,8185,8356
2022/07/07,03:30:00,487.73,165,8134,8299
2022/07/07,04:00:00,488.57,168,8047,8215
2022/07/07,04:30:00,489,107,8080,8187
2022/07/07,05:00:00,488.57,60,8128,8188
2022/07/07,05:30:00,488.57,61,8128,8189
2022/07/07,06:00:00,489.44,54,8102,8156
2022/07/07,06:30:00,489,57,8266,8323
2022/07/07,07:00:00,489,319,8424,8743
2022/07/07,07:30:00,489.44,556,8652,9208
2022/07/07,08:00:00,489,796,8784,9580
2022/07/07,08:30:00,489,1046,9068,10114
2022/07/07,09:00:00,489,1541,8916,10457
2022/07/07,09:30:00,489.88,1766,8855,10621
2022/07/07,10:00:00,488.57,2067,8753,10820
2022/07/07,10:30:00,489,2286,8682,10968
2022/07/07,11:00:00,489,2459,8743,11202
2022/07/07,11:30:00,488.57,2624,8816,11440
2022/07/07,12:00:00,488.57,2662,8631,11293
2022/07/07,12:30:00,489,2700,8697,11397
2022/07/07,13:00:00,489,2713,8829,11542
2022/07/07,13:30:00,489.88,2708,8933,11641
2022/07/07,14:00:00,489,2655,8963,11618
2022/07/07,14:30:00,488.15,2643,9012,11655
2022/07/07,15:00:00,489,2438,9360,11798
2022/07/07,15:30:00,488.57,2337,9451,11788
2022/07/07,16:00:00,485.36,2146,9520,11666
2022/07/07,16:30:00,488.15,1951,9735,11686
2022/07/07,17:00:00,488.57,1687,9871,11558
2022/07/07,17:30:00,488.57,1381,10111,11492
2022/07/07,18:00:00,498.25,993,10352,11345
2022/07/07,18:30:00,498.25,664,10552,11216
2022/07/07,19:00:00,489.44,420,10631,11051
2022/07/07,19:30:00,498.25,214,10631,10845
2022/07/07,20:00:00,498.25,217,10688,10905
2022/07/07,20:30:00,498.25,216,10643,10859
2022/07/07,21:00:00,488.57,215,10538,10753
2022/07/07,21:30:00,498.25,224,10420,10644
2022/07/07,22:00:00,488.57,224,10128,10352
2022/07/07,22:30:00,489,213,9903,10116
2022/07/07,23:00:00,489.44,206,9621,9827
2022/07/07,23:30:00,488.57,207,9295,9502
2022/07/08,00:00:00,488.57,202,9052,9254
2022/07/08,00:30:00,488.57,195,8790,8985
2022/07/08,01:00:00,487.73,189,8513,8702
2022/07/08,01:30:00,487.32,193,8295,8488
2022/07/08,02:00:00,487.73,190,8070,8260
2022/07/08,02:30:00,488.57,182,8045,8227
2022/07/08,03:00:00,488.15,75,8141,8216
2022/07/08,03:30:00,489,74,8000,8074
2022/07/08,04:00:00,488.15,68,7935,8003
2022/07/08,04:30:00,489,66,7874,7940
2022/07/08,05:00:00,489,64,7807,7871
2022/07/08,05:30:00,488.57,59,7724,7783
2022/07/08,06:00:00,488.57,59,7521,7580
2022/07/08,06:30:00,489.44,73,7530,7603
2022/07/08,07:00:00,489.44,322,7411,7733
2022/07/08,07:30:00,489,693,7355,8048
2022/07/08,08:00:00,489,1061,7259,8320
2022/07/08,08:30:00,489,1352,7272,8624
2022/07/08,09:00:00,489,1673,7315,8988
2022/07/08,09:30:00,489,1892,7402,9294
2022/07/08,10:00:00,488.57,2181,7449,9630
2022/07/08,10:30:00,489.44,2329,7523,9852
2022/07/08,11:00:00,488.15,2479,7632,10111
2022/07/08,11:30:00,488.15,2599,7758,10357
2022/07/08,12:00:00,488.57,2683,7847,10530
2022/07/08,12:30:00,486.12,2695,7844,10539
2022/07/08,13:00:00,486.91,2708,7821,10529
2022/07/08,13:30:00,487.73,2648,7985,10633
2022/07/08,14:00:00,487.32,2659,8139,10798
2022/07/08,14:30:00,487.73,2642,8223,10865
2022/07/08,15:00:00,486.12,2413,8393,10806
2022/07/08,15:30:00,488.57,2290,8546,10836
2022/07/08,16:00:00,489.88,2085,8762,10847
2022/07/08,16:30:00,488.57,1909,8953,10862
2022/07/08,17:00:00,489,1626,9231,10857
2022/07/08,17:30:00,488.57,1295,9591,10886
2022/07/08,18:00:00,488.57,944,9925,10869
2022/07/08,18:30:00,489,628,10294,10922
2022/07/08,19:00:00,488.57,386,10445,10831
2022/07/08,19:30:00,489.44,187,10397,10584
2022/07/08,20:00:00,489,187,10223,10410
2022/07/08,20:30:00,487.73,188,10126,10314
2022/07/08,21:00:00,487.32,192,9975,10167
2022/07/08,21:30:00,488.15,191,9741,9932
2022/07/08,22:00:00,487.32,178,9562,9740
2022/07/08,22:30:00,486.91,183,9373,9556
2022/07/08,23:00:00,486.91,169,9198,9367
2022/07/08,23:30:00,487.73,167,8975,9142
2022/07/09,00:00:00,487.32,139,8782,8921
2022/07/09,00:30:00,486.52,93,8613,8706
2022/07/09,01:00:00,487.73,49,8458,8507
2022/07/09,01:30:00,488.15,55,8277,8332
2022/07/09,02:00:00,487.32,49,8094,8143
2022/07/09,02:30:00,488.57,53,7931,7984
2022/07/09,03:00:00,489,56,7817,7873
2022/07/09,03:30:00,489,68,7808,7876
2022/07/09,04:00:00,488.57,63,7751,7814
2022/07/09,04:30:00,489.44,53,7709,7762
2022/07/09,05:00:00,488.57,52,7666,7718
2022/07/09,05:30:00,489,50,7584,7634
2022/07/09,06:00:00,488.57,47,7493,7540
2022/07/09,06:30:00,489.44,52,7377,7429
2022/07/09,07:00:00,488.57,299,7229,7528
2022/07/09,07:30:00,489,548,7088,7636
2022/07/09,08:00:00,488.57,833,6919,7752
2022/07/09,08:30:00,488.57,1087,6861,7948
2022/07/09,09:00:00,488.57,1402,6720,8122
2022/07/09,09:30:00,486.91,1689,6628,8317
2022/07/09,10:00:00,489,2094,6549,8643
2022/07/09,10:30:00,487.32,2264,6581,8845
2022/07/09,11:00:00,486.91,2464,6600,9064
2022/07/09,11:30:00,486.52,2630,6664,9294
2022/07/09,12:00:00,487.32,2712,6803,9515
2022/07/09,12:30:00,487.32,2728,6792,9520
2022/07/09,13:00:00,487.73,2740,6870,9610
2022/07/09,13:30:00,484.99,2727,7025,9752
2022/07/09,14:00:00,486.52,2715,6949,9664
2022/07/09,14:30:00,484.26,2692,7086,9778
2022/07/09,15:00:00,486.91,2475,7240,9715
2022/07/09,15:30:00,484.26,2389,7400,9789
2022/07/09,16:00:00,486.52,2173,7650,9823
2022/07/09,16:30:00,484.99,1978,7947,9925
2022/07/09,17:00:00,486.52,1659,8217,9876
2022/07/09,17:30:00,484.99,1360,8541,9901
2022/07/09,18:00:00,486.12,1008,8891,9899
2022/07/09,18:30:00,485.74,665,9209,9874
2022/07/09,19:00:00,487.32,412,9393,9805
2022/07/09,19:30:00,485.74,210,9506,9716
2022/07/09,20:00:00,487.32,214,9673,9887
2022/07/09,20:30:00,485.74,231,9765,9996
2022/07/09,21:00:00,488.15,229,9686,9915
2022/07/09,21:30:00,486.12,225,9676,9901
2022/07/09,22:00:00,488.15,217,9535,9752
2022/07/09,22:30:00,487.73,217,9386,9603
2022/07/09,23:00:00,488.57,218,9141,9359
2022/07/09,23:30:00,488.57,205,8897,9102
2022/07/10,00:00:00,487.32,192,8664,8856
2022/07/10,00:30:00,486.12,216,8409,8625
2022/07/10,01:00:00,488.15,229,8151,8380
2022/07/10,01:30:00,486.12,219,7947,8166
2022/07/10,02:00:00,488.15,220,7750,7970
2022/07/10,02:30:00,486.52,221,7725,7946
2022/07/10,03:00:00,486.91,136,7670,7806
2022/07/10,03:30:00,486.52,103,7603,7706
2022/07/10,04:00:00,486.91,82,7597,7679
2022/07/10,04:30:00,486.91,61,7636,7697
2022/07/10,05:00:00,486.91,65,7646,7711
2022/07/10,05:30:00,487.32,72,7615,7687
2022/07/10,06:00:00,486.91,56,7572,7628
2022/07/10,06:30:00,486.52,84,7897,7981
2022/07/10,07:00:00,487.32,343,8017,8360
2022/07/10,07:30:00,487.73,554,8267,8821
2022/07/10,08:00:00,487.73,793,8346,9139
2022/07/10,08:30:00,487.32,1040,8521,9561
2022/07/10,09:00:00,486.91,1533,8405,9938
2022/07/10,09:30:00,487.73,1887,8303,10190
2022/07/10,10:00:00,489.44,2094,8291,10385
2022/07/10,10:30:00,488.15,2277,8248,10525
2022/07/10,11:00:00,489.44,2467,8247,10714
2022/07/10,11:30:00,489.44,2670,8282,10952
2022/07/10,12:00:00,489,2721,8372,11093
2022/07/10,12:30:00,489,2738,8504,11242
2022/07/10,13:00:00,487.73,2745,8376,11121
2022/07/10,13:30:00,487.32,2718,8585,11303
2022/07/10,14:00:00,488.15,2677,8632,11309
2022/07/10,14:30:00,487.73,2665,8732,11397
2022/07/10,15:00:00,489.44,2430,8826,11256
2022/07/10,15:30:00,488.15,2309,8963,11272
2022/07/10,16:00:00,488.15,2126,9088,11214
2022/07/10,16:30:00,488.15,1931,9281,11212
2022/07/10,17:00:00,488.57,1622,9470,11092
2022/07/10,17:30:00,481.69,1284,9688,10972
2022/07/10,18:00:00,482.18,917,9932,10849
2022/07/10,18:30:00,481.69,619,10061,10680
2022/07/10,19:00:00,482.18,367,10135,10502
2022/07/10,19:30:00,481.69,193,10138,10331
2022/07/10,20:00:00,481.69,195,10256,10451
2022/07/10,20:30:00,481.2,185,10265,10450
2022/07/10,21:00:00,481.69,182,10265,10447
2022/07/10,21:30:00,482.68,166,10209,10375
2022/07/10,22:00:00,489.44,165,10019,10184
2022/07/10,22:30:00,487.32,144,9744,9888
2022/07/10,23:00:00,489.88,145,9505,9650
2022/07/10,23:30:00,489.44,153,9156,9309
2022/07/11,00:00:00,489.44,157,8888,9045
2022/07/11,00:30:00,489.44,117,8653,8770
2022/07/11,01:00:00,482.18,61,8495,8556
2022/07/11,01:30:00,489.44,50,8267,8317
2022/07/11,02:00:00,482.18,39,8122,8161
2022/07/11,02:30:00,489,46,7974,8020
2022/07/11,03:00:00,489.44,44,7823,7867
2022/07/11,03:30:00,485.74,46,7917,7963
2022/07/11,04:00:00,488.15,34,7880,7914
2022/07/11,04:30:00,486.91,37,7839,7876
2022/07/11,05:00:00,488.15,40,7855,7895
2022/07/11,05:30:00,486.91,38,7850,7888
2022/07/11,06:00:00,488.15,44,7755,7799
2022/07/11,06:30:00,488.15,66,7899,7965
2022/07/11,07:00:00,488.57,329,8005,8334
2022/07/11,07:30:00,486.52,568,8182,8750
2022/07/11,08:00:00,488.57,861,8243,9104
2022/07/11,08:30:00,487.32,1133,8281,9414
2022/07/11,09:00:00,487.73,1408,8311,9719
2022/07/11,09:30:00,486.52,1738,8219,9957
2022/07/11,10:00:00,486.91,2002,8255,10257
2022/07/11,10:30:00,487.32,2125,8202,10327
2022/07/11,11:00:00,486.91,2324,8146,10470
2022/07/11,11:30:00,486.91,2513,8180,10693
2022/07/11,12:00:00,486.91,2533,8275,10808
2022/07/11,12:30:00,486.52,2552,8333,10885
2022/07/11,13:00:00,485.74,2726,8389,11115
2022/07/11,13:30:00,489,2661,8438,11099
2022/07/11,14:00:00,485.36,2708,8505,11213
2022/07/11,14:30:00,489,2702,8587,11289
2022/07/11,15:00:00,486.91,2456,8571,11027
2022/07/11,15:30:00,488.57,2337,8726,11063
2022/07/11,16:00:00,487.73,2150,8853,11003
2022/07/11,16:30:00,487.32,1983,9027,11010
2022/07/11,17:00:00,487.32,1654,9165,10819
2022/07/11,17:30:00,487.32,1315,9428,10743
2022/07/11,18:00:00,488.43,965,9633,10598
2022/07/11,18:30:00,498.46,610,9845,10455
2022/07/11,19:00:00,498.46,385,9931,10316
2022/07/11,19:30:00,498.46,207,9848,10055
2022/07/11,20:00:00,498.46,205,10003,10208
2022/07/11,20:30:00,498.46,194,10001,10195
2022/07/11,21:00:00,488.55,184,9959,10143
2022/07/11,21:30:00,498.46,178,9863,10041
2022/07/11,22:00:00,486.91,172,9726,9898
2022/07/11,22:30:00,487.32,175,9476,9651
2022/07/11,23:00:00,486.91,165,9221,9386
2022/07/11,23:30:00,487.32,163,8917,9080
2022/07/12,00:00:00,487.73,156,8674,8830
2022/07/12,00:30:00,487.32,163,8421,8584
2022/07/12,01:00:00,486.91,147,8164,8311
2022/07/12,01:30:00,487.32,146,7973,8119
2022/07/12,02:00:00,487.32,141,7802,7943
2022/07/12,02:30:00,486.52,101,7836,7937
2022/07/12,03:00:00,487.32,20,7811,7831
2022/07/12,03:30:00,487.73,22,7705,7727
2022/07/12,04:00:00,489,19,7652,7671
2022/07/12,04:30:00,487.73,20,7640,7660
2022/07/12,05:00:00,488.15,16,7651,7667
2022/07/12,05:30:00,488.15,15,7671,7686
2022/07/12,06:00:00,486.52,12,7622,7634
2022/07/12,06:30:00,487.73,24,7783,7807
2022/07/12,07:00:00,485.74,265,7853,8118
2022/07/12,07:30:00,489,540,8080,8620
2022/07/12,08:00:00,485.36,757,8125,8882
2022/07/12,08:30:00,489,1062,8123,9185
2022/07/12,09:00:00,486.91,1507,8146,9653
2022/07/12,09:30:00,490.34,1845,8105,9950
2022/07/12,10:00:00,486.91,2180,8002,10182
2022/07/12,10:30:00,488.57,2378,7950,10328
2022/07/12,11:00:00,485.74,2547,7972,10519
2022/07/12,11:30:00,487.32,2684,8057,10741
2022/07/12,12:00:00,486.52,2768,8106,10874
2022/07/12,12:30:00,486.12,2786,8253,11039
2022/07/12,13:00:00,486.52,2806,8353,11159
2022/07/12,13:30:00,486.12,2807,8667,11474
2022/07/12,14:00:00,486.12,2781,8687,11468
2022/07/12,14:30:00,486.12,2764,8816,11580
2022/07/12,15:00:00,486.91,2552,8811,11363
2022/07/12,15:30:00,483.91,2438,9007,11445
2022/07/12,16:00:00,488.15,2206,9144,11350
2022/07/12,16:30:00,484.62,2001,9365,11366
2022/07/12,17:00:00,486.91,1695,9504,11199
2022/07/12,17:30:00,485.36,1352,9704,11056
2022/07/12,18:00:00,486.52,986,9948,10934
2022/07/12,18:30:00,486.12,627,10181,10808
2022/07/12,19:00:00,485.74,383,10216,10599
2022/07/12,19:30:00,485.74,199,10194,10393
2022/07/12,20:00:00,485.74,202,10346,10548
2022/07/12,20:30:00,486.91,199,10402,10601
2022/07/12,21:00:00,484.26,201,10341,10542
2022/07/12,21:30:00,487.73,201,10289,10490
2022/07/12,22:00:00,485.36,182,10070,10252
2022/07/12,22:30:00,486.91,176,9871,10047
2022/07/12,23:00:00,486.12,179,9578,9757
2022/07/12,23:30:00,486.12,189,9307,9496
2022/07/13,00:00:00,486.12,180,8999,9179
2022/07/13,00:30:00,485.74,159,8773,8932
2022/07/13,01:00:00,486.12,156,8530,8686
2022/07/13,01:30:00,482.24,162,8225,8387
2022/07/13,02:00:00,487.32,158,8094,8252
2022/07/13,02:30:00,483.91,142,7977,8119
2022/07/13,03:00:00,486.52,90,8035,8125
2022/07/13,03:30:00,485.74,51,7998,8049
2022/07/13,04:00:00,487.73,63,7904,7967
2022/07/13,04:30:00,486.52,73,7902,7975
2022/07/13,05:00:00,487.32,76,7894,7970
2022/07/13,05:30:00,486.91,61,7914,7975
2022/07/13,06:00:00,486.91,58,7870,7928
2022/07/13,06:30:00,486.91,58,8036,8094
2022/07/13,07:00:00,486.52,339,8154,8493
2022/07/13,07:30:00,487.32,571,8431,9002
2022/07/13,08:00:00,486.12,810,8642,9452
2022/07/13,08:30:00,489,995,8857,9852
2022/07/13,09:00:00,486.52,1445,8914,10359
2022/07/13,09:30:00,487.32,1816,8850,10666
2022/07/13,10:00:00,486.12,2157,8753,10910
2022/07/13,10:30:00,486.52,2374,8733,11107
2022/07/13,11:00:00,486.52,2551,8759,11310
2022/07/13,11:30:00,486.52,2698,8826,11524
2022/07/13,12:00:00,486.52,2748,8892,11640
2022/07/13,12:30:00,484.26,2746,9074,11820
2022/07/13,13:00:00,487.32,2805,9197,12002
2022/07/13,13:30:00,486.12,2782,9410,12192
2022/07/13,14:00:00,486.91,2776,9482,12258
2022/07/13,14:30:00,486.91,2751,9476,12227
2022/07/13,15:00:00,486.52,2556,9611,12167
2022/07/13,15:30:00,487.73,2429,9747,12176
2022/07/13,16:00:00,485.74,2231,9898,12129
2022/07/13,16:30:00,486.91,2020,10060,12080
2022/07/13,17:00:00,473.54,1711,10142,11853
2022/07/13,17:30:00,472.24,1376,10311,11687
2022/07/13,18:00:00,471.43,1006,10578,11584
2022/07/13,18:30:00,471.65,663,10753,11416
2022/07/13,19:00:00,471.63,591,10776,11367
2022/07/13,19:30:00,471.4,215,10754,10969
2022/07/13,20:00:00,472.62,218,10844,11062
2022/07/13,20:30:00,472.54,227,10819,11046
2022/07/13,21:00:00,487.73,221,10712,10933
2022/07/13,21:30:00,486.52,216,10658,10874
2022/07/13,22:00:00,488.15,215,10398,10613
2022/07/13,22:30:00,489,203,10107,10310
2022/07/13,23:00:00,486.12,195,9772,9967
2022/07/13,23:30:00,485.74,194,9498,9692
2022/07/14,00:00:00,485.74,182,9158,9340
2022/07/14,00:30:00,485.74,171,8879,9050
2022/07/14,01:00:00,485.36,191,8568,8759
2022/07/14,01:30:00,484.99,195,8343,8538
2022/07/14,02:00:00,484.99,192,8143,8335
2022/07/14,02:30:00,484.99,192,7989,8181
2022/07/14,03:00:00,484.62,146,8204,8350
2022/07/14,03:30:00,484.62,80,8169,8249
2022/07/14,04:00:00,484.99,76,8085,8161
2022/07/14,04:30:00,486.12,70,8092,8162
2022/07/14,05:00:00,482.89,61,8115,8176
2022/07/14,05:30:00,484.99,54,8135,8189
2022/07/14,06:00:00,483.91,55,8082,8137
2022/07/14,06:30:00,484.62,68,8216,8284
2022/07/14,07:00:00,483.91,377,8330,8707
2022/07/14,07:30:00,486.12,573,8557,9130
2022/07/14,08:00:00,485.74,854,8655,9509
2022/07/14,08:30:00,486.12,1186,8776,9962
2022/07/14,09:00:00,489,1466,8751,10217
2022/07/14,09:30:00,486.12,1603,8787,10390
2022/07/14,10:00:00,486.91,2107,8591,10698
2022/07/14,10:30:00,487.32,2296,8515,10811
2022/07/14,11:00:00,486.12,2431,8602,11033
2022/07/14,11:30:00,485.74,2566,8671,11237
2022/07/14,12:00:00,485.74,2752,8671,11423
2022/07/14,12:30:00,485.74,2785,8624,11409
2022/07/14,13:00:00,484.99,2797,8618,11415
2022/07/14,13:30:00,485.36,2801,8843,11644
2022/07/14,14:00:00,486.12,2764,8950,11714
2022/07/14,14:30:00,486.12,2760,9119,11879
2022/07/14,15:00:00,485.36,2514,9257,11771
2022/07/14,15:30:00,485.74,2443,9346,11789
2022/07/14,16:00:00,485.36,2217,9458,11675
2022/07/14,16:30:00,485.74,2015,9678,11693
2022/07/14,17:00:00,485.74,1715,9846,11561
2022/07/14,17:30:00,485.36,1380,10079,11459
2022/07/14,18:00:00,485.74,991,10323,11314
2022/07/14,18:30:00,485.36,661,10454,11115
2022/07/14,19:00:00,485.36,556,10535,11091
2022/07/14,19:30:00,484.99,211,10472,10683
2022/07/14,20:00:00,485.74,205,10569,10774
2022/07/14,20:30:00,485.74,185,10508,10693
2022/07/14,21:00:00,484.99,179,10361,10540
2022/07/14,21:30:00,486.12,182,10364,10546
2022/07/14,22:00:00,486.12,176,10100,10276
2022/07/14,22:30:00,486.12,169,9836,10005
2022/07/14,23:00:00,484.99,180,9599,9779
2022/07/14,23:30:00,486.12,182,9342,9524
2022/07/15,00:00:00,484.99,182,9073,9255
2022/07/15,00:30:00,485.36,123,8881,9004
2022/07/15,01:00:00,486.12,62,8655,8717
2022/07/15,01:30:00,487.32,63,8430,8493
2022/07/15,02:00:00,487.32,72,8267,8339
2022/07/15,02:30:00,487.32,73,8081,8154
2022/07/15,03:00:00,486.91,69,7947,8016
2022/07/15,03:30:00,486.91,77,7849,7926
2022/07/15,04:00:00,487.32,83,7780,7863
2022/07/15,04:30:00,487.32,89,7716,7805
2022/07/15,05:00:00,486.91,87,7713,7800
2022/07/15,05:30:00,487.32,79,7669,7748
2022/07/15,06:00:00,486.52,74,7634,7708
2022/07/15,06:30:00,484.99,74,7667,7741
2022/07/15,07:00:00,485.74,415,7649,8064
2022/07/15,07:30:00,486.52,584,7681,8265
2022/07/15,08:00:00,484.99,916,7617,8533
2022/07/15,08:30:00,485.74,1283,7659,8942
2022/07/15,09:00:00,485.74,1415,7865,9280
2022/07/15,09:30:00,485.36,1658,7867,9525
2022/07/15,10:00:00,484.62,2093,7800,9893
2022/07/15,10:30:00,485.36,2145,7768,9913
2022/07/15,11:00:00,486.12,2390,7870,10260
2022/07/15,11:30:00,486.12,2588,7922,10510
2022/07/15,12:00:00,485.74,2747,7989,10736
2022/07/15,12:30:00,486.12,2744,8123,10867
2022/07/15,13:00:00,485.36,2808,8163,10971
2022/07/15,13:30:00,486.12,2795,8219,11014
2022/07/15,14:00:00,486.12,2773,8336,11109
2022/07/15,14:30:00,485.36,2772,8443,11215
2022/07/15,15:00:00,486.12,2564,8448,11012
2022/07/15,15:30:00,485.74,2452,8507,10959
2022/07/15,16:00:00,485.74,2235,8641,10876
2022/07/15,16:30:00,485.36,2005,8869,10874
2022/07/15,17:00:00,484.99,1696,9120,10816
2022/07/15,17:30:00,486.52,1367,9393,10760
2022/07/15,18:00:00,486.12,999,9744,10743
2022/07/15,18:30:00,486.52,656,10091,10747
2022/07/15,19:00:00,485.74,598,10242,10840
2022/07/15,19:30:00,498.44,216,10165,10381
2022/07/15,20:00:00,488,220,10136,10356
2022/07/15,20:30:00,488,222,10035,10257
2022/07/15,21:00:00,486.12,221,9887,10108
2022/07/15,21:30:00,486.52,218,9715,9933
2022/07/15,22:00:00,486.12,217,9498,9715
2022/07/15,22:30:00,486.12,213,9316,9529
2022/07/15,23:00:00,483.91,207,9158,9365
2022/07/15,23:30:00,487.32,205,8978,9183
2022/07/16,00:00:00,486.12,176,8785,8961
2022/07/16,00:30:00,485.74,137,8585,8722
2022/07/16,01:00:00,485.36,84,8460,8544
2022/07/16,01:30:00,484.26,88,8273,8361
2022/07/16,02:00:00,486.12,75,8138,8213
2022/07/16,02:30:00,486.52,69,8009,8078
2022/07/16,03:00:00,485.36,68,7862,7930
2022/07/16,03:30:00,486.12,62,7735,7797
2022/07/16,04:00:00,486.52,62,7695,7757
2022/07/16,04:30:00,487.32,62,7623,7685
2022/07/16,05:00:00,485.36,49,7621,7670
2022/07/16,05:30:00,485.36,49,7484,7533
2022/07/16,06:00:00,486.12,35,7260,7295
2022/07/16,06:30:00,487.32,42,7157,7199
2022/07/16,07:00:00,484.62,386,7002,7388
2022/07/16,07:30:00,485.74,552,6932,7484
2022/07/16,08:00:00,486.12,904,6631,7535
2022/07/16,08:30:00,485.36,1329,6413,7742
2022/07/16,09:00:00,486.12,1634,6441,8075
2022/07/16,09:30:00,485.74,1852,6509,8361
2022/07/16,10:00:00,484.99,2137,6452,8589
2022/07/16,10:30:00,483.18,2261,6672,8933
2022/07/16,11:00:00,486.12,2417,6698,9115
2022/07/16,11:30:00,485.36,2624,6707,9331
2022/07/16,12:00:00,484.99,2659,6804,9463
2022/07/16,12:30:00,485.74,2638,6886,9524
2022/07/16,13:00:00,485.74,2636,6966,9602
2022/07/16,13:30:00,484.62,2666,7035,9701
2022/07/16,14:00:00,485.74,2641,7160,9801
2022/07/16,14:30:00,484.99,2652,7224,9876
2022/07/16,15:00:00,486.12,2443,7353,9796
2022/07/16,15:30:00,485.36,2400,7513,9913
2022/07/16,16:00:00,485.74,2153,7723,9876
2022/07/16,16:30:00,485.74,1924,8068,9992
2022/07/16,17:00:00,486.52,1641,8286,9927
2022/07/16,17:30:00,485.36,1350,8626,9976
2022/07/16,18:00:00,486.12,962,8948,9910
2022/07/16,18:30:00,486.12,626,9236,9862
2022/07/16,19:00:00,485.74,549,9426,9975
2022/07/16,19:30:00,485.74,206,9497,9703
2022/07/16,20:00:00,485.36,198,9698,9896
2022/07/16,20:30:00,485.74,190,9803,9993
2022/07/16,21:00:00,485.36,182,9771,9953
2022/07/16,21:30:00,487.73,173,9754,9927
2022/07/16,22:00:00,486.91,167,9601,9768
2022/07/16,22:30:00,488.15,168,9490,9658
2022/07/16,23:00:00,488.57,150,9267,9417
2022/07/16,23:30:00,488.57,140,9005,9145
2022/07/17,00:00:00,489.44,104,8930,9034
2022/07/17,00:30:00,489,71,8715,8786
2022/07/17,01:00:00,489,23,8488,8511
2022/07/17,01:30:00,489,20,8230,8250
2022/07/17,02:00:00,488.57,25,8069,8094
2022/07/17,02:30:00,488.15,32,7943,7975
2022/07/17,03:00:00,489,39,7796,7835
2022/07/17,03:30:00,488.57,42,7714,7756
2022/07/17,04:00:00,489,45,7641,7686
2022/07/17,04:30:00,488.15,47,7617,7664
2022/07/17,05:00:00,487.73,38,7636,7674
2022/07/17,05:30:00,488.57,32,7686,7718
2022/07/17,06:00:00,488.15,19,7605,7624
2022/07/17,06:30:00,489,23,7809,7832
2022/07/17,07:00:00,488.57,331,7945,8276
2022/07/17,07:30:00,487.32,539,8285,8824
2022/07/17,08:00:00,486.91,944,8270,9214
2022/07/17,08:30:00,489.44,1374,8191,9565
2022/07/17,09:00:00,489,1683,8233,9916
2022/07/17,09:30:00,488.57,1960,8304,10264
2022/07/17,10:00:00,483.56,2193,8393,10586
2022/07/17,10:30:00,487.32,2351,8452,10803
2022/07/17,11:00:00,489,2549,8398,10947
2022/07/17,11:30:00,489.44,2707,8485,11192
2022/07/17,12:00:00,487.73,2745,8600,11345
2022/07/17,12:30:00,488.57,2771,8688,11459
2022/07/17,13:00:00,489,2800,8842,11642
2022/07/17,13:30:00,488.57,2784,9101,11885
2022/07/17,14:00:00,488.57,2760,9130,11890
2022/07/17,14:30:00,488.57,2755,9244,11999
2022/07/17,15:00:00,488.57,2568,9343,11911
2022/07/17,15:30:00,489,2412,9529,11941
2022/07/17,16:00:00,488.15,2211,9626,11837
2022/07/17,16:30:00,488.57,1989,9861,11850
2022/07/17,17:00:00,480.72,1648,10044,11692
2022/07/17,17:30:00,490.6,1326,10284,11610
2022/07/17,18:00:00,483.69,957,10541,11498
2022/07/17,18:30:00,482.18,619,10696,11315
2022/07/17,19:00:00,487.3,545,10786,11331
2022/07/17,19:30:00,487.54,157,10810,10967
2022/07/17,20:00:00,489.89,166,10959,11125
2022/07/17,20:30:00,497.96,155,10991,11146
2022/07/17,21:00:00,487.54,143,10834,10977
2022/07/17,21:30:00,493.77,131,10722,10853
2022/07/17,22:00:00,497.96,131,10531,10662
2022/07/17,22:30:00,483.69,133,10174,10307
2022/07/17,23:00:00,489.44,135,9924,10059
2022/07/17,23:30:00,487.73,130,9593,9723
2022/07/18,00:00:00,487.32,126,9278,9404
2022/07/18,00:30:00,485.36,90,8999,9089
2022/07/18,01:00:00,485.36,9,8864,8873
2022/07/18,01:30:00,485.36,9,8636,8645
2022/07/18,02:00:00,485.36,9,8406,8415
2022/07/18,02:30:00,486.12,8,8374,8382
2022/07/18,03:00:00,485.36,14,8303,8317
2022/07/18,03:30:00,485.36,12,8208,8220
2022/07/18,04:00:00,484.62,11,8120,8131
2022/07/18,04:30:00,485.36,8,8115,8123
2022/07/18,05:00:00,484.62,9,8112,8121
2022/07/18,05:30:00,485.74,11,8155,8166
2022/07/18,06:00:00,485.36,8,8075,8083
2022/07/18,06:30:00,484.99,15,8303,8318
2022/07/18,07:00:00,484.99,345,8467,8812
2022/07/18,07:30:00,484.62,497,8773,9270
2022/07/18,08:00:00,484.26,865,8756,9621
2022/07/18,08:30:00,484.62,1296,8835,10131
2022/07/18,09:00:00,484.99,1654,8749,10403
2022/07/18,09:30:00,484.99,1951,8827,10778
2022/07/18,10:00:00,484.99,2198,8795,10993
2022/07/18,10:30:00,485.36,2372,8809,11181
2022/07/18,11:00:00,484.62,2551,8934,11485
2022/07/18,11:30:00,484.62,2701,8995,11696
2022/07/18,12:00:00,484.99,2759,9130,11889
2022/07/18,12:30:00,484.26,2770,9264,12034
2022/07/18,13:00:00,484.99,2745,9451,12196
2022/07/18,13:30:00,484.62,2741,9603,12344
2022/07/18,14:00:00,485.74,2743,9737,12480
2022/07/18,14:30:00,484.62,2726,9942,12668
2022/07/18,15:00:00,484.99,2552,10066,12618
2022/07/18,15:30:00,484.62,2397,10241,12638
2022/07/18,16:00:00,484.62,2167,10349,12516
2022/07/18,16:30:00,484.62,1962,10567,12529
2022/07/18,17:00:00,481.92,1641,10770,12411
2022/07/18,17:30:00,498.63,1318,10948,12266
2022/07/18,18:00:00,475.78,930,11161,12091
2022/07/18,18:30:00,485.04,591,11298,11889
2022/07/18,19:00:00,2758.5,543,11365,11908
2022/07/18,19:30:00,2789.9,165,11346,11511
2022/07/18,20:00:00,2789.9,166,11445,11611
2022/07/18,20:30:00,2728.45,162,11433,11595
2022/07/18,21:00:00,2758.5,156,11340,11496
2022/07/18,21:30:00,2758.5,152,11272,11424
2022/07/18,22:00:00,497.67,154,10982,11136
2022/07/18,22:30:00,485.02,150,10669,10819
2022/07/18,23:00:00,489.44,148,10349,10497
2022/07/18,23:30:00,490.34,144,9970,10114
2022/07/19,00:00:00,489.88,141,9631,9772
2022/07/19,00:30:00,489.44,93,9370,9463
2022/07/19,01:00:00,489.44,18,9078,9096
2022/07/19,01:30:00,488.15,17,8923,8940
2022/07/19,02:00:00,486.12,3,8731,8734
2022/07/19,02:30:00,486.52,4,8534,8538
2022/07/19,03:00:00,486.52,3,8538,8541
2022/07/19,03:30:00,486.12,3,8438,8441
2022/07/19,04:00:00,486.52,4,8323,8327
2022/07/19,04:30:00,486.52,4,8332,8336
2022/07/19,05:00:00,487.32,4,8299,8303
2022/07/19,05:30:00,486.12,3,8406,8409
2022/07/19,06:00:00,486.12,4,8341,8345
2022/07/19,06:30:00,486.91,8,8502,8510
2022/07/19,07:00:00,486.91,332,8651,8983
2022/07/19,07:30:00,486.52,527,8897,9424
2022/07/19,08:00:00,486.52,794,9008,9802
2022/07/19,08:30:00,487.32,1158,9244,10402
2022/07/19,09:00:00,487.32,1628,9115,10743
2022/07/19,09:30:00,486.12,1917,9305,11222
2022/07/19,10:00:00,486.91,2155,9272,11427
2022/07/19,10:30:00,486.91,2342,9311,11653
2022/07/19,11:00:00,486.52,2528,9408,11936
2022/07/19,11:30:00,486.12,2657,9512,12169
2022/07/19,12:00:00,486.12,2710,9663,12373
2022/07/19,12:30:00,486.12,2718,9864,12582
2022/07/19,13:00:00,486.12,2706,10063,12769
2022/07/19,13:30:00,486.12,2711,10235,12946
2022/07/19,14:00:00,486.52,2702,10430,13132
2022/07/19,14:30:00,486.52,2673,10623,13296
2022/07/19,15:00:00,486.52,2498,10752,13250
2022/07/19,15:30:00,2699.71,2372,10941,13313
2022/07/19,16:00:00,2728.45,2140,11039,13179
2022/07/19,16:30:00,2728.45,1931,11272,13203
2022/07/19,17:00:00,2758.5,1619,11376,12995
2022/07/19,17:30:00,2758.5,1289,11624,12913
2022/07/19,18:00:00,2728.45,910,11820,12730
2022/07/19,18:30:00,2984.59,550,11934,12484
2022/07/19,19:00:00,2984.59,483,11973,12456
2022/07/19,19:30:00,4200.07,146,11883,12029
2022/07/19,20:00:00,4200.07,146,11998,12144
2022/07/19,20:30:00,4200.07,142,11956,12098
2022/07/19,21:00:00,4200.07,141,11835,11976
2022/07/19,21:30:00,4200.07,145,11742,11887
2022/07/19,22:00:00,2758.5,154,11455,11609
2022/07/19,22:30:00,2758.5,160,11161,11321
2022/07/19,23:00:00,479.59,170,10729,10899
2022/07/19,23:30:00,489.44,163,10401,10564
2022/07/20,00:00:00,489.44,168,9983,10151
2022/07/20,00:30:00,489.44,107,9745,9852
2022/07/20,01:00:00,489.44,41,9459,9500
2022/07/20,01:30:00,489.44,38,9325,9363
2022/07/20,02:00:00,489.88,25,9134,9159
2022/07/20,02:30:00,489,23,8924,8947
2022/07/20,03:00:00,490.34,19,8807,8826
2022/07/20,03:30:00,488.57,20,8698,8718
2022/07/20,04:00:00,489.88,22,8606,8628
2022/07/20,04:30:00,488.57,14,8633,8647
2022/07/20,05:00:00,489.88,18,8623,8641
2022/07/20,05:30:00,488.15,13,8605,8618
2022/07/20,06:00:00,490.79,15,8504,8519
2022/07/20,06:30:00,487.32,23,8708,8731
2022/07/20,07:00:00,490.79,310,8886,9196
2022/07/20,07:30:00,489,504,9176,9680
2022/07/20,08:00:00,489.88,772,9316,10088
2022/07/20,08:30:00,489,1183,9460,10643
2022/07/20,09:00:00,489.44,1638,9453,11091
2022/07/20,09:30:00,489.88,1940,9505,11445
2022/07/20,10:00:00,490.79,2166,9546,11712
2022/07/20,10:30:00,490.34,2360,9619,11979
2022/07/20,11:00:00,489.88,2530,9625,12155
2022/07/20,11:30:00,490.79,2701,9674,12375
2022/07/20,12:00:00,490.34,2746,9771,12517
2022/07/20,12:30:00,490.34,2766,9796,12562
2022/07/20,13:00:00,489.88,2766,9939,12705
2022/07/20,13:30:00,490.34,2740,10239,12979
2022/07/20,14:00:00,483.56,2758,10423,13181
2022/07/20,14:30:00,473.2,2703,10566,13269
2022/07/20,15:00:00,472.04,2516,10702,13218
2022/07/20,15:30:00,471.39,2367,10817,13184
2022/07/20,16:00:00,2699.71,2151,10927,13078
2022/07/20,16:30:00,2728.45,1952,11111,13063
2022/07/20,17:00:00,2728.45,1653,11082,12735
2022/07/20,17:30:00,2758.5,1326,11362,12688
2022/07/20,18:00:00,2728.45,967,11522,12489
2022/07/20,18:30:00,2728.45,630,11688,12318
2022/07/20,19:00:00,2728.45,582,11642,12224
2022/07/20,19:30:00,2758.5,218,11578,11796
2022/07/20,20:00:00,2728.45,205,11688,11893
2022/07/20,20:30:00,2728.45,213,11671,11884
2022/07/20,21:00:00,2728.45,216,11554,11770
2022/07/20,21:30:00,2822.68,211,11527,11738
2022/07/20,22:00:00,490.63,224,11215,11439
2022/07/20,22:30:00,485.18,224,10947,11171
2022/07/20,23:00:00,488.39,225,10499,10724
2022/07/20,23:30:00,489,222,10167,10389
2022/07/21,00:00:00,486.91,219,9825,10044
2022/07/21,00:30:00,487.32,161,9523,9684
2022/07/21,01:00:00,485.36,102,9254,9356
2022/07/21,01:30:00,478.08,101,9026,9127
2022/07/21,02:00:00,479.07,99,8973,9072
2022/07/21,02:30:00,478.56,95,8792,8887
2022/07/21,03:00:00,478.56,98,8620,8718
2022/07/21,03:30:00,478.81,99,8525,8624
2022/07/21,04:00:00,479.59,95,8444,8539
2022/07/21,04:30:00,478.56,92,8430,8522
2022/07/21,05:00:00,479.33,94,8429,8523
2022/07/21,05:30:00,479.07,91,8418,8509
2022/07/21,06:00:00,478.81,95,8340,8435
2022/07/21,06:30:00,482.89,88,8520,8608
2022/07/21,07:00:00,489.44,393,8706,9099
2022/07/21,07:30:00,489.44,570,9004,9574
2022/07/21,08:00:00,489.44,790,9228,10018
2022/07/21,08:30:00,489.44,1027,9502,10529
2022/07/21,09:00:00,489,1305,9519,10824
2022/07/21,09:30:00,488.57,1653,9491,11144
2022/07/21,10:00:00,489.88,1920,9373,11293
2022/07/21,10:30:00,489.88,2228,9344,11572
2022/07/21,11:00:00,489.44,2385,9293,11678
2022/07/21,11:30:00,489.44,2533,9312,11845
2022/07/21,12:00:00,489.44,2601,9391,11992
2022/07/21,12:30:00,489.88,2629,9506,12135
2022/07/21,13:00:00,489.88,2701,9593,12294
2022/07/21,13:30:00,489.88,2747,9757,12504
2022/07/21,14:00:00,489,2736,9801,12537
2022/07/21,14:30:00,489.44,2718,9953,12671
2022/07/21,15:00:00,489.44,2536,10111,12647
2022/07/21,15:30:00,489,2416,10274,12690
2022/07/21,16:00:00,494.38,2214,10338,12552
2022/07/21,16:30:00,491.15,2000,10523,12523
2022/07/21,17:00:00,472.46,1685,10698,12383
2022/07/21,17:30:00,472.09,1349,10972,12321
2022/07/21,18:00:00,472.89,984,11226,12210
2022/07/21,18:30:00,2635.42,637,11382,12019
2022/07/21,19:00:00,2635.42,541,11431,11972
2022/07/21,19:30:00,472.98,206,11401,11607
2022/07/21,20:00:00,472.84,206,11471,11677
2022/07/21,20:30:00,472.86,184,11416,11600
2022/07/21,21:00:00,472.84,171,11273,11444
2022/07/21,21:30:00,472.93,171,11122,11293
2022/07/21,22:00:00,471.92,162,10844,11006
2022/07/21,22:30:00,474.17,161,10557,10718
2022/07/21,23:00:00,480.71,173,10261,10434
2022/07/21,23:30:00,481.3,194,9929,10123
2022/07/22,00:00:00,481,205,9647,9852
2022/07/22,00:30:00,481,136,9389,9525
2022/07/22,01:00:00,481.61,81,9175,9256
2022/07/22,01:30:00,481.3,63,8947,9010
2022/07/22,02:00:00,481.92,72,8726,8798
2022/07/22,02:30:00,480.14,86,8534,8620
2022/07/22,03:00:00,479.07,91,8354,8445
2022/07/22,03:30:00,480.14,65,8289,8354
2022/07/22,04:00:00,478.7,59,8321,8380
2022/07/22,04:30:00,478.7,65,8307,8372
2022/07/22,05:00:00,487.73,48,8282,8330
2022/07/22,05:30:00,489.44,48,8279,8327
2022/07/22,06:00:00,489.44,40,8088,8128
2022/07/22,06:30:00,489,38,8037,8075
2022/07/22,07:00:00,489,337,8083,8420
2022/07/22,07:30:00,489.44,512,8192,8704
2022/07/22,08:00:00,489,781,8236,9017
2022/07/22,08:30:00,488.57,1120,8353,9473
2022/07/22,09:00:00,489.88,1526,8247,9773
2022/07/22,09:30:00,489.44,1888,8211,10099
2022/07/22,10:00:00,489.44,2104,8187,10291
2022/07/22,10:30:00,489.44,2334,8236,10570
2022/07/22,11:00:00,489,2576,8349,10925
2022/07/22,11:30:00,489.44,2708,8474,11182
2022/07/22,12:00:00,489.88,2733,8591,11324
2022/07/22,12:30:00,489,2742,8754,11496
2022/07/22,13:00:00,489.88,2768,8820,11588
2022/07/22,13:30:00,489,2762,8926,11688
2022/07/22,14:00:00,489,2752,9067,11819
2022/07/22,14:30:00,489.88,2712,9196,11908
2022/07/22,15:00:00,489.88,2540,9312,11852
2022/07/22,15:30:00,489.44,2396,9421,11817
2022/07/22,16:00:00,489.44,2198,9619,11817
2022/07/22,16:30:00,491.58,1988,9660,11648
2022/07/22,17:00:00,490.5,1683,9930,11613
2022/07/22,17:30:00,493.65,1331,10253,11584
2022/07/22,18:00:00,481.24,968,10566,11534
2022/07/22,18:30:00,478.47,610,10867,11477
2022/07/22,19:00:00,481.27,511,11005,11516
2022/07/22,19:30:00,472.8,200,10847,11047
2022/07/22,20:00:00,488.15,203,10815,11018
2022/07/22,20:30:00,489.44,196,10683,10879
2022/07/22,21:00:00,489,190,10544,10734
2022/07/22,21:30:00,489,183,10403,10586
2022/07/22,22:00:00,498.76,176,10184,10360
2022/07/22,22:30:00,489.44,177,10070,10247
2022/07/22,23:00:00,493.64,168,9844,10012
2022/07/22,23:30:00,489.88,168,9670,9838
2022/07/23,00:00:00,489.44,168,9377,9545
2022/07/23,00:30:00,489,114,9155,9269
2022/07/23,01:00:00,489,49,8989,9038
2022/07/23,01:30:00,489.44,41,8808,8849
2022/07/23,02:00:00,485.36,33,8627,8660
2022/07/23,02:30:00,488.15,31,8468,8499
2022/07/23,03:00:00,484.99,30,8352,8382
2022/07/23,03:30:00,486.91,33,8322,8355
2022/07/23,04:00:00,487.73,38,8235,8273
2022/07/23,04:30:00,488.57,49,8155,8204
2022/07/23,05:00:00,485.36,48,8159,8207
2022/07/23,05:30:00,485.36,40,8072,8112
2022/07/23,06:00:00,485.36,37,7867,7904
2022/07/23,06:30:00,487.73,39,7783,7822
2022/07/23,07:00:00,487.73,327,7675,8002
2022/07/23,07:30:00,487.32,521,7554,8075
2022/07/23,08:00:00,487.32,765,7485,8250
2022/07/23,08:30:00,488.57,1048,7510,8558
2022/07/23,09:00:00,489.44,1360,7319,8679
2022/07/23,09:30:00,487.32,1854,7235,9089
2022/07/23,10:00:00,486.91,2166,7217,9383
2022/07/23,10:30:00,487.73,2353,7393,9746
2022/07/23,11:00:00,487.73,2564,7422,9986
2022/07/23,11:30:00,488.15,2743,7570,10313
2022/07/23,12:00:00,486.91,2777,7659,10436
2022/07/23,12:30:00,486.91,2833,7734,10567
2022/07/23,13:00:00,488.15,2797,7886,10683
2022/07/23,13:30:00,488.57,2799,8023,10822
2022/07/23,14:00:00,488.15,2770,8144,10914
2022/07/23,14:30:00,489.44,2752,8251,11003
2022/07/23,15:00:00,487.32,2539,8374,10913
2022/07/23,15:30:00,487.32,2415,8570,10985
2022/07/23,16:00:00,488.57,2209,8649,10858
2022/07/23,16:30:00,488.57,2007,8941,10948
2022/07/23,17:00:00,488.15,1686,9192,10878
2022/07/23,17:30:00,487.73,1352,9514,10866
2022/07/23,18:00:00,488.15,980,9842,10822
2022/07/23,18:30:00,488.57,647,10109,10756
2022/07/23,19:00:00,491.29,566,10241,10807
2022/07/23,19:30:00,488.57,196,10314,10510
2022/07/23,20:00:00,489.44,189,10576,10765
2022/07/23,20:30:00,488.15,176,10626,10802
2022/07/23,21:00:00,488.15,170,10636,10806
2022/07/23,21:30:00,488.15,161,10580,10741
2022/07/23,22:00:00,487.32,154,10466,10620
2022/07/23,22:30:00,487.32,155,10307,10462
2022/07/23,23:00:00,498.73,152,10049,10201
2022/07/23,23:30:00,487.73,154,9737,9891
2022/07/24,00:00:00,488.57,94,9515,9609
2022/07/24,00:30:00,488.15,61,9212,9273
2022/07/24,01:00:00,488.15,17,8959,8976
2022/07/24,01:30:00,487.73,18,8715,8733
2022/07/24,02:00:00,489,20,8470,8490
2022/07/24,02:30:00,487.32,21,8272,8293
2022/07/24,03:00:00,488.15,24,8162,8186
2022/07/24,03:30:00,487.73,22,8011,8033
2022/07/24,04:00:00,488.15,19,7992,8011
2022/07/24,04:30:00,486.12,19,8014,8033
2022/07/24,05:00:00,486.91,17,8005,8022
2022/07/24,05:30:00,484.99,21,8027,8048
2022/07/24,06:00:00,487.73,20,7957,7977
2022/07/24,06:30:00,489.44,31,8377,8408
2022/07/24,07:00:00,488.15,295,8534,8829
2022/07/24,07:30:00,487.32,486,8863,9349
2022/07/24,08:00:00,487.73,766,9067,9833
2022/07/24,08:30:00,489,1132,9052,10184
2022/07/24,09:00:00,488.57,1527,9055,10582
2022/07/24,09:30:00,488.57,1801,9055,10856
2022/07/24,10:00:00,487.32,2193,9031,11224
2022/07/24,10:30:00,488.57,2379,9007,11386
2022/07/24,11:00:00,486.91,2570,9018,11588
2022/07/24,11:30:00,489,2686,9039,11725
2022/07/24,12:00:00,485.74,2769,9182,11951
2022/07/24,12:30:00,488.15,2786,9374,12160
2022/07/24,13:00:00,486.52,2786,9557,12343
2022/07/24,13:30:00,487.73,2780,9801,12581
2022/07/24,14:00:00,486.91,2766,9990,12756
2022/07/24,14:30:00,486.91,2777,10179,12956
2022/07/24,15:00:00,486.12,2569,10331,12900
2022/07/24,15:30:00,486.12,2432,10512,12944
2022/07/24,16:00:00,486.52,2204,10650,12854
2022/07/24,16:30:00,484.62,1983,10844,12827
2022/07/24,17:00:00,490.63,1685,11024,12709
2022/07/24,17:30:00,474.18,1325,11259,12584
2022/07/24,18:00:00,472.71,971,11490,12461
2022/07/24,18:30:00,488.42,638,11641,12279
2022/07/24,19:00:00,488.42,492,11668,12160
2022/07/24,19:30:00,498.66,208,11590,11798
2022/07/24,20:00:00,485.49,198,11742,11940
2022/07/24,20:30:00,485.49,199,11744,11943
2022/07/24,21:00:00,488.42,196,11616,11812
2022/07/24,21:30:00,490.78,195,11516,11711
2022/07/24,22:00:00,498.66,189,11150,11339
2022/07/24,22:30:00,484.21,192,10879,11071
2022/07/24,23:00:00,485.36,179,10563,10742
2022/07/24,23:30:00,489.44,172,10168,10340
2022/07/25,00:00:00,488.15,102,9862,9964
2022/07/25,00:30:00,489,38,9553,9591
2022/07/25,01:00:00,488.15,21,9261,9282
2022/07/25,01:30:00,489,18,9014,9032
2022/07/25,02:00:00,487.73,14,8839,8853
2022/07/25,02:30:00,488.15,9,8847,8856
2022/07/25,03:00:00,489.44,9,8668,8677
2022/07/25,03:30:00,487.73,6,8601,8607
2022/07/25,04:00:00,487.32,5,8516,8521
2022/07/25,04:30:00,488.57,6,8516,8522
2022/07/25,05:00:00,488.57,7,8492,8499
2022/07/25,05:30:00,488.57,6,8543,8549
2022/07/25,06:00:00,488.57,4,8462,8466
2022/07/25,06:30:00,489,6,8669,8675
2022/07/25,07:00:00,488.15,256,8871,9127
2022/07/25,07:30:00,487.73,450,9169,9619
2022/07/25,08:00:00,487.73,758,9277,10035
2022/07/25,08:30:00,488.15,1131,9403,10534
2022/07/25,09:00:00,487.73,1584,9340,10924
2022/07/25,09:30:00,488.15,1909,9347,11256
2022/07/25,10:00:00,487.32,2186,9255,11441
2022/07/25,10:30:00,488.57,2320,9349,11669
2022/07/25,11:00:00,488.15,2548,9390,11938
2022/07/25,11:30:00,487.32,2682,9504,12186
2022/07/25,12:00:00,482.68,2753,9576,12329
2022/07/25,12:30:00,481.69,2728,9708,12436
2022/07/25,13:00:00,482.18,2758,9844,12602
2022/07/25,13:30:00,481.69,2767,10114,12881
2022/07/25,14:00:00,482.68,2746,10296,13042
2022/07/25,14:30:00,482.68,2714,10275,12989
2022/07/25,15:00:00,483.18,2554,10393,12947
2022/07/25,15:30:00,482.68,2408,10567,12975
2022/07/25,16:00:00,482.68,2167,10641,12808
2022/07/25,16:30:00,481.69,1972,10854,12826
2022/07/25,17:00:00,498.66,1669,10904,12573
2022/07/25,17:30:00,488.43,1340,11193,12533
2022/07/25,18:00:00,485.5,937,11420,12357
2022/07/25,18:30:00,2620.8,590,11535,12125
2022/07/25,19:00:00,2758.5,510,11589,12099
2022/07/25,19:30:00,2758.5,159,11487,11646
2022/07/25,20:00:00,2758.5,175,11631,11806
2022/07/25,20:30:00,2758.5,165,11618,11783
2022/07/25,21:00:00,2728.45,159,11522,11681
2022/07/25,21:30:00,485.71,153,11406,11559
2022/07/25,22:00:00,491.55,151,11116,11267
2022/07/25,22:30:00,498.66,150,10831,10981
2022/07/25,23:00:00,489,144,10445,10589
2022/07/25,23:30:00,498.66,146,10067,10213
2022/07/26,00:00:00,488.57,144,9678,9822
2022/07/26,00:30:00,488.15,75,9418,9493
2022/07/26,01:00:00,487.73,25,9157,9182
2022/07/26,01:30:00,486.91,22,8887,8909
2022/07/26,02:00:00,485.74,20,8824,8844
2022/07/26,02:30:00,488.57,15,8687,8702
2022/07/26,03:00:00,488.57,14,8541,8555
2022/07/26,03:30:00,488.15,17,8448,8465
2022/07/26,04:00:00,489,17,8330,8347
2022/07/26,04:30:00,487.73,20,8316,8336
2022/07/26,05:00:00,488.15,22,8323,8345
2022/07/26,05:30:00,488.57,17,8312,8329
2022/07/26,06:00:00,488.15,19,8208,8227
2022/07/26,06:30:00,489,23,8407,8430
2022/07/26,07:00:00,489,388,8485,8873
2022/07/26,07:30:00,489.44,611,8672,9283
2022/07/26,08:00:00,489,1014,8632,9646
2022/07/26,08:30:00,489,1364,8842,10206
2022/07/26,09:00:00,484.21,1691,8944,10635
2022/07/26,09:30:00,489,1950,9085,11035
2022/07/26,10:00:00,484.21,2199,8862,11061
2022/07/26,10:30:00,489.44,2373,8947,11320
2022/07/26,11:00:00,483.69,2547,9036,11583
2022/07/26,11:30:00,485.36,2699,9087,11786
2022/07/26,12:00:00,484.26,2752,9208,11960
2022/07/26,12:30:00,485.36,2748,9370,12118
2022/07/26,13:00:00,484.62,2773,9506,12279
2022/07/26,13:30:00,484.99,2778,9815,12593
2022/07/26,14:00:00,484.26,2728,9931,12659
2022/07/26,14:30:00,482.18,2735,10121,12856
2022/07/26,15:00:00,477.39,2570,10254,12824
2022/07/26,15:30:00,472.54,2447,10384,12831
2022/07/26,16:00:00,496.27,2222,10477,12699
2022/07/26,16:30:00,496.43,2016,10667,12683
2022/07/26,17:00:00,499.18,1690,10808,12498
2022/07/26,17:30:00,493.69,1366,11031,12397
2022/07/26,18:00:00,2672.26,978,11294,12272
2022/07/26,18:30:00,2758.5,625,11436,12061
2022/07/26,19:00:00,2758.5,532,11465,11997
2022/07/26,19:30:00,2758.5,197,11351,11548
2022/07/26,20:00:00,2758.5,197,11473,11670
2022/07/26,20:30:00,2789.9,184,11441,11625
2022/07/26,21:00:00,2758.5,173,11334,11507
2022/07/26,21:30:00,2728.45,167,11259,11426
2022/07/26,22:00:00,496.43,165,10922,11087
2022/07/26,22:30:00,496.43,155,10685,10840
2022/07/26,23:00:00,506.26,155,10316,10471
2022/07/26,23:30:00,498.45,142,9938,10080
2022/07/27,00:00:00,494.33,138,9546,9684
2022/07/27,00:30:00,489,61,9311,9372
2022/07/27,01:00:00,486.91,13,9027,9040
2022/07/27,01:30:00,489.88,10,8825,8835
2022/07/27,02:00:00,486.91,6,8561,8567
2022/07/27,02:30:00,486.12,7,8426,8433
2022/07/27,03:00:00,483.91,8,8203,8211
2022/07/27,03:30:00,484.99,9,8293,8302
2022/07/27,04:00:00,485.36,8,8187,8195
2022/07/27,04:30:00,485.74,4,8165,8169
2022/07/27,05:00:00,485.74,5,8187,8192
2022/07/27,05:30:00,485.36,3,8157,8160
2022/07/27,06:00:00,485.74,3,8057,8060
2022/07/27,06:30:00,485.36,9,8234,8243
2022/07/27,07:00:00,485.36,379,8325,8704
2022/07/27,07:30:00,484.99,602,8466,9068
2022/07/27,08:00:00,484.62,1012,8455,9467
2022/07/27,08:30:00,485.36,1378,8654,10032
2022/07/27,09:00:00,485.74,1691,8785,10476
2022/07/27,09:30:00,484.99,1940,8908,10848
2022/07/27,10:00:00,484.99,2194,8899,11093
2022/07/27,10:30:00,484.99,2359,8970,11329
2022/07/27,11:00:00,487.73,2568,9095,11663
2022/07/27,11:30:00,484.21,2680,9213,11893
2022/07/27,12:00:00,485.36,2736,9358,12094
2022/07/27,12:30:00,488.15,2756,9496,12252
2022/07/27,13:00:00,486.52,2741,9655,12396
2022/07/27,13:30:00,484.26,2743,9741,12484
2022/07/27,14:00:00,486.91,2743,10010,12753
2022/07/27,14:30:00,489,2692,10234,12926
2022/07/27,15:00:00,482.68,2489,10389,12878
2022/07/27,15:30:00,472.74,2383,10505,12888
2022/07/27,16:00:00,472.57,2160,10608,12768
2022/07/27,16:30:00,505.28,1944,10842,12786
2022/07/27,17:00:00,498.22,1614,10961,12575
2022/07/27,17:30:00,498.22,1280,11227,12507
2022/07/27,18:00:00,505.28,899,11452,12351
2022/07/27,18:30:00,2799.52,539,11634,12173
2022/07/27,19:00:00,2799.52,466,11697,12163
2022/07/27,19:30:00,2758.5,142,11584,11726
2022/07/27,20:00:00,2758.5,146,11747,11893
2022/07/27,20:30:00,2728.45,145,11716,11861
2022/07/27,21:00:00,2758.5,143,11613,11756
2022/07/27,21:30:00,2758.5,136,11478,11614
2022/07/27,22:00:00,498.11,133,11191,11324
2022/07/27,22:30:00,505.28,129,10928,11057
2022/07/27,23:00:00,505.28,124,10602,10726
2022/07/27,23:30:00,505.28,123,10249,10372
2022/07/28,00:00:00,498.54,118,9893,10011
2022/07/28,00:30:00,488.15,55,9630,9685
2022/07/28,01:00:00,490.34,2,9368,9370
2022/07/28,01:30:00,488.15,4,9099,9103
2022/07/28,02:00:00,488.57,4,8857,8861
2022/07/28,02:30:00,488.57,3,8670,8673
2022/07/28,03:00:00,485.74,8,8534,8542
2022/07/28,03:30:00,485.74,9,8408,8417
2022/07/28,04:00:00,485.36,10,8343,8353
2022/07/28,04:30:00,485.74,7,8322,8329
2022/07/28,05:00:00,483.91,11,8257,8268
2022/07/28,05:30:00,487.32,14,8298,8312
2022/07/28,06:00:00,484.62,16,8199,8215
2022/07/28,06:30:00,486.52,18,8320,8338
2022/07/28,07:00:00,483.18,298,8596,8894
2022/07/28,07:30:00,482.68,490,8878,9368
2022/07/28,08:00:00,482.68,791,9031,9822
2022/07/28,08:30:00,483.69,1214,9155,10369
2022/07/28,09:00:00,487.73,1647,9140,10787
2022/07/28,09:30:00,486.12,1933,9309,11242
2022/07/28,10:00:00,487.73,2148,9367,11515
2022/07/28,10:30:00,486.91,2313,9434,11747
2022/07/28,11:00:00,486.91,2529,9567,12096
2022/07/28,11:30:00,486.12,2675,9675,12350
2022/07/28,12:00:00,486.91,2713,9891,12604
2022/07/28,12:30:00,486.91,2727,9939,12666
2022/07/28,13:00:00,486.91,2732,10112,12844
2022/07/28,13:30:00,486.91,2708,10418,13126
2022/07/28,14:00:00,483.69,2716,10652,13368
2022/07/28,14:30:00,472.31,2647,10837,13484
2022/07/28,15:00:00,472.54,2509,10989,13498
2022/07/28,15:30:00,472.54,2321,11154,13475
2022/07/28,16:00:00,471.84,2107,11268,13375
2022/07/28,16:30:00,471.79,1896,11499,13395
2022/07/28,17:00:00,506.38,1581,11690,13271
2022/07/28,17:30:00,2758.5,1235,11942,13177
2022/07/28,18:00:00,2632.64,858,12194,13052
2022/07/28,18:30:00,2660.88,570,12346,12916
2022/07/28,19:00:00,2632.64,400,12313,12713
2022/07/28,19:30:00,2646.65,123,12193,12316
2022/07/28,20:00:00,2632.64,123,12286,12409
2022/07/28,20:30:00,2758.5,125,12157,12282
2022/07/28,21:00:00,2758.5,126,11979,12105
2022/07/28,21:30:00,499.18,126,11766,11892
2022/07/28,22:00:00,499.18,132,11482,11614
2022/07/28,22:30:00,506.38,136,11173,11309
2022/07/28,23:00:00,506.38,135,10882,11017
2022/07/28,23:30:00,506.38,127,10550,10677
2022/07/29,00:00:00,505.07,111,10286,10397
2022/07/29,00:30:00,486.91,53,10011,10064
2022/07/29,01:00:00,501.7,11,9742,9753
2022/07/29,01:30:00,484.62,13,9496,9509
2022/07/29,02:00:00,485.36,18,9243,9261
2022/07/29,02:30:00,484.21,21,9179,9200
2022/07/29,03:00:00,484.21,18,9025,9043
2022/07/29,03:30:00,484.62,18,8889,8907
2022/07/29,04:00:00,484.21,16,8763,8779
2022/07/29,04:30:00,483.69,12,8700,8712
2022/07/29,05:00:00,483.69,9,8667,8676
2022/07/29,05:30:00,483.18,13,8628,8641
2022/07/29,06:00:00,483.69,7,8428,8435
2022/07/29,06:30:00,482.24,9,8426,8435
2022/07/29,07:00:00,483.18,263,8459,8722
2022/07/29,07:30:00,483.18,465,8525,8990
2022/07/29,08:00:00,483.69,794,8489,9283
2022/07/29,08:30:00,483.69,1157,8584,9741
2022/07/29,09:00:00,482.68,1604,8619,10223
2022/07/29,09:30:00,482.56,1923,8733,10656
2022/07/29,10:00:00,484.21,2145,8858,11003
2022/07/29,10:30:00,484.21,2317,8875,11192
2022/07/29,11:00:00,483.69,2533,9040,11573
2022/07/29,11:30:00,483.69,2681,9210,11891
2022/07/29,12:00:00,488.57,2742,9377,12119
2022/07/29,12:30:00,487.73,2759,9534,12293
2022/07/29,13:00:00,488.15,2736,9657,12393
2022/07/29,13:30:00,487.73,2749,9706,12455
2022/07/29,14:00:00,488.57,2773,9818,12591
2022/07/29,14:30:00,488.15,2729,9977,12706
2022/07/29,15:00:00,489.44,2544,10078,12622
2022/07/29,15:30:00,493.39,2392,10219,12611
2022/07/29,16:00:00,499.3,2151,10317,12468
2022/07/29,16:30:00,496.31,1932,10534,12466
2022/07/29,17:00:00,486.88,1604,10775,12379
2022/07/29,17:30:00,478.21,1260,11062,12322
2022/07/29,18:00:00,478.39,894,11401,12295
2022/07/29,18:30:00,478.79,607,11662,12269
2022/07/29,19:00:00,475.39,489,11691,12180
2022/07/29,19:30:00,472.44,159,11509,11668
2022/07/29,20:00:00,478.4,157,11509,11666
2022/07/29,20:30:00,475.09,164,11309,11473
2022/07/29,21:00:00,472.54,165,11129,11294
2022/07/29,21:30:00,479.75,163,10925,11088
2022/07/29,22:00:00,489.44,152,10737,10889
2022/07/29,22:30:00,496.73,159,10597,10756
2022/07/29,23:00:00,489.44,153,10411,10564
2022/07/29,23:30:00,488.57,164,10133,10297
2022/07/30,00:00:00,485.74,166,9881,10047
2022/07/30,00:30:00,490.34,53,9754,9807
2022/07/30,01:00:00,501.68,53,9653,9706
2022/07/30,01:30:00,486.91,55,9441,9496
2022/07/30,02:00:00,485.74,42,9265,9307
2022/07/30,02:30:00,486.91,27,9070,9097
2022/07/30,03:00:00,486.12,25,8928,8953
2022/07/30,03:30:00,486.12,23,8814,8837
2022/07/30,04:00:00,486.52,17,8748,8765
2022/07/30,04:30:00,486.91,13,8671,8684
2022/07/30,05:00:00,486.12,12,8572,8584
2022/07/30,05:30:00,486.52,14,8509,8523
2022/07/30,06:00:00,486.12,16,8319,8335
2022/07/30,06:30:00,486.91,16,8194,8210
2022/07/30,07:00:00,486.91,237,8122,8359
2022/07/30,07:30:00,485.74,458,8072,8530
2022/07/30,08:00:00,486.12,725,7965,8690
2022/07/30,08:30:00,486.12,1032,7929,8961
2022/07/30,09:00:00,486.12,1460,7776,9236
2022/07/30,09:30:00,487.73,1844,7685,9529
2022/07/30,10:00:00,488.15,2111,7826,9937
2022/07/30,10:30:00,486.52,2336,7980,10316
2022/07/30,11:00:00,486.91,2485,8010,10495
2022/07/30,11:30:00,486.12,2635,8223,10858
2022/07/30,12:00:00,486.12,2730,8242,10972
2022/07/30,12:30:00,486.52,2760,8412,11172
2022/07/30,13:00:00,486.91,2758,8462,11220
2022/07/30,13:30:00,486.12,2754,8642,11396
2022/07/30,14:00:00,486.52,2736,8690,11426
2022/07/30,14:30:00,486.52,2686,8845,11531
2022/07/30,15:00:00,486.52,2526,9039,11565
2022/07/30,15:30:00,485.74,2391,9162,11553
2022/07/30,16:00:00,486.91,2111,9409,11520
2022/07/30,16:30:00,487.06,1872,9558,11430
2022/07/30,17:00:00,487.84,1586,9775,11361
2022/07/30,17:30:00,488.06,1266,10095,11361
2022/07/30,18:00:00,477.57,869,10398,11267
2022/07/30,18:30:00,471.88,620,10594,11214
2022/07/30,19:00:00,483.6,464,10690,11154
2022/07/30,19:30:00,483.6,144,10803,10947
2022/07/30,20:00:00,483.61,141,10995,11136
2022/07/30,20:30:00,481.15,143,10992,11135
2022/07/30,21:00:00,481.15,148,10989,11137
2022/07/30,21:30:00,478.08,175,10840,11015
2022/07/30,22:00:00,490.99,171,10710,10881
2022/07/30,22:30:00,486.91,168,10546,10714
2022/07/30,23:00:00,489.44,163,10327,10490
2022/07/30,23:30:00,487.32,155,9972,10127
2022/07/31,00:00:00,488.15,170,9652,9822
2022/07/31,00:30:00,489,132,9398,9530
2022/07/31,01:00:00,488.15,69,9175,9244
2022/07/31,01:30:00,488.15,76,8925,9001
2022/07/31,02:00:00,482.18,54,8687,8741
2022/07/31,02:30:00,489.44,34,8535,8569
2022/07/31,03:00:00,489,36,8362,8398
2022/07/31,03:30:00,487.73,26,8321,8347
2022/07/31,04:00:00,489,26,8247,8273
2022/07/31,04:30:00,489.88,23,8264,8287
2022/07/31,05:00:00,487.73,23,8245,8268
2022/07/31,05:30:00,489.44,23,8320,8343
2022/07/31,06:00:00,483.22,26,8404,8430
2022/07/31,06:30:00,486.12,31,8559,8590
2022/07/31,07:00:00,484.99,298,8775,9073
2022/07/31,07:30:00,485.74,500,9080,9580
2022/07/31,08:00:00,486.12,784,9258,10042
2022/07/31,08:30:00,484.26,983,9553,10536
2022/07/31,09:00:00,485.74,1202,9602,10804
2022/07/31,09:30:00,486.12,1645,9637,11282
2022/07/31,10:00:00,485.36,2066,9376,11442
2022/07/31,10:30:00,486.52,2192,9370,11562
2022/07/31,11:00:00,488.57,2513,9324,11837
2022/07/31,11:30:00,483.91,2646,9372,12018
2022/07/31,12:00:00,485.74,2702,9401,12103
2022/07/31,12:30:00,484.26,2729,9564,12293
2022/07/31,13:00:00,486.52,2749,9729,12478
2022/07/31,13:30:00,485.36,2727,9812,12539
2022/07/31,14:00:00,486.52,2715,9982,12697
2022/07/31,14:30:00,485.36,2681,10148,12829
2022/07/31,15:00:00,485.74,2503,10267,12770
2022/07/31,15:30:00,485.36,2381,10424,12805
2022/07/31,16:00:00,483.69,2142,10505,12647
2022/07/31,16:30:00,484.21,1931,10721,12652
2022/07/31,17:00:00,499.52,1634,10857,12491
2022/07/31,17:30:00,484.47,1308,11025,12333
2022/07/31,18:00:00,478.37,937,11213,12150
2022/07/31,18:30:00,478.37,613,11266,11879
2022/07/31,19:00:00,472.41,474,11260,11734
2022/07/31,19:30:00,480.33,185,11189,11374
2022/07/31,20:00:00,501.86,182,11338,11520
2022/07/31,20:30:00,499.61,161,11293,11454
2022/07/31,21:00:00,506.79,156,11147,11303
2022/07/31,21:30:00,499.58,147,11012,11159
2022/07/31,22:00:00,499.58,145,10727,10872
2022/07/31,22:30:00,506.79,141,10454,10595
2022/07/31,23:00:00,506.79,139,10160,10299
2022/07/31,23:30:00,498.8,151,9767,9918
2022/08/01,00:00:00,596.35,99,9487,9586
2022/08/01,00:30:00,596.07,42,9188,9230
2022/08/01,01:00:00,594.94,35,9001,9036
2022/08/01,01:30:00,598.06,34,8724,8758
2022/08/01,02:00:00,594.66,16,8735,8751
2022/08/01,02:30:00,597.77,19,8527,8546
2022/08/01,03:00:00,595.5,21,8395,8416
2022/08/01,03:30:00,595.22,25,8340,8365
2022/08/01,04:00:00,594.66,18,8272,8290
2022/08/01,04:30:00,596.35,14,8231,8245
2022/08/01,05:00:00,594.66,15,8275,8290
2022/08/01,05:30:00,594.38,19,8297,8316
2022/08/01,06:00:00,594.66,18,8263,8281
2022/08/01,06:30:00,593.81,16,8446,8462
2022/08/01,07:00:00,594.1,188,8626,8814
2022/08/01,07:30:00,594.94,484,8919,9403
2022/08/01,08:00:00,595.22,740,9072,9812
2022/08/01,08:30:00,593.81,1127,9251,10378
2022/08/01,09:00:00,596.64,1404,9267,10671
2022/08/01,09:30:00,596.35,1742,9120,10862
2022/08/01,10:00:00,596.35,2072,9042,11114
2022/08/01,10:30:00,596.07,2323,9009,11332
2022/08/01,11:00:00,596.07,2533,9027,11560
2022/08/01,11:30:00,596.07,2642,9162,11804
2022/08/01,12:00:00,596.35,2700,9307,12007
2022/08/01,12:30:00,598.06,2705,9426,12131
2022/08/01,13:00:00,596.92,2723,9692,12415
2022/08/01,13:30:00,583.72,2723,9977,12700
2022/08/01,14:00:00,579.05,2609,10139,12748
2022/08/01,14:30:00,562.48,2392,10394,12786
2022/08/01,15:00:00,560.95,2215,10554,12769
2022/08/01,15:30:00,555.65,1897,10703,12600
2022/08/01,16:00:00,552.44,1674,10824,12498
2022/08/01,16:30:00,549.11,1358,11060,12418
2022/08/01,17:00:00,2354.63,1115,11237,12352
2022/08/01,17:30:00,2479.45,447,11460,11907
2022/08/01,18:00:00,2449.35,344,11633,11977
2022/08/01,18:30:00,2145.56,267,11725,11992
2022/08/01,19:00:00,2153.46,209,11732,11941
2022/08/01,19:30:00,2145.51,191,11691,11882
2022/08/01,20:00:00,3157.37,186,11835,12021
2022/08/01,20:30:00,2980.35,182,11787,11969
2022/08/01,21:00:00,2947.9,180,11662,11842
2022/08/01,21:30:00,2354.63,182,11490,11672
2022/08/01,22:00:00,2479.45,179,11242,11421
2022/08/01,22:30:00,548.24,172,10886,11058
2022/08/01,23:00:00,555.96,167,10502,10669
2022/08/01,23:30:00,570.12,132,10204,10336
2022/08/02,00:00:00,583.45,88,9860,9948
2022/08/02,00:30:00,592.98,51,9549,9600
2022/08/02,01:00:00,597.77,52,9245,9297
2022/08/02,01:30:00,596.92,47,8996,9043
2022/08/02,02:00:00,596.92,45,8994,9039
2022/08/02,02:30:00,596.92,37,8849,8886
2022/08/02,03:00:00,598.06,41,8734,8775
2022/08/02,03:30:00,597.49,43,8632,8675
2022/08/02,04:00:00,595.79,47,8509,8556
2022/08/02,04:30:00,597.2,42,8507,8549
2022/08/02,05:00:00,596.92,32,8535,8567
2022/08/02,05:30:00,598.06,32,8541,8573
2022/08/02,06:00:00,596.92,29,8491,8520
2022/08/02,06:30:00,596.35,27,8606,8633
2022/08/02,07:00:00,596.92,221,8823,9044
2022/08/02,07:30:00,595.79,441,9140,9581
2022/08/02,08:00:00,596.35,644,9337,9981
2022/08/02,08:30:00,598.34,917,9340,10257
2022/08/02,09:00:00,590.48,1186,9503,10689
2022/08/02,09:30:00,586.38,1621,9409,11030
2022/08/02,10:00:00,596.64,2108,9385,11493
2022/08/02,10:30:00,596.35,2338,9396,11734
2022/08/02,11:00:00,597.49,2505,9418,11923
2022/08/02,11:30:00,596.35,2681,9550,12231
2022/08/02,12:00:00,597.49,2715,9672,12387
2022/08/02,12:30:00,598.34,2745,9851,12596
2022/08/02,13:00:00,577.54,2750,10063,12813
2022/08/02,13:30:00,565.52,2732,10157,12889
2022/08/02,14:00:00,560.76,2716,10351,13067
2022/08/02,14:30:00,560.95,2657,10559,13216
2022/08/02,15:00:00,561.33,2491,10689,13180
2022/08/02,15:30:00,556.11,2334,10858,13192
2022/08/02,16:00:00,551.82,2083,10975,13058
2022/08/02,16:30:00,548.11,1869,11193,13062
2022/08/02,17:00:00,2342.18,1560,11363,12923
2022/08/02,17:30:00,2479.45,1209,11586,12795
2022/08/02,18:00:00,2137.34,854,11845,12699
2022/08/02,18:30:00,2137.34,618,11976,12594
2022/08/02,19:00:00,2556.1,510,11964,12474
2022/08/02,19:30:00,2514.98,178,11857,12035
2022/08/02,20:00:00,2556.1,173,11977,12150
2022/08/02,20:30:00,2556.1,170,11860,12030
2022/08/02,21:00:00,2514.98,179,11705,11884
2022/08/02,21:30:00,2476.02,173,11561,11734
2022/08/02,22:00:00,2507.32,170,11179,11349
2022/08/02,22:30:00,551.82,161,10868,11029
2022/08/02,23:00:00,561.52,155,10538,10693
2022/08/02,23:30:00,572.67,155,10139,10294
2022/08/03,00:00:00,588.28,169,9757,9926
2022/08/03,00:30:00,598.34,115,9502,9617
2022/08/03,01:00:00,596.07,56,9265,9321
2022/08/03,01:30:00,592.86,66,9173,9239
2022/08/03,02:00:00,591.43,66,8953,9019
2022/08/03,02:30:00,591.43,66,8797,8863
2022/08/03,03:00:00,592,54,8675,8729
2022/08/03,03:30:00,596.92,56,8504,8560
2022/08/03,04:00:00,593.43,55,8454,8509
2022/08/03,04:30:00,591.43,53,8484,8537
2022/08/03,05:00:00,597.49,50,8480,8530
2022/08/03,05:30:00,591.43,41,8531,8572
2022/08/03,06:00:00,590.29,34,8476,8510
2022/08/03,06:30:00,597.2,32,8615,8647
2022/08/03,07:00:00,597.49,266,8829,9095
2022/08/03,07:30:00,594.66,482,9146,9628
2022/08/03,08:00:00,597.49,705,9268,9973
2022/08/03,08:30:00,595.79,1042,9448,10490
2022/08/03,09:00:00,577.04,1431,9421,10852
2022/08/03,09:30:00,593.81,1712,9379,11091
2022/08/03,10:00:00,597.2,2098,9441,11539
2022/08/03,10:30:00,595.22,2365,9442,11807
2022/08/03,11:00:00,595.79,2477,9532,12009
2022/08/03,11:30:00,596.64,2658,9649,12307
2022/08/03,12:00:00,595.5,2702,9784,12486
2022/08/03,12:30:00,593.25,2710,10030,12740
2022/08/03,13:00:00,576.3,2710,10091,12801
2022/08/03,13:30:00,562.48,2665,10401,13066
2022/08/03,14:00:00,2338.25,2654,10566,13220
2022/08/03,14:30:00,2331.66,2620,10756,13376
2022/08/03,15:00:00,2201.97,2440,10871,13311
2022/08/03,15:30:00,2016.79,2308,11071,13379
2022/08/03,16:00:00,2344.66,2092,11199,13291
2022/08/03,16:30:00,2829.85,1796,11411,13207
2022/08/03,17:00:00,2479.45,1462,11576,13038
2022/08/03,17:30:00,2503.88,1126,11790,12916
2022/08/03,18:00:00,2449.35,757,11952,12709
2022/08/03,18:30:00,2476.02,520,12001,12521
2022/08/03,19:00:00,2479.45,367,11942,12309
2022/08/03,19:30:00,2479.45,131,11819,11950
2022/08/03,20:00:00,2479.45,137,12007,12144
2022/08/03,20:30:00,2356.93,131,11917,12048
2022/08/03,21:00:00,581.9,127,11786,11913
2022/08/03,21:30:00,580.65,126,11647,11773
2022/08/03,22:00:00,581.4,121,11333,11454
2022/08/03,22:30:00,581.4,118,11013,11131
2022/08/03,23:00:00,591.15,125,10704,10829
2022/08/03,23:30:00,588.39,75,10410,10485
2022/08/04,00:00:00,582.41,19,10104,10123
2022/08/04,00:30:00,598.27,20,9765,9785
2022/08/04,01:00:00,599.96,17,9473,9490
2022/08/04,01:30:00,600.53,32,9189,9221
2022/08/04,02:00:00,598.34,27,9007,9034
2022/08/04,02:30:00,598.55,26,8956,8982
2022/08/04,03:00:00,599.68,43,8782,8825
2022/08/04,03:30:00,598.27,38,8684,8722
2022/08/04,04:00:00,598.27,39,8617,8656
2022/08/04,04:30:00,598.27,41,8595,8636
2022/08/04,05:00:00,599.11,29,8607,8636
2022/08/04,05:30:00,599.96,27,8664,8691
2022/08/04,06:00:00,597.99,17,8597,8614
2022/08/04,06:30:00,599.68,11,8741,8752
2022/08/04,07:00:00,593.81,189,8950,9139
2022/08/04,07:30:00,572.44,445,9142,9587
2022/08/04,08:00:00,561.28,634,9399,10033
2022/08/04,08:30:00,552.92,927,9620,10547
2022/08/04,09:00:00,548.37,1192,9796,10988
2022/08/04,09:30:00,552.44,1535,9816,11351
2022/08/04,10:00:00,560.21,1919,9870,11789
2022/08/04,10:30:00,558.43,2202,9761,11963
2022/08/04,11:00:00,556.91,2438,9807,12245
2022/08/04,11:30:00,556.43,2591,9959,12550
2022/08/04,12:00:00,556.27,2659,10083,12742
2022/08/04,12:30:00,556.27,2713,10323,13036
2022/08/04,13:00:00,555.04,2721,10532,13253
2022/08/04,13:30:00,551.71,2702,10666,13368
2022/08/04,14:00:00,550.29,2674,10937,13611
2022/08/04,14:30:00,550.29,2575,11178,13753
2022/08/04,15:00:00,550.39,2363,11340,13703
2022/08/04,15:30:00,550.81,2233,11514,13747
2022/08/04,16:00:00,550.19,1942,11706,13648
2022/08/04,16:30:00,2342.18,1634,11991,13625
2022/08/04,17:00:00,2479.45,1288,12186,13474
2022/08/04,17:30:00,2503.88,1051,12194,13245
2022/08/04,18:00:00,2479.45,727,12199,12926
2022/08/04,18:30:00,2476.02,495,12161,12656
2022/08/04,19:00:00,2507.32,301,12083,12384
2022/08/04,19:30:00,2354.63,141,12021,12162
2022/08/04,20:00:00,547.05,89,12190,12279
2022/08/04,20:30:00,547.03,36,12179,12215
2022/08/04,21:00:00,548.11,35,12042,12077
2022/08/04,21:30:00,555.19,38,11797,11835
2022/08/04,22:00:00,559.3,32,11615,11647
2022/08/04,22:30:00,558.43,29,11254,11283
2022/08/04,23:00:00,581.62,31,11009,11040
2022/08/04,23:30:00,591.58,33,10709,10742
2022/08/05,00:00:00,598.34,27,10397,10424
2022/08/05,00:30:00,596.92,23,10115,10138
2022/08/05,01:00:00,597.49,16,9831,9847
2022/08/05,01:30:00,597.49,16,9596,9612
2022/08/05,02:00:00,506.02,13,9373,9386
2022/08/05,02:30:00,590.86,17,9195,9212
2022/08/05,03:00:00,594.66,9,9014,9023
2022/08/05,03:30:00,591.43,7,9081,9088
2022/08/05,04:00:00,597.77,11,8979,8990
2022/08/05,04:30:00,598.34,11,8925,8936
2022/08/05,05:00:00,597.49,7,8911,8918
2022/08/05,05:30:00,598.34,6,8912,8918
2022/08/05,06:00:00,598.34,8,8721,8729
2022/08/05,06:30:00,506.26,6,8715,8721
2022/08/05,07:00:00,598.34,195,8795,8990
2022/08/05,07:30:00,597.49,430,8916,9346
2022/08/05,08:00:00,596.35,693,8974,9667
2022/08/05,08:30:00,595.5,904,9155,10059
2022/08/05,09:00:00,596.07,1292,9193,10485
2022/08/05,09:30:00,598.34,1640,9207,10847
2022/08/05,10:00:00,598.06,2058,9227,11285
2022/08/05,10:30:00,596.92,2255,9288,11543
2022/08/05,11:00:00,597.2,2428,9387,11815
2022/08/05,11:30:00,597.49,2603,9568,12171
2022/08/05,12:00:00,598.34,2675,9682,12357
2022/08/05,12:30:00,598.06,2693,9819,12512
2022/08/05,13:00:00,596.64,2721,9956,12677
2022/08/05,13:30:00,594.1,2701,10082,12783
2022/08/05,14:00:00,588.6,2684,10080,12764
2022/08/05,14:30:00,587.47,2598,10210,12808
2022/08/05,15:00:00,583.31,2413,10365,12778
2022/08/05,15:30:00,577.54,2248,10513,12761
2022/08/05,16:00:00,578.04,2054,10675,12729
2022/08/05,16:30:00,576.79,1796,10858,12654
2022/08/05,17:00:00,553.89,1416,11104,12520
2022/08/05,17:30:00,553.08,1132,11415,12547
2022/08/05,18:00:00,552.95,756,11676,12432
2022/08/05,18:30:00,548.87,494,11876,12370
2022/08/05,19:00:00,548.87,341,11865,12206
2022/08/05,19:30:00,553.21,162,11653,11815
2022/08/05,20:00:00,553.21,154,11624,11778
2022/08/05,20:30:00,561.14,150,11433,11583
2022/08/05,21:00:00,560.76,96,11280,11376
2022/08/05,21:30:00,566.8,44,11131,11175
2022/08/05,22:00:00,582.66,56,11000,11056
2022/08/05,22:30:00,581.88,40,10863,10903
2022/08/05,23:00:00,596.07,39,10656,10695
2022/08/05,23:30:00,506.26,38,10431,10469
2022/08/06,00:00:00,597.49,50,10203,10253
2022/08/06,00:30:00,596.35,54,9880,9934
2022/08/06,01:00:00,596.35,51,9638,9689
2022/08/06,01:30:00,596.92,36,9413,9449
2022/08/06,02:00:00,596.07,18,9235,9253
2022/08/06,02:30:00,598.06,8,9140,9148
2022/08/06,03:00:00,596.64,11,8998,9009
2022/08/06,03:30:00,596.92,20,8845,8865
2022/08/06,04:00:00,596.35,26,8745,8771
2022/08/06,04:30:00,596.07,24,8753,8777
2022/08/06,05:00:00,596.92,20,8645,8665
2022/08/06,05:30:00,595.79,27,8641,8668
2022/08/06,06:00:00,596.64,19,8417,8436
2022/08/06,06:30:00,595.5,24,8299,8323
2022/08/06,07:00:00,594.66,209,8205,8414
2022/08/06,07:30:00,595.79,466,8295,8761
2022/08/06,08:00:00,596.35,682,8246,8928
2022/08/06,08:30:00,598.34,948,8344,9292
2022/08/06,09:00:00,594.94,1190,8423,9613
2022/08/06,09:30:00,596.64,1586,8306,9892
2022/08/06,10:00:00,597.49,2043,8261,10304
2022/08/06,10:30:00,596.35,2337,8324,10661
2022/08/06,11:00:00,596.64,2506,8401,10907
2022/08/06,11:30:00,597.49,2658,8556,11214
2022/08/06,12:00:00,594.66,2726,8627,11353
2022/08/06,12:30:00,596.64,2756,8777,11533
2022/08/06,13:00:00,594.38,2761,8887,11648
2022/08/06,13:30:00,585.04,2752,9104,11856
2022/08/06,14:00:00,583.98,2711,9266,11977
2022/08/06,14:30:00,595.22,2643,9398,12041
2022/08/06,15:00:00,593.81,2476,9538,12014
2022/08/06,15:30:00,595.22,2326,9785,12111
2022/08/06,16:00:00,592.42,2113,9871,11984
2022/08/06,16:30:00,594.66,1805,10182,11987
2022/08/06,17:00:00,579.56,1422,10454,11876
2022/08/06,17:30:00,571.04,1102,10763,11865
2022/08/06,18:00:00,561.33,749,10990,11739
2022/08/06,18:30:00,552.44,504,11168,11672
2022/08/06,19:00:00,549.03,154,11240,11394
2022/08/06,19:30:00,553.08,150,11225,11375
2022/08/06,20:00:00,552.69,154,11370,11524
2022/08/06,20:30:00,552.95,161,11163,11324
2022/08/06,21:00:00,552.82,164,10992,11156
2022/08/06,21:30:00,553.08,192,10857,11049
2022/08/06,22:00:00,569.22,134,10708,10842
2022/08/06,22:30:00,578.8,67,10649,10716
2022/08/06,23:00:00,588.03,63,10381,10444
2022/08/06,23:30:00,598.34,64,10024,10088
2022/08/07,00:00:00,596.64,64,9767,9831
2022/08/07,00:30:00,597.49,72,9435,9507
2022/08/07,01:00:00,595.5,71,9190,9261
2022/08/07,01:30:00,596.07,74,8954,9028
2022/08/07,02:00:00,596.64,91,8746,8837
2022/08/07,02:30:00,596.92,101,8619,8720
2022/08/07,03:00:00,506.98,93,8467,8560
2022/08/07,03:30:00,506.26,93,8454,8547
2022/08/07,04:00:00,591.43,90,8342,8432
2022/08/07,04:30:00,506.74,88,8311,8399
2022/08/07,05:00:00,596.35,94,8356,8450
2022/08/07,05:30:00,595.79,98,8406,8504
2022/08/07,06:00:00,595.5,85,8332,8417
2022/08/07,06:30:00,596.92,76,8434,8510
2022/08/07,07:00:00,596.07,240,8692,8932
2022/08/07,07:30:00,586.38,522,8955,9477
2022/08/07,08:00:00,585.31,733,9279,10012
2022/08/07,08:30:00,583.19,999,9453,10452
2022/08/07,09:00:00,584.51,1398,9479,10877
2022/08/07,09:30:00,596.64,1625,9519,11144
2022/08/07,10:00:00,597.77,2099,9255,11354
2022/08/07,10:30:00,597.49,2331,9266,11597
2022/08/07,11:00:00,597.49,2474,9292,11766
2022/08/07,11:30:00,596.64,2617,9432,12049
2022/08/07,12:00:00,596.35,2678,9563,12241
2022/08/07,12:30:00,597.77,2717,9645,12362
2022/08/07,13:00:00,595.5,2759,9835,12594
2022/08/07,13:30:00,596.07,2735,10017,12752
2022/08/07,14:00:00,597.49,2707,10181,12888
2022/08/07,14:30:00,597.49,2654,10383,13037
2022/08/07,15:00:00,586.12,2454,10516,12970
2022/08/07,15:30:00,582.4,2335,10673,13008
2022/08/07,16:00:00,585.31,2072,10685,12757
2022/08/07,16:30:00,584.78,1823,10904,12727
2022/08/07,17:00:00,563.07,1456,11043,12499
2022/08/07,17:30:00,561.52,1119,11297,12416
2022/08/07,18:00:00,561.33,794,11453,12247
2022/08/07,18:30:00,561.52,555,11508,12063
2022/08/07,19:00:00,561.14,329,11443,11772
2022/08/07,19:30:00,559.48,182,11460,11642
2022/08/07,20:00:00,559.84,182,11614,11796
2022/08/07,20:30:00,559.48,175,11494,11669
2022/08/07,21:00:00,559.3,178,11339,11517
2022/08/07,21:30:00,569.67,112,11276,11388
2022/08/07,22:00:00,573.86,50,11060,11110
2022/08/07,22:30:00,582.4,32,10810,10842
2022/08/07,23:00:00,577.11,34,10500,10534
2022/08/07,23:30:00,596.07,25,10185,10210
2022/08/08,00:00:00,596.07,40,9867,9907
2022/08/08,00:30:00,597.2,37,9528,9565
2022/08/08,01:00:00,598.34,21,9293,9314
2022/08/08,01:30:00,597.2,28,9158,9186
2022/08/08,02:00:00,597.49,31,8979,9010
2022/08/08,02:30:00,596.92,30,8799,8829
2022/08/08,03:00:00,596.92,21,8643,8664
2022/08/08,03:30:00,596.64,16,8557,8573
2022/08/08,04:00:00,596.92,31,8434,8465
2022/08/08,04:30:00,597.77,39,8394,8433
2022/08/08,05:00:00,597.49,32,8389,8421
2022/08/08,05:30:00,598.34,29,8442,8471
2022/08/08,06:00:00,597.49,17,8424,8441
2022/08/08,06:30:00,596.92,24,8500,8524
2022/08/08,07:00:00,596.92,228,8701,8929
2022/08/08,07:30:00,597.2,515,9026,9541
2022/08/08,08:00:00,597.49,760,9184,9944
2022/08/08,08:30:00,597.77,1161,9264,10425
2022/08/08,09:00:00,597.77,1534,9341,10875
2022/08/08,09:30:00,596.92,1777,9410,11187
2022/08/08,10:00:00,592,2054,9382,11436
2022/08/08,10:30:00,596.92,2350,9386,11736
2022/08/08,11:00:00,596.92,2486,9365,11851
2022/08/08,11:30:00,597.2,2600,9371,11971
2022/08/08,12:00:00,598.06,2709,9499,12208
2022/08/08,12:30:00,598.34,2744,9531,12275
2022/08/08,13:00:00,597.49,2779,9714,12493
2022/08/08,13:30:00,597.49,2775,9915,12690
2022/08/08,14:00:00,597.49,2754,9939,12693
2022/08/08,14:30:00,596.35,2715,10118,12833
2022/08/08,15:00:00,596.92,2515,10277,12792
2022/08/08,15:30:00,598.06,2387,10375,12762
2022/08/08,16:00:00,590.86,2143,10511,12654
2022/08/08,16:30:00,590.29,1860,10627,12487
2022/08/08,17:00:00,591.43,1510,10721,12231
2022/08/08,17:30:00,590.29,1179,10956,12135
2022/08/08,18:00:00,592,828,11098,11926
2022/08/08,18:30:00,598.34,597,11165,11762
2022/08/08,19:00:00,597.49,189,11136,11325
2022/08/08,19:30:00,598.06,185,11117,11302
2022/08/08,20:00:00,598.34,185,11224,11409
2022/08/08,20:30:00,597.77,177,11167,11344
2022/08/08,21:00:00,597.77,172,11067,11239
2022/08/08,21:30:00,596.64,181,10968,11149
2022/08/08,22:00:00,597.2,161,10706,10867
2022/08/08,22:30:00,594.94,98,10509,10607
2022/08/08,23:00:00,596.64,62,10296,10358
2022/08/08,23:30:00,597.2,84,10004,10088
2022/08/09,00:00:00,596.92,71,9722,9793
2022/08/09,00:30:00,595.22,81,9402,9483
2022/08/09,01:00:00,597.49,86,9145,9231
2022/08/09,01:30:00,597.49,93,8952,9045
2022/08/09,02:00:00,596.92,89,8678,8767
2022/08/09,02:30:00,504.59,84,8598,8682
2022/08/09,03:00:00,596.35,80,8603,8683
2022/08/09,03:30:00,597.2,89,8475,8564
2022/08/09,04:00:00,597.2,84,8323,8407
2022/08/09,04:30:00,597.2,71,8384,8455
2022/08/09,05:00:00,597.2,77,8351,8428
2022/08/09,05:30:00,598.06,75,8371,8446
2022/08/09,06:00:00,592,76,8306,8382
2022/08/09,06:30:00,598.34,70,8463,8533
2022/08/09,07:00:00,595.22,305,8692,8997
2022/08/09,07:30:00,597.2,540,8895,9435
2022/08/09,08:00:00,597.77,830,8993,9823
2022/08/09,08:30:00,505.54,1224,9151,10375
2022/08/09,09:00:00,596.64,1637,9195,10832
2022/08/09,09:30:00,597.77,1913,9331,11244
2022/08/09,10:00:00,597.2,2211,9338,11549
2022/08/09,10:30:00,591.43,2360,9285,11645
2022/08/09,11:00:00,596.92,2554,9298,11852
2022/08/09,11:30:00,597.49,2676,9312,11988
2022/08/09,12:00:00,591.15,2740,9373,12113
2022/08/09,12:30:00,596.35,2768,9446,12214
2022/08/09,13:00:00,505.54,2774,9549,12323
2022/08/09,13:30:00,596.35,2780,9715,12495
2022/08/09,14:00:00,597.77,2743,9816,12559
2022/08/09,14:30:00,598.06,2710,9992,12702
2022/08/09,15:00:00,597.2,2509,10162,12671
2022/08/09,15:30:00,597.49,2374,10306,12680
2022/08/09,16:00:00,597.77,2148,10442,12590
2022/08/09,16:30:00,597.2,1870,10677,12547
2022/08/09,17:00:00,596.92,1501,10796,12297
2022/08/09,17:30:00,596.64,1200,11030,12230
2022/08/09,18:00:00,598.34,838,11169,12007
2022/08/09,18:30:00,583.98,576,11252,11828
2022/08/09,19:00:00,583.72,223,11178,11401
2022/08/09,19:30:00,583.45,211,11193,11404
2022/08/09,20:00:00,576.3,215,11344,11559
2022/08/09,20:30:00,576.54,208,11279,11487
2022/08/09,21:00:00,575.8,213,11199,11412
2022/08/09,21:30:00,596.64,177,11119,11296
2022/08/09,22:00:00,597.49,106,10903,11009
2022/08/09,22:30:00,596.92,97,10702,10799
2022/08/09,23:00:00,598.06,90,10423,10513
2022/08/09,23:30:00,596.64,87,10120,10207
2022/08/10,00:00:00,590.01,72,9777,9849
2022/08/10,00:30:00,596.64,51,9556,9607
2022/08/10,01:00:00,596.92,48,9246,9294
2022/08/10,01:30:00,598.34,50,9018,9068
2022/08/10,02:00:00,597.2,75,8778,8853
2022/08/10,02:30:00,589.73,63,8663,8726
2022/08/10,03:00:00,597.49,67,8652,8719
2022/08/10,03:30:00,597.77,42,8574,8616
2022/08/10,04:00:00,597.2,69,8521,8590
2022/08/10,04:30:00,597.77,97,8473,8570
2022/08/10,05:00:00,596.07,98,8477,8575
2022/08/10,05:30:00,596.92,94,8478,8572
2022/08/10,06:00:00,596.64,92,8487,8579
2022/08/10,06:30:00,591.72,80,8626,8706
2022/08/10,07:00:00,596.07,270,8803,9073
2022/08/10,07:30:00,596.35,535,9087,9622
2022/08/10,08:00:00,505.54,736,9070,9806
2022/08/10,08:30:00,596.07,1135,9151,10286
2022/08/10,09:00:00,596.07,1485,9273,10758
2022/08/10,09:30:00,596.35,1848,9332,11180
2022/08/10,10:00:00,597.49,2093,9302,11395
2022/08/10,10:30:00,596.35,2338,9303,11641
2022/08/10,11:00:00,596.92,2437,9271,11708
2022/08/10,11:30:00,591.03,2615,9335,11950
2022/08/10,12:00:00,590.86,2708,9409,12117
2022/08/10,12:30:00,593.53,2711,9452,12163
2022/08/10,13:00:00,594.66,2750,9624,12374
2022/08/10,13:30:00,594.1,2812,9799,12611
2022/08/10,14:00:00,596.07,2729,9991,12720
2022/08/10,14:30:00,596.07,2572,10201,12773
2022/08/10,15:00:00,594.66,2469,10322,12791
2022/08/10,15:30:00,591.86,2367,10509,12876
2022/08/10,16:00:00,596.92,2114,10626,12740
2022/08/10,16:30:00,596.64,1832,10810,12642
2022/08/10,17:00:00,574.34,1531,10925,12456
2022/08/10,17:30:00,559.3,1222,11181,12403
2022/08/10,18:00:00,556.27,822,11309,12131
2022/08/10,18:30:00,555.65,570,11358,11928
2022/08/10,19:00:00,556.59,220,11305,11525
2022/08/10,19:30:00,560.95,216,11374,11590
2022/08/10,20:00:00,554.75,210,11526,11736
2022/08/10,20:30:00,553.48,192,11479,11671
2022/08/10,21:00:00,561.52,188,11378,11566
2022/08/10,21:30:00,560.76,104,11330,11434
2022/08/10,22:00:00,561.33,60,11148,11208
2022/08/10,22:30:00,562.88,89,10863,10952
2022/08/10,23:00:00,594.66,84,10617,10701
2022/08/10,23:30:00,597.49,79,10237,10316
2022/08/11,00:00:00,596.35,84,9963,10047
2022/08/11,00:30:00,597.2,85,9671,9756
2022/08/11,01:00:00,597.49,83,9416,9499
2022/08/11,01:30:00,596.35,79,9188,9267
2022/08/11,02:00:00,597.49,91,8960,9051
2022/08/11,02:30:00,596.92,92,8746,8838
2022/08/11,03:00:00,597.49,63,8786,8849
2022/08/11,03:30:00,596.92,72,8623,8695
2022/08/11,04:00:00,597.49,86,8535,8621
2022/08/11,04:30:00,596.92,88,8538,8626
2022/08/11,05:00:00,598.06,76,8552,8628
2022/08/11,05:30:00,596.35,76,8660,8736
2022/08/11,06:00:00,597.49,60,8637,8697
2022/08/11,06:30:00,587.47,56,8762,8818
2022/08/11,07:00:00,593.81,277,8847,9124
2022/08/11,07:30:00,596.35,552,9175,9727
2022/08/11,08:00:00,593.25,769,9208,9977
2022/08/11,08:30:00,595.79,1179,9330,10509
2022/08/11,09:00:00,593.81,1568,9518,11086
2022/08/11,09:30:00,600.06,1814,9561,11375
2022/08/11,10:00:00,598.34,2127,9534,11661
2022/08/11,10:30:00,519.09,2410,9521,11931
2022/08/11,11:00:00,519.06,2610,9503,12113
2022/08/11,11:30:00,591.43,2702,9597,12299
2022/08/11,12:00:00,592,2724,9673,12397
2022/08/11,12:30:00,596.64,2773,9728,12501
2022/08/11,13:00:00,597.49,2763,9862,12625
2022/08/11,13:30:00,596.07,2766,10035,12801
2022/08/11,14:00:00,596.35,2756,10188,12944
2022/08/11,14:30:00,597.49,2745,10334,13079
2022/08/11,15:00:00,596.07,2555,10290,12845
2022/08/11,15:30:00,589.1,2424,10439,12863
2022/08/11,16:00:00,585.24,2131,10563,12694
2022/08/11,16:30:00,576.79,1885,10745,12630
2022/08/11,17:00:00,567.88,1558,10918,12476
2022/08/11,17:30:00,566.37,1168,11161,12329
2022/08/11,18:00:00,557.08,805,11386,12191
2022/08/11,18:30:00,555.8,603,11489,12092
2022/08/11,19:00:00,555.65,484,11464,11948
2022/08/11,19:30:00,556.11,182,11461,11643
2022/08/11,20:00:00,555.96,167,11521,11688
2022/08/11,20:30:00,555.8,181,11417,11598
2022/08/11,21:00:00,555.65,198,11217,11415
2022/08/11,21:30:00,557.41,208,11064,11272
2022/08/11,22:00:00,562.48,210,10789,10999
2022/08/11,22:30:00,592.98,212,10525,10737
2022/08/11,23:00:00,596.35,212,10265,10477
2022/08/11,23:30:00,596.07,207,9963,10170
2022/08/12,00:00:00,594.66,174,9739,9913
2022/08/12,00:30:00,594.66,81,9597,9678
2022/08/12,01:00:00,594.66,79,9343,9422
2022/08/12,01:30:00,595.22,60,9116,9176
2022/08/12,02:00:00,595.79,61,8862,8923
2022/08/12,02:30:00,595.22,46,8703,8749
2022/08/12,03:00:00,596.35,40,8705,8745
2022/08/12,03:30:00,593.53,57,8572,8629
2022/08/12,04:00:00,594.94,39,8492,8531
2022/08/12,04:30:00,593.25,53,8427,8480
2022/08/12,05:00:00,593.53,57,8382,8439
2022/08/12,05:30:00,594.66,52,8378,8430
2022/08/12,06:00:00,511.35,53,8263,8316
2022/08/12,06:30:00,510.86,61,8163,8224
2022/08/12,07:00:00,510.86,283,8183,8466
2022/08/12,07:30:00,511.1,468,8281,8749
2022/08/12,08:00:00,511.1,725,8325,9050
2022/08/12,08:30:00,510.12,1042,8417,9459
2022/08/12,09:00:00,598.06,1280,8494,9774
2022/08/12,09:30:00,596.64,1590,8528,10118
2022/08/12,10:00:00,598.34,2048,8413,10461
2022/08/12,10:30:00,595.5,2232,8417,10649
2022/08/12,11:00:00,596.92,2430,8549,10979
2022/08/12,11:30:00,595.79,2536,8716,11252
2022/08/12,12:00:00,597.2,2597,8752,11349
2022/08/12,12:30:00,594.66,2570,8853,11423
2022/08/12,13:00:00,596.07,2671,8893,11564
2022/08/12,13:30:00,596.35,2604,8996,11600
2022/08/12,14:00:00,596.35,2588,9101,11689
2022/08/12,14:30:00,596.07,2678,9199,11877
2022/08/12,15:00:00,596.35,2445,9380,11825
2022/08/12,15:30:00,596.07,2282,9480,11762
2022/08/12,16:00:00,596.92,2063,9507,11570
2022/08/12,16:30:00,595.22,1844,9670,11514
2022/08/12,17:00:00,596.07,1553,9921,11474
2022/08/12,17:30:00,596.92,1219,10222,11441
2022/08/12,18:00:00,594.66,869,10541,11410
2022/08/12,18:30:00,596.35,635,10772,11407
2022/08/12,19:00:00,580.58,205,10861,11066
2022/08/12,19:30:00,592.42,198,10718,10916
2022/08/12,20:00:00,596.07,182,10685,10867
2022/08/12,20:30:00,596.35,192,10498,10690
2022/08/12,21:00:00,596.35,190,10316,10506
2022/08/12,21:30:00,596.35,189,10095,10284
2022/08/12,22:00:00,597.49,186,9878,10064
2022/08/12,22:30:00,597.2,178,9793,9971
2022/08/12,23:00:00,596.35,177,9592,9769
2022/08/12,23:30:00,596.07,162,9382,9544
2022/08/13,00:00:00,596.64,139,9191,9330
2022/08/13,00:30:00,596.35,73,9099,9172
2022/08/13,01:00:00,596.07,69,8864,8933
2022/08/13,01:30:00,598.34,65,8673,8738
2022/08/13,02:00:00,596.35,64,8486,8550
2022/08/13,02:30:00,596.64,55,8375,8430
2022/08/13,03:00:00,596.35,64,8180,8244
2022/08/13,03:30:00,598.06,75,8151,8226
2022/08/13,04:00:00,594.1,73,8199,8272
2022/08/13,04:30:00,596.07,73,8137,8210
2022/08/13,05:00:00,597.49,52,8128,8180
2022/08/13,05:30:00,597.77,63,8031,8094
2022/08/13,06:00:00,596.64,70,7898,7968
2022/08/13,06:30:00,594.38,65,7774,7839
2022/08/13,07:00:00,596.07,298,7605,7903
2022/08/13,07:30:00,596.35,558,7527,8085
2022/08/13,08:00:00,507.22,912,7251,8163
2022/08/13,08:30:00,597.49,1331,7120,8451
2022/08/13,09:00:00,596.64,1514,7292,8806
2022/08/13,09:30:00,596.92,1537,7440,8977
2022/08/13,10:00:00,596.64,1781,7545,9326
2022/08/13,10:30:00,507.46,1775,7482,9257
2022/08/13,11:00:00,596.64,1997,7605,9602
2022/08/13,11:30:00,596.35,2217,7472,9689
2022/08/13,12:00:00,597.2,2503,7543,10046
2022/08/13,12:30:00,594.66,2697,7582,10279
2022/08/13,13:00:00,596.07,2763,7651,10414
2022/08/13,13:30:00,597.77,2781,7712,10493
2022/08/13,14:00:00,595.79,2722,7801,10523
2022/08/13,14:30:00,597.49,2714,7944,10658
2022/08/13,15:00:00,596.35,2569,8086,10655
2022/08/13,15:30:00,596.35,2349,8332,10681
2022/08/13,16:00:00,507.46,2181,8597,10778
2022/08/13,16:30:00,596.07,1918,8857,10775
2022/08/13,17:00:00,596.07,1554,9183,10737
2022/08/13,17:30:00,595.22,1232,9574,10806
2022/08/13,18:00:00,597.2,806,9827,10633
2022/08/13,18:30:00,596.92,577,10044,10621
2022/08/13,19:00:00,597.2,212,10151,10363
2022/08/13,19:30:00,596.35,213,10321,10534
2022/08/13,20:00:00,576.54,211,10460,10671
2022/08/13,20:30:00,584.25,200,10429,10629
2022/08/13,21:00:00,584.25,185,10427,10612
2022/08/13,21:30:00,588.28,181,10375,10556
2022/08/13,22:00:00,594.1,198,10258,10456
2022/08/13,22:30:00,596.92,200,10078,10278
2022/08/13,23:00:00,596.35,174,9934,10108
2022/08/13,23:30:00,594.94,84,9710,9794
2022/08/14,00:00:00,596.92,72,9402,9474
2022/08/14,00:30:00,598.06,40,9183,9223
2022/08/14,01:00:00,591.43,47,8899,8946
2022/08/14,01:30:00,596.92,59,8705,8764
2022/08/14,02:00:00,595.79,65,8483,8548
2022/08/14,02:30:00,596.64,58,8290,8348
2022/08/14,03:00:00,598.34,65,8302,8367
2022/08/14,03:30:00,597.2,72,8180,8252
2022/08/14,04:00:00,595.22,67,8172,8239
2022/08/14,04:30:00,596.92,75,8115,8190
2022/08/14,05:00:00,597.77,71,8159,8230
2022/08/14,05:30:00,595.22,64,8267,8331
2022/08/14,06:00:00,595.5,50,8278,8328
2022/08/14,06:30:00,596.35,51,8395,8446
2022/08/14,07:00:00,594.66,285,8592,8877
2022/08/14,07:30:00,596.35,504,8915,9419
2022/08/14,08:00:00,593.81,794,8819,9613
2022/08/14,08:30:00,598.06,1232,8974,10206
2022/08/14,09:00:00,595.22,1522,9062,10584
2022/08/14,09:30:00,588.6,1697,9269,10966
2022/08/14,10:00:00,597.2,1803,9161,10964
2022/08/14,10:30:00,590.01,2104,9202,11306
2022/08/14,11:00:00,590.58,2329,9238,11567
2022/08/14,11:30:00,596.07,2291,9291,11582
2022/08/14,12:00:00,596.35,2674,9234,11908
2022/08/14,12:30:00,597.2,2670,9307,11977
2022/08/14,13:00:00,596.64,2725,9418,12143
2022/08/14,13:30:00,596.35,2727,9632,12359
2022/08/14,14:00:00,596.64,2818,9691,12509
2022/08/14,14:30:00,597.2,2798,9855,12653
2022/08/14,15:00:00,595.22,2735,9983,12718
2022/08/14,15:30:00,595.5,2442,10142,12584
2022/08/14,16:00:00,596.92,2183,10257,12440
2022/08/14,16:30:00,583.98,1972,10439,12411
2022/08/14,17:00:00,591.86,1633,10501,12134
2022/08/14,17:30:00,583.19,1219,10752,11971
2022/08/14,18:00:00,560.95,918,10953,11871
2022/08/14,18:30:00,554.6,604,11066,11670
2022/08/14,19:00:00,552.95,469,11080,11549
2022/08/14,19:30:00,552.82,179,11153,11332
2022/08/14,20:00:00,552.95,177,11237,11414
2022/08/14,20:30:00,552.95,168,11169,11337
2022/08/14,21:00:00,552.56,160,11054,11214
2022/08/14,21:30:00,552.69,154,10965,11119
2022/08/14,22:00:00,553.61,155,10678,10833
2022/08/14,22:30:00,578.54,152,10415,10567
2022/08/14,23:00:00,582.4,147,10122,10269
2022/08/14,23:30:00,591.86,131,9855,9986
2022/08/15,00:00:00,593.81,80,9580,9660
2022/08/15,00:30:00,595.22,53,9307,9360
2022/08/15,01:00:00,595.5,46,9049,9095
2022/08/15,01:30:00,594.38,37,8838,8875
2022/08/15,02:00:00,596.35,45,8665,8710
2022/08/15,02:30:00,594.38,48,8574,8622
2022/08/15,03:00:00,596.92,47,8479,8526
2022/08/15,03:30:00,596.07,49,8390,8439
2022/08/15,04:00:00,596.35,59,8240,8299
2022/08/15,04:30:00,597.2,68,8208,8276
2022/08/15,05:00:00,596.64,73,8260,8333
2022/08/15,05:30:00,596.92,67,8282,8349
2022/08/15,06:00:00,597.77,77,8282,8359
2022/08/15,06:30:00,595.22,70,8414,8484
2022/08/15,07:00:00,596.35,278,8565,8843
2022/08/15,07:30:00,595.5,531,8800,9331
2022/08/15,08:00:00,596.64,774,8858,9632
2022/08/15,08:30:00,597.2,1202,8972,10174
2022/08/15,09:00:00,595.79,1582,9009,10591
2022/08/15,09:30:00,596.35,1714,8867,10581
2022/08/15,10:00:00,597.2,1966,8760,10726
2022/08/15,10:30:00,595.5,2176,8928,11104
2022/08/15,11:00:00,594.94,2419,8932,11351
2022/08/15,11:30:00,596.92,2531,8944,11475
2022/08/15,12:00:00,595.22,2741,8959,11700
2022/08/15,12:30:00,595.79,2777,9105,11882
2022/08/15,13:00:00,595.22,2802,9257,12059
2022/08/15,13:30:00,594.94,2824,9423,12247
2022/08/15,14:00:00,595.79,2810,9620,12430
2022/08/15,14:30:00,598.06,2655,9621,12276
2022/08/15,15:00:00,596.92,2546,9764,12310
2022/08/15,15:30:00,596.35,2317,9921,12238
2022/08/15,16:00:00,596.64,2066,10070,12136
2022/08/15,16:30:00,594.66,1832,10266,12098
2022/08/15,17:00:00,595.5,1547,10387,11934
2022/08/15,17:30:00,597.2,1199,10691,11890
2022/08/15,18:00:00,584.51,821,10931,11752
2022/08/15,18:30:00,584.25,504,11051,11555
2022/08/15,19:00:00,595.79,353,11015,11368
2022/08/15,19:30:00,590.48,185,11104,11289
2022/08/15,20:00:00,583.45,162,11165,11327
2022/08/15,20:30:00,583.98,172,11050,11222
2022/08/15,21:00:00,586.12,169,10949,11118
2022/08/15,21:30:00,596.64,152,10855,11007
2022/08/15,22:00:00,597.2,146,10617,10763
2022/08/15,22:30:00,596.35,143,10373,10516
2022/08/15,23:00:00,595.79,139,10037,10176
2022/08/15,23:30:00,596.35,136,9733,9869
2022/08/16,00:00:00,596.07,71,9474,9545
2022/08/16,00:30:00,595.22,23,9279,9302
2022/08/16,01:00:00,595.5,21,8994,9015
2022/08/16,01:30:00,595.5,17,8758,8775
2022/08/16,02:00:00,596.35,7,8591,8598
2022/08/16,02:30:00,596.92,3,8581,8584
2022/08/16,03:00:00,596.07,2,8424,8426
2022/08/16,03:30:00,596.07,2,8380,8382
2022/08/16,04:00:00,595.5,3,8291,8294
2022/08/16,04:30:00,596.35,3,8291,8294
2022/08/16,05:00:00,594.94,0,8279,8279
2022/08/16,05:30:00,596.07,0,8282,8282
2022/08/16,06:00:00,596.92,0,8264,8264
2022/08/16,06:30:00,596.35,0,8395,8395
2022/08/16,07:00:00,596.35,175,8553,8728
2022/08/16,07:30:00,594.66,396,8764,9160
2022/08/16,08:00:00,596.07,684,8868,9552
2022/08/16,08:30:00,596.35,1111,8892,10003
2022/08/16,09:00:00,589.73,1483,8886,10369
2022/08/16,09:30:00,600.92,1784,8904,10688
2022/08/16,10:00:00,598.06,2044,8818,10862
2022/08/16,10:30:00,596.92,2264,8870,11134
2022/08/16,11:00:00,596.35,2439,8904,11343
2022/08/16,11:30:00,594.38,2603,8940,11543
2022/08/16,12:00:00,595.5,2775,9102,11877
2022/08/16,12:30:00,596.07,2810,9215,12025
2022/08/16,13:00:00,595.5,2821,9257,12078
2022/08/16,13:30:00,594.38,2791,9461,12252
2022/08/16,14:00:00,594.38,2764,9605,12369
2022/08/16,14:30:00,595.22,2625,9786,12411
2022/08/16,15:00:00,597.2,2460,9957,12417
2022/08/16,15:30:00,596.35,2239,10112,12351
2022/08/16,16:00:00,596.07,2006,10268,12274
2022/08/16,16:30:00,596.07,1737,10486,12223
2022/08/16,17:00:00,595.22,1421,10652,12073
2022/08/16,17:30:00,594.1,1053,10933,11986
2022/08/16,18:00:00,579.56,705,11145,11850
2022/08/16,18:30:00,570.95,432,11246,11678
2022/08/16,19:00:00,573.47,143,11210,11353
2022/08/16,19:30:00,570.7,147,11283,11430
2022/08/16,20:00:00,570.45,149,11315,11464
2022/08/16,20:30:00,570.45,144,11206,11350
2022/08/16,21:00:00,574.83,143,11099,11242
2022/08/16,21:30:00,575.56,141,11002,11143
2022/08/16,22:00:00,583.19,66,10812,10878
2022/08/16,22:30:00,506.26,33,10566,10599
2022/08/16,23:00:00,596.92,30,10368,10398
2022/08/16,23:30:00,596.64,29,10059,10088
2022/08/17,00:00:00,597.49,35,9751,9786
2022/08/17,00:30:00,596.92,18,9398,9416
2022/08/17,01:00:00,596.92,14,9165,9179
2022/08/17,01:30:00,598.34,13,8948,8961
2022/08/17,02:00:00,598.06,10,8764,8774
2022/08/17,02:30:00,596.92,8,8588,8596
2022/08/17,03:00:00,592,9,8558,8567
2022/08/17,03:30:00,596.64,13,8508,8521
2022/08/17,04:00:00,596.92,17,8420,8437
2022/08/17,04:30:00,598.34,18,8342,8360
2022/08/17,05:00:00,596.92,17,8356,8373
2022/08/17,05:30:00,595.79,29,8422,8451
2022/08/17,06:00:00,596.92,24,8422,8446
2022/08/17,06:30:00,596.35,23,8508,8531
2022/08/17,07:00:00,596.35,203,8665,8868
2022/08/17,07:30:00,596.92,391,8877,9268
2022/08/17,08:00:00,596.64,676,9033,9709
2022/08/17,08:30:00,595.5,936,9240,10176
2022/08/17,09:00:00,597.77,1108,9391,10499
2022/08/17,09:30:00,596.07,1335,9463,10798
2022/08/17,10:00:00,595.22,1801,9241,11042
2022/08/17,10:30:00,597.49,1942,9233,11175
2022/08/17,11:00:00,596.35,2278,9160,11438
2022/08/17,11:30:00,590.01,2587,9133,11720
2022/08/17,12:00:00,595.79,2771,9211,11982
2022/08/17,12:30:00,596.64,2820,9315,12135
2022/08/17,13:00:00,596.64,2821,9490,12311
2022/08/17,13:30:00,596.35,2802,9521,12323
2022/08/17,14:00:00,596.35,2568,9675,12243
2022/08/17,14:30:00,597.49,2603,9865,12468
2022/08/17,15:00:00,596.35,2470,10000,12470
2022/08/17,15:30:00,597.2,2241,10168,12409
2022/08/17,16:00:00,596.92,2003,10284,12287
2022/08/17,16:30:00,596.35,1730,10509,12239
2022/08/17,17:00:00,598.06,1444,10625,12069
2022/08/17,17:30:00,591.58,1075,10894,11969
2022/08/17,18:00:00,582.14,709,11104,11813
2022/08/17,18:30:00,582.14,464,11180,11644
2022/08/17,19:00:00,575.31,155,11120,11275
2022/08/17,19:30:00,576.54,156,11168,11324
2022/08/17,20:00:00,576.79,154,11213,11367
2022/08/17,20:30:00,595.5,149,11123,11272
2022/08/17,21:00:00,592,93,11053,11146
2022/08/17,21:30:00,597.49,34,10996,11030
2022/08/17,22:00:00,598.06,36,10733,10769
2022/08/17,22:30:00,595.22,34,10499,10533
2022/08/17,23:00:00,595.5,42,10222,10264
2022/08/17,23:30:00,595.22,42,9905,9947
2022/08/18,00:00:00,591.58,53,9598,9651
2022/08/18,00:30:00,596.92,43,9348,9391
2022/08/18,01:00:00,595.5,42,9074,9116
2022/08/18,01:30:00,596.07,37,8858,8895
2022/08/18,02:00:00,595.22,52,8623,8675
2022/08/18,02:30:00,595.79,48,8594,8642
2022/08/18,03:00:00,592,43,8455,8498
2022/08/18,03:30:00,591.43,38,8357,8395
2022/08/18,04:00:00,591.43,38,8264,8302
2022/08/18,04:30:00,591.43,46,8206,8252
2022/08/18,05:00:00,591.43,41,8219,8260
2022/08/18,05:30:00,592,48,8249,8297
2022/08/18,06:00:00,596.35,34,8230,8264
2022/08/18,06:30:00,595.79,29,8284,8313
2022/08/18,07:00:00,596.35,168,8434,8602
2022/08/18,07:30:00,596.92,383,8661,9044
2022/08/18,08:00:00,597.49,730,8739,9469
2022/08/18,08:30:00,597.2,1070,8800,9870
2022/08/18,09:00:00,598.06,1390,8803,10193
2022/08/18,09:30:00,592,1691,8755,10446
2022/08/18,10:00:00,597.49,2048,8681,10729
2022/08/18,10:30:00,598.34,2255,8686,10941
2022/08/18,11:00:00,595.79,2455,8728,11183
2022/08/18,11:30:00,596.07,2591,8836,11427
2022/08/18,12:00:00,596.07,2790,8928,11718
2022/08/18,12:30:00,596.07,2804,8965,11769
2022/08/18,13:00:00,597.2,2796,9128,11924
2022/08/18,13:30:00,596.35,2797,9309,12106
2022/08/18,14:00:00,597.49,2788,9437,12225
2022/08/18,14:30:00,596.92,2643,9615,12258
2022/08/18,15:00:00,596.92,2535,9756,12291
2022/08/18,15:30:00,596.92,2281,9902,12183
2022/08/18,16:00:00,597.49,2065,10026,12091
2022/08/18,16:30:00,596.35,1764,10259,12023
2022/08/18,17:00:00,596.35,1477,10406,11883
2022/08/18,17:30:00,596.92,1072,10705,11777
2022/08/18,18:00:00,594.1,724,10901,11625
2022/08/18,18:30:00,577.79,451,10995,11446
2022/08/18,19:00:00,580.84,155,10888,11043
2022/08/18,19:30:00,578.54,156,10972,11128
2022/08/18,20:00:00,580.07,154,11020,11174
2022/08/18,20:30:00,582.14,155,10877,11032
2022/08/18,21:00:00,590.48,155,10727,10882
2022/08/18,21:30:00,597.2,150,10560,10710
2022/08/18,22:00:00,595.22,144,10282,10426
2022/08/18,22:30:00,592,138,10051,10189
2022/08/18,23:00:00,596.64,133,9818,9951
2022/08/18,23:30:00,596.07,92,9578,9670
2022/08/19,00:00:00,596.07,34,9398,9432
2022/08/19,00:30:00,596.35,39,9127,9166
2022/08/19,01:00:00,598.06,33,8873,8906
2022/08/19,01:30:00,596.92,27,8668,8695
2022/08/19,02:00:00,598.06,22,8605,8627
2022/08/19,02:30:00,596.92,13,8429,8442
2022/08/19,03:00:00,596.64,11,8301,8312
2022/08/19,03:30:00,596.92,9,8180,8189
2022/08/19,04:00:00,595.5,11,8088,8099
2022/08/19,04:30:00,595.5,11,8045,8056
2022/08/19,05:00:00,596.35,16,8015,8031
2022/08/19,05:30:00,596.35,15,8030,8045
2022/08/19,06:00:00,597.2,16,7937,7953
2022/08/19,06:30:00,596.35,15,7844,7859
2022/08/19,07:00:00,596.07,183,7841,8024
2022/08/19,07:30:00,596.35,384,7876,8260
2022/08/19,08:00:00,596.92,649,7883,8532
2022/08/19,08:30:00,589.73,1028,7790,8818
2022/08/19,09:00:00,598.63,1399,7810,9209
2022/08/19,09:30:00,596.07,1641,7875,9516
2022/08/19,10:00:00,597.2,1992,7905,9897
2022/08/19,10:30:00,597.2,2084,8026,10110
2022/08/19,11:00:00,596.64,2364,8043,10407
2022/08/19,11:30:00,596.92,2552,8136,10688
2022/08/19,12:00:00,597.49,2741,8234,10975
2022/08/19,12:30:00,598.91,2713,8231,10944
2022/08/19,13:00:00,597.49,2732,8363,11095
2022/08/19,13:30:00,597.77,2716,8472,11188
2022/08/19,14:00:00,596.92,2775,8618,11393
2022/08/19,14:30:00,597.77,2582,8755,11337
2022/08/19,15:00:00,596.64,2493,8914,11407
2022/08/19,15:30:00,596.35,2259,9075,11334
2022/08/19,16:00:00,596.35,2031,9289,11320
2022/08/19,16:30:00,595.79,1754,9529,11283
2022/08/19,17:00:00,596.64,1379,9893,11272
2022/08/19,17:30:00,592.42,1089,10170,11259
2022/08/19,18:00:00,571.04,715,10481,11196
2022/08/19,18:30:00,557.24,481,10744,11225
2022/08/19,19:00:00,556.43,146,10732,10878
2022/08/19,19:30:00,555.8,155,10678,10833
2022/08/19,20:00:00,555.34,158,10568,10726
2022/08/19,20:30:00,572.44,160,10368,10528
2022/08/19,21:00:00,582.4,154,10185,10339
2022/08/19,21:30:00,594.94,121,10005,10126
2022/08/19,22:00:00,596.64,149,9812,9961
2022/08/19,22:30:00,596.35,156,9607,9763
2022/08/19,23:00:00,596.07,161,9488,9649
2022/08/19,23:30:00,596.92,133,9318,9451
2022/08/20,00:00:00,596.07,67,9108,9175
2022/08/20,00:30:00,597.2,39,8950,8989
2022/08/20,01:00:00,596.35,37,8745,8782
2022/08/20,01:30:00,598.06,42,8518,8560
2022/08/20,02:00:00,596.64,45,8355,8400
2022/08/20,02:30:00,594.66,39,8184,8223
2022/08/20,03:00:00,596.35,46,8051,8097
2022/08/20,03:30:00,597.49,38,7936,7974
2022/08/20,04:00:00,595.79,40,7834,7874
2022/08/20,04:30:00,597.49,39,7809,7848
2022/08/20,05:00:00,596.35,36,7737,7773
2022/08/20,05:30:00,592,34,7727,7761
2022/08/20,06:00:00,597.49,36,7617,7653
2022/08/20,06:30:00,591.86,33,7580,7613
2022/08/20,07:00:00,596.07,193,7440,7633
2022/08/20,07:30:00,597.77,419,7311,7730
2022/08/20,08:00:00,596.35,688,7232,7920
2022/08/20,08:30:00,591.43,1022,7138,8160
2022/08/20,09:00:00,593.53,1413,7069,8482
2022/08/20,09:30:00,595.79,1750,6985,8735
2022/08/20,10:00:00,590.86,2048,7036,9084
2022/08/20,10:30:00,597.77,2253,7153,9406
2022/08/20,11:00:00,594.66,2429,7265,9694
2022/08/20,11:30:00,594.66,2614,7349,9963
2022/08/20,12:00:00,596.64,2751,7498,10249
2022/08/20,12:30:00,596.92,2782,7612,10394
2022/08/20,13:00:00,596.64,2740,7798,10538
2022/08/20,13:30:00,595.79,2757,7942,10699
2022/08/20,14:00:00,595.5,2743,8111,10854
2022/08/20,14:30:00,595.5,2633,8219,10852
2022/08/20,15:00:00,594.94,2462,8276,10738
2022/08/20,15:30:00,589.16,2237,8545,10782
2022/08/20,16:00:00,593.81,2024,8841,10865
2022/08/20,16:30:00,590.48,1739,9162,10901
2022/08/20,17:00:00,591.86,1443,9442,10885
2022/08/20,17:30:00,588.32,1085,9804,10889
2022/08/20,18:00:00,580.85,737,10089,10826
2022/08/20,18:30:00,560.76,475,10300,10775
2022/08/20,19:00:00,560.95,186,10358,10544
2022/08/20,19:30:00,561.14,175,10585,10760
2022/08/20,20:00:00,553.08,168,10699,10867
2022/08/20,20:30:00,556.11,155,10667,10822
2022/08/20,21:00:00,555.8,169,10679,10848
2022/08/20,21:30:00,562.29,171,10531,10702
2022/08/20,22:00:00,567.01,174,10414,10588
2022/08/20,22:30:00,583.72,170,10293,10463
2022/08/20,23:00:00,593.53,160,10031,10191
2022/08/20,23:30:00,597.49,102,9810,9912
2022/08/21,00:00:00,597.77,41,9526,9567
2022/08/21,00:30:00,598.34,43,9327,9370
2022/08/21,01:00:00,590.48,47,9046,9093
2022/08/21,01:30:00,597.2,55,8810,8865
2022/08/21,02:00:00,591.43,58,8546,8604
2022/08/21,02:30:00,492.85,58,8525,8583
2022/08/21,03:00:00,598.06,55,8425,8480
2022/08/21,03:30:00,596.92,61,8329,8390
2022/08/21,04:00:00,597.49,63,8243,8306
2022/08/21,04:30:00,596.92,59,8260,8319
2022/08/21,05:00:00,596.64,51,8298,8349
2022/08/21,05:30:00,596.35,39,8338,8377
2022/08/21,06:00:00,596.92,53,8386,8439
2022/08/21,06:30:00,598.34,46,8468,8514
2022/08/21,07:00:00,493.89,183,8679,8862
2022/08/21,07:30:00,493.37,390,8842,9232
2022/08/21,08:00:00,492.85,693,8994,9687
2022/08/21,08:30:00,595.5,1099,9137,10236
2022/08/21,09:00:00,493.37,1454,9130,10584
2022/08/21,09:30:00,595.5,1757,9424,11181
2022/08/21,10:00:00,598.34,2016,9348,11364
2022/08/21,10:30:00,593.81,2243,9369,11612
2022/08/21,11:00:00,593.81,2460,9434,11894
2022/08/21,11:30:00,592.98,2613,9523,12136
2022/08/21,12:00:00,596.35,2737,9463,12200
2022/08/21,12:30:00,593.53,2805,9660,12465
2022/08/21,13:00:00,595.5,2775,9891,12666
2022/08/21,13:30:00,594.66,2713,10015,12728
2022/08/21,14:00:00,577.79,2720,10168,12888
2022/08/21,14:30:00,574.83,2584,10337,12921
2022/08/21,15:00:00,575.8,2447,10405,12852
2022/08/21,15:30:00,572.91,2246,10507,12753
2022/08/21,16:00:00,557.24,2042,10594,12636
2022/08/21,16:30:00,552.69,1755,10803,12558
2022/08/21,17:00:00,553.08,1447,10914,12361
2022/08/21,17:30:00,549.36,1060,11184,12244
2022/08/21,18:00:00,547.37,717,11344,12061
2022/08/21,18:30:00,547.26,463,11385,11848
2022/08/21,19:00:00,547.2,195,11306,11501
2022/08/21,19:30:00,547.12,202,11366,11568
2022/08/21,20:00:00,547.88,212,11363,11575
2022/08/21,20:30:00,550.19,210,11255,11465
2022/08/21,21:00:00,550.19,199,11196,11395
2022/08/21,21:30:00,556.43,197,11048,11245
2022/08/21,22:00:00,555.04,180,10838,11018
2022/08/21,22:30:00,558.43,154,10586,10740
2022/08/21,23:00:00,585.58,151,10288,10439
2022/08/21,23:30:00,595.79,84,10011,10095
2022/08/22,00:00:00,597.49,23,9772,9795
2022/08/22,00:30:00,597.2,15,9460,9475
2022/08/22,01:00:00,596.07,16,9146,9162
2022/08/22,01:30:00,596.35,17,8901,8918
2022/08/22,02:00:00,597.2,14,8738,8752
2022/08/22,02:30:00,595.79,16,8716,8732
2022/08/22,03:00:00,596.35,14,8537,8551
2022/08/22,03:30:00,596.35,16,8429,8445
2022/08/22,04:00:00,590.01,15,8356,8371
2022/08/22,04:30:00,591.43,17,8315,8332
2022/08/22,05:00:00,596.64,17,8328,8345
2022/08/22,05:30:00,595.22,19,8447,8466
2022/08/22,06:00:00,596.35,22,8439,8461
2022/08/22,06:30:00,596.07,27,8535,8562
2022/08/22,07:00:00,595.22,177,8666,8843
2022/08/22,07:30:00,596.07,392,8957,9349
2022/08/22,08:00:00,596.07,690,9079,9769
2022/08/22,08:30:00,595.22,1023,9181,10204
2022/08/22,09:00:00,595.22,1313,9301,10614
2022/08/22,09:30:00,595.5,1611,9314,10925
2022/08/22,10:00:00,596.35,1880,9274,11154
2022/08/22,10:30:00,594.94,2040,9266,11306
2022/08/22,11:00:00,596.07,2298,9166,11464
2022/08/22,11:30:00,595.79,2343,9258,11601
2022/08/22,12:00:00,595.22,2683,9321,12004
2022/08/22,12:30:00,596.07,2704,9477,12181
2022/08/22,13:00:00,596.92,2761,9589,12350
2022/08/22,13:30:00,596.92,2777,9792,12569
2022/08/22,14:00:00,596.07,2709,10004,12713
2022/08/22,14:30:00,594.66,2615,10104,12719
2022/08/22,15:00:00,596.07,2522,10067,12589
2022/08/22,15:30:00,596.92,2267,10287,12554
2022/08/22,16:00:00,579.05,2021,10359,12380
2022/08/22,16:30:00,572.44,1788,10540,12328
2022/08/22,17:00:00,566.8,1467,10657,12124
2022/08/22,17:30:00,561.33,1130,10945,12075
2022/08/22,18:00:00,560.76,793,11080,11873
2022/08/22,18:30:00,560.76,511,11154,11665
2022/08/22,19:00:00,552.82,216,11112,11328
2022/08/22,19:30:00,552.69,234,11237,11471
2022/08/22,20:00:00,553.75,224,11260,11484
2022/08/22,20:30:00,552.95,221,11199,11420
2022/08/22,21:00:00,554.6,219,11095,11314
2022/08/22,21:30:00,551.82,212,10959,11171
2022/08/22,22:00:00,559.3,207,10784,10991
2022/08/22,22:30:00,570.35,134,10621,10755
2022/08/22,23:00:00,582.14,48,10433,10481
2022/08/22,23:30:00,586.07,49,10087,10136
2022/08/23,00:00:00,586.12,58,9783,9841
2022/08/23,00:30:00,591.43,66,9415,9481
2022/08/23,01:00:00,589.73,66,9119,9185
2022/08/23,01:30:00,589.16,67,8928,8995
2022/08/23,02:00:00,590.29,60,8713,8773
2022/08/23,02:30:00,590.01,54,8570,8624
2022/08/23,03:00:00,591.43,46,8549,8595
2022/08/23,03:30:00,590.58,56,8458,8514
2022/08/23,04:00:00,589.16,52,8392,8444
2022/08/23,04:30:00,589.44,46,8361,8407
2022/08/23,05:00:00,589.73,51,8379,8430
2022/08/23,05:30:00,589.73,35,8434,8469
2022/08/23,06:00:00,589.73,36,8396,8432
2022/08/23,06:30:00,589.73,39,8490,8529
2022/08/23,07:00:00,593.25,219,8689,8908
2022/08/23,07:30:00,492.34,481,8840,9321
2022/08/23,08:00:00,594.1,859,8728,9587
2022/08/23,08:30:00,596.64,1231,8836,10067
2022/08/23,09:00:00,596.64,1495,8867,10362
2022/08/23,09:30:00,596.07,1746,8971,10717
2022/08/23,10:00:00,598.06,2011,8955,10966
2022/08/23,10:30:00,596.92,2127,8938,11065
2022/08/23,11:00:00,593.53,2310,8950,11260
2022/08/23,11:30:00,595.5,2485,8972,11457
2022/08/23,12:00:00,596.07,2778,9066,11844
2022/08/23,12:30:00,596.64,2797,9191,11988
2022/08/23,13:00:00,596.92,2786,9444,12230
2022/08/23,13:30:00,595.5,2785,9640,12425
2022/08/23,14:00:00,596.92,2782,9774,12556
2022/08/23,14:30:00,596.07,2522,9864,12386
2022/08/23,15:00:00,596.07,2394,9967,12361
2022/08/23,15:30:00,594.1,2204,9983,12187
2022/08/23,16:00:00,596.35,2004,10084,12088
2022/08/23,16:30:00,596.07,1792,10303,12095
2022/08/23,17:00:00,595.79,1513,10376,11889
2022/08/23,17:30:00,593.25,1149,10638,11787
2022/08/23,18:00:00,573.62,783,10842,11625
2022/08/23,18:30:00,572.2,519,10957,11476
2022/08/23,19:00:00,571.73,179,10940,11119
2022/08/23,19:30:00,571.27,207,11030,11237
2022/08/23,20:00:00,571.5,202,11021,11223
2022/08/23,20:30:00,571.73,190,10916,11106
2022/08/23,21:00:00,581.62,188,10845,11033
2022/08/23,21:30:00,583.19,179,10752,10931
2022/08/23,22:00:00,592.98,177,10564,10741
2022/08/23,22:30:00,595.22,151,10327,10478
2022/08/23,23:00:00,595.5,165,10046,10211
2022/08/23,23:30:00,595.22,158,9745,9903
2022/08/24,00:00:00,596.07,104,9503,9607
2022/08/24,00:30:00,596.92,76,9246,9322
2022/08/24,01:00:00,596.64,40,8987,9027
2022/08/24,01:30:00,594.66,36,8903,8939
2022/08/24,02:00:00,596.92,29,8669,8698
2022/08/24,02:30:00,595.5,24,8504,8528
2022/08/24,03:00:00,598.34,29,8345,8374
2022/08/24,03:30:00,595.5,25,8254,8279
2022/08/24,04:00:00,597.49,23,8149,8172
2022/08/24,04:30:00,597.2,20,8117,8137
2022/08/24,05:00:00,595.79,20,8141,8161
2022/08/24,05:30:00,596.92,16,8226,8242
2022/08/24,06:00:00,595.79,13,8211,8224
2022/08/24,06:30:00,595.79,13,8222,8235
2022/08/24,07:00:00,594.66,200,8343,8543
2022/08/24,07:30:00,597.2,470,8424,8894
2022/08/24,08:00:00,596.92,871,8425,9296
2022/08/24,08:30:00,598.34,1240,8462,9702
2022/08/24,09:00:00,492.34,1522,8476,9998
2022/08/24,09:30:00,589.16,1780,8510,10290
2022/08/24,10:00:00,492.85,2018,8506,10524
2022/08/24,10:30:00,594.66,2196,8552,10748
2022/08/24,11:00:00,595.22,2364,8625,10989
2022/08/24,11:30:00,594.66,2487,8721,11208
2022/08/24,12:00:00,592.42,2764,8678,11442
2022/08/24,12:30:00,592.98,2766,8847,11613
2022/08/24,13:00:00,595.79,2763,9042,11805
2022/08/24,13:30:00,594.66,2787,9256,12043
2022/08/24,14:00:00,592.98,2756,9469,12225
2022/08/24,14:30:00,594.94,2546,9624,12170
2022/08/24,15:00:00,595.22,2329,9792,12121
2022/08/24,15:30:00,592.98,2195,9971,12166
2022/08/24,16:00:00,595.79,1992,10179,12171
2022/08/24,16:30:00,592.42,1720,10427,12147
2022/08/24,17:00:00,576.54,1405,10614,12019
2022/08/24,17:30:00,575.31,1060,10942,12002
2022/08/24,18:00:00,555.8,698,11151,11849
2022/08/24,18:30:00,553.48,437,11271,11708
2022/08/24,19:00:00,552.82,165,11181,11346
2022/08/24,19:30:00,553.08,179,11301,11480
2022/08/24,20:00:00,553.21,183,11252,11435
2022/08/24,20:30:00,552.82,194,11123,11317
2022/08/24,21:00:00,553.34,203,11023,11226
2022/08/24,21:30:00,552.95,194,10907,11101
2022/08/24,22:00:00,575.8,202,10646,10848
2022/08/24,22:30:00,595.22,175,10450,10625
2022/08/24,23:00:00,596.07,172,10169,10341
2022/08/24,23:30:00,596.92,158,9851,10009
2022/08/25,00:00:00,596.92,84,9644,9728
2022/08/25,00:30:00,596.92,27,9431,9458
2022/08/25,01:00:00,597.49,17,9174,9191
2022/08/25,01:30:00,590.58,18,8925,8943
2022/08/25,02:00:00,597.49,20,8720,8740
2022/08/25,02:30:00,589.73,18,8540,8558
2022/08/25,03:00:00,598.06,20,8410,8430
2022/08/25,03:30:00,597.77,20,8295,8315
2022/08/25,04:00:00,589.73,21,8207,8228
2022/08/25,04:30:00,596.92,20,8175,8195
2022/08/25,05:00:00,596.64,24,8169,8193
2022/08/25,05:30:00,596.64,20,8220,8240
2022/08/25,06:00:00,597.49,14,8228,8242
2022/08/25,06:30:00,596.92,17,8265,8282
2022/08/25,07:00:00,597.77,177,8375,8552
2022/08/25,07:30:00,492.34,419,8725,9144
2022/08/25,08:00:00,595.79,742,8853,9595
2022/08/25,08:30:00,590.01,1148,8916,10064
2022/08/25,09:00:00,596.35,1480,9004,10484
2022/08/25,09:30:00,595.5,1750,9160,10910
2022/08/25,10:00:00,596.35,2058,9192,11250
2022/08/25,10:30:00,596.35,2262,9270,11532
2022/08/25,11:00:00,596.64,2460,9390,11850
2022/08/25,11:30:00,596.07,2599,9535,12134
2022/08/25,12:00:00,596.07,2767,9695,12462
2022/08/25,12:30:00,596.64,2771,9907,12678
2022/08/25,13:00:00,596.64,2758,10125,12883
2022/08/25,13:30:00,588.83,2772,10402,13174
2022/08/25,14:00:00,582.14,2776,10557,13333
2022/08/25,14:30:00,578.8,2536,10723,13259
2022/08/25,15:00:00,567.04,2413,10712,13125
2022/08/25,15:30:00,566.33,2184,10861,13045
2022/08/25,16:00:00,566.33,1955,11008,12963
2022/08/25,16:30:00,566.33,1676,11228,12904
2022/08/25,17:00:00,566.33,1359,11345,12704
2022/08/25,17:30:00,2338.25,980,11623,12603
2022/08/25,18:00:00,2344.66,626,11803,12429
2022/08/25,18:30:00,2350.89,397,11791,12188
2022/08/25,19:00:00,2344.66,154,11640,11794
2022/08/25,19:30:00,566.33,158,11726,11884
2022/08/25,20:00:00,560.24,153,11679,11832
2022/08/25,20:30:00,551.82,153,11516,11669
2022/08/25,21:00:00,553.61,151,11358,11509
2022/08/25,21:30:00,558.95,148,11211,11359
2022/08/25,22:00:00,558.43,152,10975,11127
2022/08/25,22:30:00,579.56,67,10816,10883
2022/08/25,23:00:00,580.58,3,10636,10639
2022/08/25,23:30:00,596.35,2,10363,10365
2022/08/26,00:00:00,596.07,1,10110,10111
2022/08/26,00:30:00,596.64,6,9825,9831
2022/08/26,01:00:00,596.35,7,9580,9587
2022/08/26,01:30:00,596.92,9,9372,9381
2022/08/26,02:00:00,596.64,47,9116,9163
2022/08/26,02:30:00,596.35,34,8953,8987
2022/08/26,03:00:00,596.92,17,8809,8826
2022/08/26,03:30:00,598.06,10,8710,8720
2022/08/26,04:00:00,596.64,11,8624,8635
2022/08/26,04:30:00,598.06,11,8569,8580
2022/08/26,05:00:00,596.64,15,8539,8554
2022/08/26,05:30:00,597.49,17,8540,8557
2022/08/26,06:00:00,597.2,23,8462,8485
2022/08/26,06:30:00,591.43,19,8514,8533
2022/08/26,07:00:00,596.35,194,8506,8700
2022/08/26,07:30:00,596.64,417,8569,8986
2022/08/26,08:00:00,596.92,644,8643,9287
2022/08/26,08:30:00,596.92,939,8717,9656
2022/08/26,09:00:00,596.07,1101,8816,9917
2022/08/26,09:30:00,595.5,1391,8837,10228
2022/08/26,10:00:00,596.35,1705,8840,10545
2022/08/26,10:30:00,596.07,2164,8753,10917
2022/08/26,11:00:00,596.92,2319,8800,11119
2022/08/26,11:30:00,596.64,2629,8910,11539
2022/08/26,12:00:00,595.22,2679,9035,11714
2022/08/26,12:30:00,596.07,2684,9158,11842
2022/08/26,13:00:00,596.35,2706,9283,11989
2022/08/26,13:30:00,594.66,2728,9375,12103
2022/08/26,14:00:00,596.64,2705,9513,12218
2022/08/26,14:30:00,596.64,2478,9619,12097
2022/08/26,15:00:00,596.92,2339,9779,12118
2022/08/26,15:30:00,596.07,2149,9770,11919
2022/08/26,16:00:00,596.07,1948,9977,11925
2022/08/26,16:30:00,594.94,1679,10213,11892
2022/08/26,17:00:00,596.35,1359,10497,11856
2022/08/26,17:30:00,577.29,985,10828,11813
2022/08/26,18:00:00,576.79,667,11104,11771
2022/08/26,18:30:00,574.83,397,11310,11707
2022/08/26,19:00:00,552.44,143,11193,11336
2022/08/26,19:30:00,560.21,153,11142,11295
2022/08/26,20:00:00,574.58,150,10945,11095
2022/08/26,20:30:00,592.42,153,10731,10884
2022/08/26,21:00:00,596.35,153,10579,10732
2022/08/26,21:30:00,596.07,149,10381,10530
2022/08/26,22:00:00,596.35,151,10140,10291
2022/08/26,22:30:00,597.49,110,10102,10212
2022/08/26,23:00:00,596.07,20,10011,10031
2022/08/26,23:30:00,596.92,20,9883,9903
2022/08/27,00:00:00,595.22,21,9635,9656
2022/08/27,00:30:00,596.35,28,9371,9399
2022/08/27,01:00:00,596.35,25,9146,9171
2022/08/27,01:30:00,594.38,35,8945,8980
2022/08/27,02:00:00,597.49,28,8828,8856
2022/08/27,02:30:00,595.5,10,8654,8664
2022/08/27,03:00:00,594.94,12,8669,8681
2022/08/27,03:30:00,596.35,8,8615,8623
2022/08/27,04:00:00,597.77,6,8503,8509
2022/08/27,04:30:00,596.07,5,8453,8458
2022/08/27,05:00:00,597.2,4,8400,8404
2022/08/27,05:30:00,597.77,10,8399,8409
2022/08/27,06:00:00,598.34,12,8233,8245
2022/08/27,06:30:00,595.5,15,8069,8084
2022/08/27,07:00:00,595.22,217,7922,8139
2022/08/27,07:30:00,598.34,432,7829,8261
2022/08/27,08:00:00,596.35,711,7727,8438
2022/08/27,08:30:00,597.49,1127,7597,8724
2022/08/27,09:00:00,596.35,1535,7391,8926
2022/08/27,09:30:00,596.64,1838,7420,9258
2022/08/27,10:00:00,591.58,2058,7519,9577
2022/08/27,10:30:00,562.09,2244,7675,9919
2022/08/27,11:00:00,554.89,2441,7801,10242
2022/08/27,11:30:00,550.7,2713,7935,10648
2022/08/27,12:00:00,547.12,2704,8121,10825
2022/08/27,12:30:00,547.07,2755,8233,10988
2022/08/27,13:00:00,547.15,2713,8399,11112
2022/08/27,13:30:00,547.23,2713,8545,11258
2022/08/27,14:00:00,547.17,2720,8543,11263
2022/08/27,14:30:00,547.2,2457,8649,11106
2022/08/27,15:00:00,547.17,2335,8819,11154
2022/08/27,15:30:00,547.17,2120,9068,11188
2022/08/27,16:00:00,547.26,1899,9332,11231
2022/08/27,16:30:00,547.15,1649,9670,11319
2022/08/27,17:00:00,2049.2,1337,10038,11375
2022/08/27,17:30:00,2079.41,959,10394,11353
2022/08/27,18:00:00,2075.39,632,10529,11161
2022/08/27,18:30:00,2694.61,366,10693,11059
2022/08/27,19:00:00,3378.97,145,10658,10803
2022/08/27,19:30:00,2662.55,159,10837,10996
2022/08/27,20:00:00,2677.7,156,10843,10999
2022/08/27,20:30:00,2677.7,150,10831,10981
2022/08/27,21:00:00,2817,146,10838,10984
2022/08/27,21:30:00,2452.79,146,10754,10900
2022/08/27,22:00:00,2449.35,146,10641,10787
2022/08/27,22:30:00,573.41,119,10553,10672
2022/08/27,23:00:00,574.24,121,10315,10436
2022/08/27,23:30:00,582.81,86,10093,10179
2022/08/28,00:00:00,571.2,10,9841,9851
2022/08/28,00:30:00,606.37,8,9575,9583
2022/08/28,01:00:00,594.34,6,9278,9284
2022/08/28,01:30:00,591.43,3,9167,9170
2022/08/28,02:00:00,591.43,13,8926,8939
2022/08/28,02:30:00,592,23,8733,8756
2022/08/28,03:00:00,597.49,26,8671,8697
2022/08/28,03:30:00,597.49,23,8548,8571
2022/08/28,04:00:00,596.07,21,8514,8535
2022/08/28,04:30:00,596.07,22,8545,8567
2022/08/28,05:00:00,597.49,21,8563,8584
2022/08/28,05:30:00,597.2,29,8713,8742
2022/08/28,06:00:00,597.2,27,8721,8748
2022/08/28,06:30:00,596.92,21,8915,8936
2022/08/28,07:00:00,595.79,168,9112,9280
2022/08/28,07:30:00,582.66,374,9493,9867
2022/08/28,08:00:00,580.33,587,9780,10367
2022/08/28,08:30:00,570.35,824,10045,10869
2022/08/28,09:00:00,565.73,1142,10131,11273
2022/08/28,09:30:00,565.52,1588,10148,11736
2022/08/28,10:00:00,564.08,1945,10137,12082
2022/08/28,10:30:00,570.12,2171,10107,12278
2022/08/28,11:00:00,571.73,2406,10278,12684
2022/08/28,11:30:00,576.54,2667,10428,13095
2022/08/28,12:00:00,575.31,2693,10810,13503
2022/08/28,12:30:00,560.02,2710,10774,13484
2022/08/28,13:00:00,559.6,2690,11057,13747
2022/08/28,13:30:00,551.59,2657,11375,14032
2022/08/28,14:00:00,551.25,2642,11563,14205
2022/08/28,14:30:00,547.45,2438,11746,14184
2022/08/28,15:00:00,2452.79,2314,11886,14200
2022/08/28,15:30:00,2427.29,2063,12127,14190
2022/08/28,16:00:00,3613.72,1776,12272,14048
2022/08/28,16:30:00,3613.72,1485,12460,13945
2022/08/28,17:00:00,3613.72,1146,12656,13802
2022/08/28,17:30:00,3613.72,826,12883,13709
2022/08/28,18:00:00,3034.51,519,12982,13501
2022/08/28,18:30:00,3613.72,269,12908,13177
2022/08/28,19:00:00,3613.72,307,12742,13049
2022/08/28,19:30:00,3613.72,112,12830,12942
2022/08/28,20:00:00,3613.72,113,12782,12895
2022/08/28,20:30:00,3613.72,113,12669,12782
2022/08/28,21:00:00,3613.72,84,12562,12646
2022/08/28,21:30:00,2521.33,3,12482,12485
2022/08/28,22:00:00,2476.02,3,12286,12289
2022/08/28,22:30:00,547.23,3,11915,11918
2022/08/28,23:00:00,558.43,3,11542,11545
2022/08/28,23:30:00,562.48,4,11198,11202
2022/08/29,00:00:00,578.54,3,10811,10814
2022/08/29,00:30:00,585.31,9,10394,10403
2022/08/29,01:00:00,491.83,19,10054,10073
2022/08/29,01:30:00,597.49,26,9796,9822
2022/08/29,02:00:00,594.94,20,9765,9785
2022/08/29,02:30:00,596.07,17,9580,9597
2022/08/29,03:00:00,594.38,16,9484,9500
2022/08/29,03:30:00,596.92,21,9383,9404
2022/08/29,04:00:00,595.22,21,9305,9326
2022/08/29,04:30:00,597.49,18,9292,9310
2022/08/29,05:00:00,596.07,16,9324,9340
2022/08/29,05:30:00,596.07,17,9389,9406
2022/08/29,06:00:00,596.35,17,9426,9443
2022/08/29,06:30:00,597.2,18,9503,9521
2022/08/29,07:00:00,596.07,178,9667,9845
2022/08/29,07:30:00,574.83,244,9992,10236
2022/08/29,08:00:00,570.81,401,10231,10632
2022/08/29,08:30:00,570.35,653,10475,11128
2022/08/29,09:00:00,571.27,944,10549,11493
2022/08/29,09:30:00,570.81,1529,10615,12144
2022/08/29,10:00:00,571.27,1848,10602,12450
2022/08/29,10:30:00,571.5,2248,10611,12859
2022/08/29,11:00:00,571.73,2523,10687,13210
2022/08/29,11:30:00,575.8,2625,10783,13408
2022/08/29,12:00:00,563.07,2688,10943,13631
2022/08/29,12:30:00,557.57,2712,11155,13867
2022/08/29,13:00:00,551.25,2737,11405,14142
2022/08/29,13:30:00,556.11,2708,11542,14250
2022/08/29,14:00:00,551.82,2682,11740,14422
2022/08/29,14:30:00,548.65,2613,11961,14574
2022/08/29,15:00:00,2354.63,2472,12055,14527
2022/08/29,15:30:00,2354.63,2227,12225,14452
2022/08/29,16:00:00,2452.79,1951,12401,14352
2022/08/29,16:30:00,2476.02,1587,12550,14137
2022/08/29,17:00:00,3613.72,1249,12462,13711
2022/08/29,17:30:00,3613.72,897,12675,13572
2022/08/29,18:00:00,3613.72,595,12780,13375
2022/08/29,18:30:00,3613.72,335,12711,13046
2022/08/29,19:00:00,3613.72,147,12565,12712
2022/08/29,19:30:00,2476.02,149,12717,12866
2022/08/29,20:00:00,2449.35,136,12662,12798
2022/08/29,20:30:00,2479.45,72,12641,12713
2022/08/29,21:00:00,2452.79,43,12572,12615
2022/08/29,21:30:00,2452.79,43,12331,12374
2022/08/29,22:00:00,547.2,44,12169,12213
2022/08/29,22:30:00,548.43,14,11919,11933
2022/08/29,23:00:00,548.37,10,11561,11571
2022/08/29,23:30:00,554.6,4,11215,11219
2022/08/30,00:00:00,577.29,4,10854,10858
2022/08/30,00:30:00,591.15,5,10455,10460
2022/08/30,01:00:00,597.77,6,10162,10168
2022/08/30,01:30:00,589.73,7,10037,10044
2022/08/30,02:00:00,589.73,10,9836,9846
2022/08/30,02:30:00,590.29,13,9681,9694
2022/08/30,03:00:00,597.49,10,9550,9560
2022/08/30,03:30:00,597.2,9,9455,9464
2022/08/30,04:00:00,590.01,6,9385,9391
2022/08/30,04:30:00,597.49,13,9358,9371
2022/08/30,05:00:00,597.49,15,9387,9402
2022/08/30,05:30:00,597.49,27,9433,9460
2022/08/30,06:00:00,597.77,20,9480,9500
2022/08/30,06:30:00,597.49,18,9621,9639
2022/08/30,07:00:00,597.2,22,9819,9841
2022/08/30,07:30:00,596.64,235,10173,10408
2022/08/30,08:00:00,596.07,418,10416,10834
2022/08/30,08:30:00,582.4,646,10716,11362
2022/08/30,09:00:00,580.58,993,10789,11782
2022/08/30,09:30:00,579.3,1367,10843,12210
2022/08/30,10:00:00,578.8,1809,10805,12614
2022/08/30,10:30:00,592.42,2146,10765,12911
2022/08/30,11:00:00,597.49,2381,10773,13154
2022/08/30,11:30:00,598.34,2567,10847,13414
2022/08/30,12:00:00,595.79,2633,10976,13609
2022/08/30,12:30:00,594.1,2678,11152,13830
2022/08/30,13:00:00,592.7,2674,11269,13943
2022/08/30,13:30:00,571.45,2662,11527,14189
2022/08/30,14:00:00,557.57,2643,11732,14375
2022/08/30,14:30:00,549.63,2580,11937,14517
2022/08/30,15:00:00,548.17,2462,12089,14551
2022/08/30,15:30:00,547.15,2223,12259,14482
2022/08/30,16:00:00,547.23,1892,12379,14271
2022/08/30,16:30:00,2338.25,1560,12562,14122
2022/08/30,17:00:00,2449.35,1213,12695,13908
2022/08/30,17:30:00,2129.79,899,12882,13781
2022/08/30,18:00:00,2452.79,582,12934,13516
2022/08/30,18:30:00,2479.45,296,12829,13125
2022/08/30,19:00:00,2449.35,266,12560,12826
2022/08/30,19:30:00,2476.02,109,12848,12957
2022/08/30,20:00:00,2507.32,75,12829,12904
2022/08/30,20:30:00,2479.45,45,12727,12772
2022/08/30,21:00:00,2507.32,40,12567,12607
2022/08/30,21:30:00,547.26,10,12436,12446
2022/08/30,22:00:00,553.89,13,12169,12182
2022/08/30,22:30:00,554.61,16,11858,11874
2022/08/30,23:00:00,575.28,19,11467,11486
2022/08/30,23:30:00,583.19,14,11107,11121
2022/08/31,00:00:00,598.34,17,10752,10769
2022/08/31,00:30:00,492.85,11,10401,10412
2022/08/31,01:00:00,492.34,9,10076,10085
2022/08/31,01:30:00,491.83,8,10012,10020
2022/08/31,02:00:00,597.49,9,9798,9807
2022/08/31,02:30:00,596.92,10,9664,9674
2022/08/31,03:00:00,592,10,9499,9509
2022/08/31,03:30:00,598.34,14,9388,9402
2022/08/31,04:00:00,596.92,12,9339,9351
2022/08/31,04:30:00,596.35,11,9325,9336
2022/08/31,05:00:00,597.49,18,9327,9345
2022/08/31,05:30:00,597.49,13,9405,9418
2022/08/31,06:00:00,596.92,17,9377,9394
2022/08/31,06:30:00,598.34,154,9557,9711
2022/08/31,07:00:00,598.34,31,9757,9788
2022/08/31,07:30:00,492.85,275,9959,10234
2022/08/31,08:00:00,597.2,446,10271,10717
2022/08/31,08:30:00,576.79,557,10593,11150
2022/08/31,09:00:00,580.58,808,10658,11466
2022/08/31,09:30:00,578.54,1179,10672,11851
2022/08/31,10:00:00,579.56,1509,10651,12160
2022/08/31,10:30:00,582.66,1922,10512,12434
2022/08/31,11:00:00,582.93,2305,10505,12810
2022/08/31,11:30:00,582.66,2542,10553,13095
2022/08/31,12:00:00,582.66,2628,10737,13365
2022/08/31,12:30:00,583.19,2698,10774,13472
2022/08/31,13:00:00,572.91,2657,11058,13715
2022/08/31,13:30:00,560.02,2705,11307,14012
2022/08/31,14:00:00,560.76,2665,11519,14184
2022/08/31,14:30:00,558.08,2586,11741,14327
2022/08/31,15:00:00,553.08,2461,11916,14377
2022/08/31,15:30:00,548.72,2218,12107,14325
2022/08/31,16:00:00,548.37,1936,12249,14185
2022/08/31,16:30:00,1976.15,1553,12433,13986
2022/08/31,17:00:00,1975.07,1224,12560,13784
2022/08/31,17:30:00,2354.63,897,12733,13630
2022/08/31,18:00:00,2354.53,542,12803,13345
2022/08/31,18:30:00,2354.63,313,12747,13060
2022/08/31,19:00:00,2344.66,75,12697,12772
2022/08/31,19:30:00,2344.66,44,12861,12905
2022/08/31,20:00:00,2449.35,44,12815,12859
2022/08/31,20:30:00,2479.45,46,12712,12758
2022/08/31,21:00:00,2507.32,47,12590,12637
2022/08/31,21:30:00,548.3,18,12462,12480
2022/08/31,22:00:00,551.71,18,12187,12205
2022/08/31,22:30:00,553.48,13,11870,11883
2022/08/31,23:00:00,556.93,15,11467,11482
2022/08/31,23:30:00,572.44,14,11071,11085
2022/09/01,00:00:00,538.08,16,10670,10686
2022/09/01,00:30:00,539.1,17,10295,10312
2022/09/01,01:00:00,539.1,12,10128,10140
2022/09/01,01:30:00,538.59,9,9886,9895
2022/09/01,02:00:00,538.85,8,9675,9683
2022/09/01,02:30:00,538.85,7,9519,9526
2022/09/01,03:00:00,538.59,6,9390,9396
2022/09/01,03:30:00,538.08,7,9275,9282
2022/09/01,04:00:00,538.08,5,9216,9221
2022/09/01,04:30:00,538.85,8,9202,9210
2022/09/01,05:00:00,537.82,4,9194,9198
2022/09/01,05:30:00,539.1,4,9285,9289
2022/09/01,06:00:00,539.1,6,9349,9355
2022/09/01,06:30:00,538.85,4,9499,9503
2022/09/01,07:00:00,538.08,124,9807,9931
2022/09/01,07:30:00,538.85,244,10127,10371
2022/09/01,08:00:00,539.87,485,10062,10547
2022/09/01,08:30:00,538.85,685,10261,10946
2022/09/01,09:00:00,539.36,964,10365,11329
2022/09/01,09:30:00,539.36,1290,10430,11720
2022/09/01,10:00:00,539.87,1577,10321,11898
2022/09/01,10:30:00,539.1,1838,10346,12184
2022/09/01,11:00:00,538.85,2116,10374,12490
2022/09/01,11:30:00,539.62,2302,10451,12753
2022/09/01,12:00:00,526.7,2403,10571,12974
2022/09/01,12:30:00,527.17,2523,10843,13366
2022/09/01,13:00:00,514.47,2560,11191,13751
2022/09/01,13:30:00,506.23,2603,11312,13915
2022/09/01,14:00:00,500.81,2607,11495,14102
2022/09/01,14:30:00,508.5,2534,11713,14247
2022/09/01,15:00:00,502.61,2384,11803,14187
2022/09/01,15:30:00,497.06,2168,11986,14154
2022/09/01,16:00:00,497.45,1973,12109,14082
2022/09/01,16:30:00,2416.62,1489,12329,13818
2022/09/01,17:00:00,2429.47,1178,12400,13578
2022/09/01,17:30:00,2416.62,846,12518,13364
2022/09/01,18:00:00,2558.16,497,12516,13013
2022/09/01,18:30:00,2558.16,299,12412,12711
2022/09/01,19:00:00,2558.16,142,12307,12449
2022/09/01,19:30:00,2558.16,141,12373,12514
2022/09/01,20:00:00,2558.16,146,12263,12409
2022/09/01,20:30:00,496.88,152,12084,12236
2022/09/01,21:00:00,499.66,92,11921,12013
2022/09/01,21:30:00,499.3,34,11694,11728
2022/09/01,22:00:00,499.54,35,11396,11431
2022/09/01,22:30:00,499.54,4,11233,11237
2022/09/01,23:00:00,502.47,6,10918,10924
2022/09/01,23:30:00,507.08,12,10568,10580
2022/09/02,00:00:00,519.58,17,10257,10274
2022/09/02,00:30:00,538.33,12,9941,9953
2022/09/02,01:00:00,538.85,18,9790,9808
2022/09/02,01:30:00,539.62,31,9544,9575
2022/09/02,02:00:00,538.59,5,9380,9385
2022/09/02,02:30:00,538.59,11,9208,9219
2022/09/02,03:00:00,538.59,15,9039,9054
2022/09/02,03:30:00,538.59,7,8929,8936
2022/09/02,04:00:00,538.08,4,8843,8847
2022/09/02,04:30:00,538.08,5,8806,8811
2022/09/02,05:00:00,538.08,2,8765,8767
2022/09/02,05:30:00,538.59,1,8800,8801
2022/09/02,06:00:00,539.62,0,8706,8706
2022/09/02,06:30:00,538.59,0,8618,8618
2022/09/02,07:00:00,539.36,164,8692,8856
2022/09/02,07:30:00,539.1,381,8843,9224
2022/09/02,08:00:00,537.31,654,8852,9506
2022/09/02,08:30:00,538.33,872,8970,9842
2022/09/02,09:00:00,538.59,1214,8923,10137
2022/09/02,09:30:00,539.1,1641,8868,10509
2022/09/02,10:00:00,538.08,1963,8837,10800
2022/09/02,10:30:00,538.85,2278,8911,11189
2022/09/02,11:00:00,538.08,2494,9035,11529
2022/09/02,11:30:00,538.59,2584,9182,11766
2022/09/02,12:00:00,538.85,2642,9296,11938
2022/09/02,12:30:00,538.85,2665,9631,12296
2022/09/02,13:00:00,538.08,2659,9805,12464
2022/09/02,13:30:00,538.08,2642,9972,12614
2022/09/02,14:00:00,523.42,2621,10132,12753
2022/09/02,14:30:00,521.14,2515,10272,12787
2022/09/02,15:00:00,505.57,2365,10406,12771
2022/09/02,15:30:00,506.4,2143,10495,12638
2022/09/02,16:00:00,506.91,1875,10685,12560
2022/09/02,16:30:00,506.4,1511,10885,12396
2022/09/02,17:00:00,501.62,1177,11141,12318
2022/09/02,17:30:00,497.96,882,11429,12311
2022/09/02,18:00:00,2405.77,501,11662,12163
2022/09/02,18:30:00,2416.62,316,11704,12020
2022/09/02,19:00:00,2416.62,141,11529,11670
2022/09/02,19:30:00,494.22,149,11557,11706
2022/09/02,20:00:00,494.99,155,11308,11463
2022/09/02,20:30:00,496.88,62,11274,11336
2022/09/02,21:00:00,497.45,17,11119,11136
2022/09/02,21:30:00,502.47,12,10949,10961
2022/09/02,22:00:00,501.9,15,10793,10808
2022/09/02,22:30:00,515.71,15,10669,10684
2022/09/02,23:00:00,519.8,18,10537,10555
2022/09/02,23:30:00,525.75,16,10295,10311
2022/09/03,00:00:00,538.59,13,10061,10074
2022/09/03,00:30:00,539.62,13,9773,9786
2022/09/03,01:00:00,539.1,12,9538,9550
2022/09/03,01:30:00,496.32,12,9451,9463
2022/09/03,02:00:00,539.1,15,9264,9279
2022/09/03,02:30:00,539.87,4,9107,9111
2022/09/03,03:00:00,539.36,5,8986,8991
2022/09/03,03:30:00,540.13,3,8884,8887
2022/09/03,04:00:00,540.13,3,8790,8793
2022/09/03,04:30:00,540.13,4,8760,8764
2022/09/03,05:00:00,539.36,5,8714,8719
2022/09/03,05:30:00,539.36,6,8696,8702
2022/09/03,06:00:00,539.87,1,8583,8584
2022/09/03,06:30:00,539.1,1,8431,8432
2022/09/03,07:00:00,539.36,153,8345,8498
2022/09/03,07:30:00,539.36,381,8305,8686
2022/09/03,08:00:00,539.1,678,8207,8885
2022/09/03,08:30:00,539.1,922,8208,9130
2022/09/03,09:00:00,539.36,1272,8152,9424
2022/09/03,09:30:00,539.62,1598,8169,9767
2022/09/03,10:00:00,540.13,1915,8248,10163
2022/09/03,10:30:00,539.36,2207,8350,10557
2022/09/03,11:00:00,540.13,2409,8372,10781
2022/09/03,11:30:00,540.65,2549,8500,11049
2022/09/03,12:00:00,538.85,2607,8400,11007
2022/09/03,12:30:00,539.62,2641,8468,11109
2022/09/03,13:00:00,538.33,2661,8586,11247
2022/09/03,13:30:00,539.62,2678,8669,11347
2022/09/03,14:00:00,540.13,2612,8834,11446
2022/09/03,14:30:00,539.36,2564,9023,11587
2022/09/03,15:00:00,539.87,2403,9247,11650
2022/09/03,15:30:00,539.62,2187,9472,11659
2022/09/03,16:00:00,535.54,1893,9735,11628
2022/09/03,16:30:00,533.53,1540,10074,11614
2022/09/03,17:00:00,529.83,1182,10279,11461
2022/09/03,17:30:00,529.59,861,10514,11375
2022/09/03,18:00:00,520.91,522,10654,11176
2022/09/03,18:30:00,516.13,280,10701,10981
2022/09/03,19:00:00,508.32,244,10816,11060
2022/09/03,19:30:00,496.27,74,11062,11136
2022/09/03,20:00:00,496.19,66,11049,11115
2022/09/03,20:30:00,496.44,58,11095,11153
2022/09/03,21:00:00,496.32,55,11028,11083
2022/09/03,21:30:00,496.35,21,11092,11113
2022/09/03,22:00:00,496.27,19,10931,10950
2022/09/03,22:30:00,498.17,23,10750,10773
2022/09/03,23:00:00,521.82,31,10440,10471
2022/09/03,23:30:00,524.34,36,10084,10120
2022/09/04,00:00:00,539.62,29,9867,9896
2022/09/04,00:30:00,539.1,25,9554,9579
2022/09/04,01:00:00,540.13,22,9252,9274
2022/09/04,01:30:00,538.59,22,9005,9027
2022/09/04,02:00:00,540.13,24,8787,8811
2022/09/04,02:30:00,538.85,20,8638,8658
2022/09/04,03:00:00,538.85,15,8516,8531
2022/09/04,03:30:00,540.13,11,8436,8447
2022/09/04,04:00:00,539.1,7,8374,8381
2022/09/04,04:30:00,540.13,7,8372,8379
2022/09/04,05:00:00,539.36,8,8387,8395
2022/09/04,05:30:00,539.36,13,8509,8522
2022/09/04,06:00:00,539.36,10,8572,8582
2022/09/04,06:30:00,535.54,8,8708,8716
2022/09/04,07:00:00,538.08,136,9025,9161
2022/09/04,07:30:00,537.57,359,9368,9727
2022/09/04,08:00:00,539.62,656,9439,10095
2022/09/04,08:30:00,538.85,907,9684,10591
2022/09/04,09:00:00,536.3,1188,9787,10975
2022/09/04,09:30:00,523.42,1384,9827,11211
2022/09/04,10:00:00,535.04,1720,9644,11364
2022/09/04,10:30:00,538.85,2216,9442,11658
2022/09/04,11:00:00,540.13,2483,9322,11805
2022/09/04,11:30:00,538.85,2607,9334,11941
2022/09/04,12:00:00,539.62,2686,9413,12099
2022/09/04,12:30:00,538.08,2724,9564,12288
2022/09/04,13:00:00,539.36,2709,9806,12515
2022/09/04,13:30:00,539.1,2696,9985,12681
2022/09/04,14:00:00,528.13,2653,10333,12986
2022/09/04,14:30:00,508.14,2557,10692,13249
2022/09/04,15:00:00,513.65,2429,10898,13327
2022/09/04,15:30:00,513.45,2210,11073,13283
2022/09/04,16:00:00,512.26,1910,11207,13117
2022/09/04,16:30:00,503.21,1533,11483,13016
2022/09/04,17:00:00,498.06,1208,11639,12847
2022/09/04,17:30:00,497.25,873,11813,12686
2022/09/04,18:00:00,497.16,550,11917,12467
2022/09/04,18:30:00,502.18,359,11828,12187
2022/09/04,19:00:00,502.47,163,11817,11980
2022/09/04,19:30:00,502.18,159,11944,12103
2022/09/04,20:00:00,502.47,170,11891,12061
2022/09/04,20:30:00,504.28,180,11771,11951
2022/09/04,21:00:00,506.4,175,11630,11805
2022/09/04,21:30:00,522.5,175,11367,11542
2022/09/04,22:00:00,530.56,173,11100,11273
2022/09/04,22:30:00,538.33,141,10922,11063
2022/09/04,23:00:00,538.33,121,10575,10696
2022/09/04,23:30:00,539.1,27,10271,10298
2022/09/05,00:00:00,536.81,33,9883,9916
2022/09/05,00:30:00,539.62,35,9559,9594
2022/09/05,01:00:00,538.85,32,9435,9467
2022/09/05,01:30:00,539.62,35,9203,9238
2022/09/05,02:00:00,538.08,37,8999,9036
2022/09/05,02:30:00,537.57,54,8850,8904
2022/09/05,03:00:00,537.82,48,8715,8763
2022/09/05,03:30:00,538.59,39,8657,8696
2022/09/05,04:00:00,538.85,38,8592,8630
2022/09/05,04:30:00,539.36,34,8581,8615
2022/09/05,05:00:00,538.08,30,8587,8617
2022/09/05,05:30:00,537.57,30,8707,8737
2022/09/05,06:00:00,538.85,39,8715,8754
2022/09/05,06:30:00,538.08,45,8768,8813
2022/09/05,07:00:00,538.85,163,9014,9177
2022/09/05,07:30:00,537.57,413,9305,9718
2022/09/05,08:00:00,538.85,724,9318,10042
2022/09/05,08:30:00,538.08,928,9595,10523
2022/09/05,09:00:00,537.57,1136,9557,10693
2022/09/05,09:30:00,538.85,1537,9511,11048
2022/09/05,10:00:00,538.33,1861,9303,11164
2022/09/05,10:30:00,539.36,2224,9090,11314
2022/09/05,11:00:00,537.31,2480,9008,11488
2022/09/05,11:30:00,537.57,2621,9018,11639
2022/09/05,12:00:00,537.57,2643,9072,11715
2022/09/05,12:30:00,539.36,2696,9171,11867
2022/09/05,13:00:00,537.57,2731,9389,12120
2022/09/05,13:30:00,537.57,2671,9641,12312
2022/09/05,14:00:00,537.57,2643,9938,12581
2022/09/05,14:30:00,537.06,2596,10316,12912
2022/09/05,15:00:00,538.33,2491,10534,13025
2022/09/05,15:30:00,539.36,2266,10752,13018
2022/09/05,16:00:00,526.22,1979,10881,12860
2022/09/05,16:30:00,521.14,1640,11097,12737
2022/09/05,17:00:00,509.96,1299,11252,12551
2022/09/05,17:30:00,507.78,945,11417,12362
2022/09/05,18:00:00,501.07,624,11534,12158
2022/09/05,18:30:00,499.3,339,11558,11897
2022/09/05,19:00:00,499.06,140,11493,11633
2022/09/05,19:30:00,499.06,146,11613,11759
2022/09/05,20:00:00,506.74,154,11526,11680
2022/09/05,20:30:00,506.74,153,11399,11552
2022/09/05,21:00:00,526.7,151,11230,11381
2022/09/05,21:30:00,538.85,152,10995,11147
2022/09/05,22:00:00,538.08,157,10714,10871
2022/09/05,22:30:00,538.59,164,10518,10682
2022/09/05,23:00:00,539.87,158,10167,10325
2022/09/05,23:30:00,538.85,114,9845,9959
2022/09/06,00:00:00,539.36,34,9540,9574
2022/09/06,00:30:00,539.62,39,9371,9410
2022/09/06,01:00:00,538.85,53,9061,9114
2022/09/06,01:30:00,539.36,54,8832,8886
2022/09/06,02:00:00,539.1,53,8650,8703
2022/09/06,02:30:00,539.36,53,8506,8559
2022/09/06,03:00:00,539.36,59,8400,8459
2022/09/06,03:30:00,539.36,62,8321,8383
2022/09/06,04:00:00,539.62,57,8251,8308
2022/09/06,04:30:00,539.62,55,8240,8295
2022/09/06,05:00:00,539.36,40,8297,8337
2022/09/06,05:30:00,539.36,36,8386,8422
2022/09/06,06:00:00,539.62,30,8419,8449
2022/09/06,06:30:00,539.36,29,8505,8534
2022/09/06,07:00:00,538.59,186,8722,8908
2022/09/06,07:30:00,539.62,443,8805,9248
2022/09/06,08:00:00,539.36,705,8810,9515
2022/09/06,08:30:00,539.62,1040,8880,9920
2022/09/06,09:00:00,539.62,1329,8956,10285
2022/09/06,09:30:00,539.62,1683,9000,10683
2022/09/06,10:00:00,539.36,1831,9046,10877
2022/09/06,10:30:00,538.33,2004,8946,10950
2022/09/06,11:00:00,540.13,2223,8862,11085
2022/09/06,11:30:00,539.1,2294,8972,11266
2022/09/06,12:00:00,539.62,2335,9048,11383
2022/09/06,12:30:00,540.13,2284,9124,11408
2022/09/06,13:00:00,539.62,2226,9387,11613
2022/09/06,13:30:00,538.33,2366,9589,11955
2022/09/06,14:00:00,538.33,2538,9756,12294
2022/09/06,14:30:00,539.36,2507,10058,12565
2022/09/06,15:00:00,529.83,2345,10318,12663
2022/09/06,15:30:00,527.89,1933,10577,12510
2022/09/06,16:00:00,526.94,1753,10676,12429
2022/09/06,16:30:00,527.17,1601,10739,12340
2022/09/06,17:00:00,527.89,1281,10838,12119
2022/09/06,17:30:00,516.13,1016,11013,12029
2022/09/06,18:00:00,515.92,773,11078,11851
2022/09/06,18:30:00,515.71,399,11119,11518
2022/09/06,19:00:00,516.13,495,11099,11594
2022/09/06,19:30:00,515.92,239,11254,11493
2022/09/06,20:00:00,516.13,237,11212,11449
2022/09/06,20:30:00,526.7,222,11095,11317
2022/09/06,21:00:00,537.57,230,10973,11203
2022/09/06,21:30:00,538.85,212,10845,11057
2022/09/06,22:00:00,538.08,202,10565,10767
2022/09/06,22:30:00,539.36,188,10370,10558
2022/09/06,23:00:00,538.85,177,10165,10342
2022/09/06,23:30:00,538.33,130,9850,9980
2022/09/07,00:00:00,537.57,55,9545,9600
2022/09/07,00:30:00,538.59,39,9253,9292
2022/09/07,01:00:00,538.33,30,8957,8987
2022/09/07,01:30:00,539.1,38,8742,8780
2022/09/07,02:00:00,538.33,26,8707,8733
2022/09/07,02:30:00,538.59,25,8512,8537
2022/09/07,03:00:00,538.85,42,8359,8401
2022/09/07,03:30:00,538.33,39,8294,8333
2022/09/07,04:00:00,539.1,36,8254,8290
2022/09/07,04:30:00,538.33,39,8183,8222
2022/09/07,05:00:00,537.57,28,8265,8293
2022/09/07,05:30:00,539.1,27,8347,8374
2022/09/07,06:00:00,538.59,31,8397,8428
2022/09/07,06:30:00,537.82,28,8497,8525
2022/09/07,07:00:00,538.85,192,8709,8901
2022/09/07,07:30:00,537.57,452,8953,9405
2022/09/07,08:00:00,536.81,729,8926,9655
2022/09/07,08:30:00,538.08,1149,8897,10046
2022/09/07,09:00:00,537.82,1535,8965,10500
2022/09/07,09:30:00,538.08,1668,9106,10774
2022/09/07,10:00:00,538.08,1718,9130,10848
2022/09/07,10:30:00,538.08,2038,9090,11128
2022/09/07,11:00:00,539.87,2321,8939,11260
2022/09/07,11:30:00,538.59,2426,8896,11322
2022/09/07,12:00:00,538.08,2436,8965,11401
2022/09/07,12:30:00,538.33,2503,9030,11533
2022/09/07,13:00:00,537.06,2648,9212,11860
2022/09/07,13:30:00,538.59,2488,9341,11829
2022/09/07,14:00:00,538.33,2437,9619,12056
2022/09/07,14:30:00,538.08,2520,9823,12343
2022/09/07,15:00:00,539.36,2449,10032,12481
2022/09/07,15:30:00,535.29,2265,10224,12489
2022/09/07,16:00:00,520.69,1977,10389,12366
2022/09/07,16:30:00,520.47,1697,10634,12331
2022/09/07,17:00:00,506.91,1267,10918,12185
2022/09/07,17:30:00,503.21,936,11096,12032
2022/09/07,18:00:00,502.91,626,11201,11827
2022/09/07,18:30:00,502.76,331,11307,11638
2022/09/07,19:00:00,502.61,196,11319,11515
2022/09/07,19:30:00,497.35,199,11456,11655
2022/09/07,20:00:00,497.45,192,11417,11609
2022/09/07,20:30:00,501.76,187,11284,11471
2022/09/07,21:00:00,504.75,183,11140,11323
2022/09/07,21:30:00,518.05,178,10953,11131
2022/09/07,22:00:00,538.08,177,10640,10817
2022/09/07,22:30:00,538.85,145,10516,10661
2022/09/07,23:00:00,538.33,143,10149,10292
2022/09/07,23:30:00,539.1,131,9814,9945
2022/09/08,00:00:00,538.08,119,9427,9546
2022/09/08,00:30:00,538.08,63,9150,9213
2022/09/08,01:00:00,537.57,10,8977,8987
2022/09/08,01:30:00,538.08,11,8712,8723
2022/09/08,02:00:00,535.79,13,8660,8673
2022/09/08,02:30:00,537.57,10,8481,8491
2022/09/08,03:00:00,538.85,7,8405,8412
2022/09/08,03:30:00,539.62,7,8286,8293
2022/09/08,04:00:00,539.36,7,8228,8235
2022/09/08,04:30:00,539.1,4,8214,8218
2022/09/08,05:00:00,538.33,3,8286,8289
2022/09/08,05:30:00,538.85,1,8353,8354
2022/09/08,06:00:00,538.33,0,8417,8417
2022/09/08,06:30:00,538.59,0,8482,8482
2022/09/08,07:00:00,538.85,176,8676,8852
2022/09/08,07:30:00,538.59,419,8951,9370
2022/09/08,08:00:00,539.36,708,8904,9612
2022/09/08,08:30:00,539.36,1084,9085,10169
2022/09/08,09:00:00,536.05,1530,8848,10378
2022/09/08,09:30:00,538.08,1845,8860,10705
2022/09/08,10:00:00,536.81,2144,8812,10956
2022/09/08,10:30:00,538.08,2376,8791,11167
2022/09/08,11:00:00,540.13,2571,8866,11437
2022/09/08,11:30:00,495.28,2633,8853,11486
2022/09/08,12:00:00,539.62,2538,9122,11660
2022/09/08,12:30:00,539.36,2525,9299,11824
2022/09/08,13:00:00,536.3,2609,9394,12003
2022/09/08,13:30:00,537.57,2697,9574,12271
2022/09/08,14:00:00,537.57,2665,9918,12583
2022/09/08,14:30:00,525.28,2614,10222,12836
2022/09/08,15:00:00,533.28,2530,10420,12950
2022/09/08,15:30:00,518.7,2249,10669,12918
2022/09/08,16:00:00,508.68,1945,10824,12769
2022/09/08,16:30:00,501.9,1582,11074,12656
2022/09/08,17:00:00,501.9,1232,11258,12490
2022/09/08,17:30:00,501.34,927,11493,12420
2022/09/08,18:00:00,501.48,557,11654,12211
2022/09/08,18:30:00,501.48,327,11624,11951
2022/09/08,19:00:00,501.76,152,11578,11730
2022/09/08,19:30:00,502.04,167,11598,11765
2022/09/08,20:00:00,503.51,166,11463,11629
2022/09/08,20:30:00,506.57,167,11269,11436
2022/09/08,21:00:00,513.25,165,11059,11224
2022/09/08,21:30:00,525.75,161,10882,11043
2022/09/08,22:00:00,539.1,161,10521,10682
2022/09/08,22:30:00,538.33,123,10389,10512
2022/09/08,23:00:00,539.36,124,10094,10218
2022/09/08,23:30:00,538.85,132,9771,9903
2022/09/09,00:00:00,538.85,75,9542,9617
2022/09/09,00:30:00,537.06,1,9307,9308
2022/09/09,01:00:00,538.85,1,9007,9008
2022/09/09,01:30:00,538.59,2,8765,8767
2022/09/09,02:00:00,538.85,2,8549,8551
2022/09/09,02:30:00,538.33,3,8576,8579
2022/09/09,03:00:00,539.1,4,8394,8398
2022/09/09,03:30:00,539.62,4,8312,8316
2022/09/09,04:00:00,538.59,3,8247,8250
2022/09/09,04:30:00,538.33,4,8192,8196
2022/09/09,05:00:00,537.57,3,8202,8205
2022/09/09,05:30:00,538.85,3,8225,8228
2022/09/09,06:00:00,538.08,3,8112,8115
2022/09/09,06:30:00,538.59,3,8001,8004
2022/09/09,07:00:00,538.33,146,8059,8205
2022/09/09,07:30:00,538.85,403,8147,8550
2022/09/09,08:00:00,539.36,691,8126,8817
2022/09/09,08:30:00,538.59,1064,8185,9249
2022/09/09,09:00:00,538.85,1487,8086,9573
2022/09/09,09:30:00,538.85,1860,8053,9913
2022/09/09,10:00:00,537.57,2134,8086,10220
2022/09/09,10:30:00,537.57,2431,8181,10612
2022/09/09,11:00:00,538.59,2642,8268,10910
2022/09/09,11:30:00,539.62,2676,8407,11083
2022/09/09,12:00:00,539.62,2709,8467,11176
2022/09/09,12:30:00,537.82,2746,8667,11413
2022/09/09,13:00:00,538.59,2725,8818,11543
2022/09/09,13:30:00,538.33,2735,8971,11706
2022/09/09,14:00:00,538.85,2695,9055,11750
2022/09/09,14:30:00,537.57,2658,9150,11808
2022/09/09,15:00:00,538.85,2558,9224,11782
2022/09/09,15:30:00,538.59,2300,9345,11645
2022/09/09,16:00:00,538.59,1984,9516,11500
2022/09/09,16:30:00,538.85,1633,9779,11412
2022/09/09,17:00:00,520.24,1247,10106,11353
2022/09/09,17:30:00,507.61,912,10446,11358
2022/09/09,18:00:00,501.34,558,10795,11353
2022/09/09,18:30:00,499.66,324,10868,11192
2022/09/09,19:00:00,496.32,121,10820,10941
2022/09/09,19:30:00,496.19,133,10738,10871
2022/09/09,20:00:00,496.35,140,10539,10679
2022/09/09,20:30:00,500.03,140,10443,10583
2022/09/09,21:00:00,509.22,136,10235,10371
2022/09/09,21:30:00,516.34,131,10095,10226
2022/09/09,22:00:00,525.28,135,9932,10067
2022/09/09,22:30:00,536.55,135,9758,9893
2022/09/09,23:00:00,538.85,135,9613,9748
2022/09/09,23:30:00,538.85,132,9376,9508
2022/09/10,00:00:00,538.33,132,9174,9306
2022/09/10,00:30:00,538.33,128,8902,9030
2022/09/10,01:00:00,539.87,124,8666,8790
2022/09/10,01:30:00,538.59,65,8525,8590
2022/09/10,02:00:00,538.85,9,8429,8438
2022/09/10,02:30:00,538.33,7,8450,8457
2022/09/10,03:00:00,539.1,7,8330,8337
2022/09/10,03:30:00,538.08,6,8233,8239
2022/09/10,04:00:00,539.62,5,8083,8088
2022/09/10,04:30:00,538.08,3,8069,8072
2022/09/10,05:00:00,538.08,3,8028,8031
2022/09/10,05:30:00,538.85,2,8040,8042
2022/09/10,06:00:00,538.85,0,7998,7998
2022/09/10,06:30:00,539.1,0,7739,7739
2022/09/10,07:00:00,537.82,183,7653,7836
2022/09/10,07:30:00,538.85,429,7502,7931
2022/09/10,08:00:00,538.08,697,7406,8103
2022/09/10,08:30:00,539.1,1114,7270,8384
2022/09/10,09:00:00,539.36,1572,7112,8684
2022/09/10,09:30:00,539.62,1858,7092,8950
2022/09/10,10:00:00,538.33,2186,7084,9270
2022/09/10,10:30:00,538.85,2445,7191,9636
2022/09/10,11:00:00,539.1,2620,7234,9854
2022/09/10,11:30:00,538.85,2682,7370,10052
2022/09/10,12:00:00,538.85,2702,7409,10111
2022/09/10,12:30:00,539.62,2734,7546,10280
2022/09/10,13:00:00,538.08,2742,7725,10467
2022/09/10,13:30:00,537.57,2709,7898,10607
2022/09/10,14:00:00,539.1,2693,8042,10735
2022/09/10,14:30:00,537.57,2634,8258,10892
2022/09/10,15:00:00,538.08,2539,8402,10941
2022/09/10,15:30:00,537.06,2262,8667,10929
2022/09/10,16:00:00,538.85,1985,8935,10920
2022/09/10,16:30:00,537.06,1638,9239,10877
2022/09/10,17:00:00,537.57,1277,9397,10674
2022/09/10,17:30:00,538.08,935,9726,10661
2022/09/10,18:00:00,537.06,573,9957,10530
2022/09/10,18:30:00,538.59,373,10098,10471
2022/09/10,19:00:00,538.33,445,10273,10718
2022/09/10,19:30:00,521.14,161,10388,10549
2022/09/10,20:00:00,521.36,169,10330,10499
2022/09/10,20:30:00,521.14,174,10349,10523
2022/09/10,21:00:00,520.47,173,10314,10487
2022/09/10,21:30:00,522.04,145,10293,10438
2022/09/10,22:00:00,539.62,145,10106,10251
2022/09/10,22:30:00,539.1,145,9889,10034
2022/09/10,23:00:00,540.13,148,9618,9766
2022/09/10,23:30:00,538.59,143,9251,9394
2022/09/11,00:00:00,539.1,146,8979,9125
2022/09/11,00:30:00,538.85,147,8640,8787
2022/09/11,01:00:00,539.36,139,8368,8507
2022/09/11,01:30:00,539.36,74,8187,8261
2022/09/11,02:00:00,538.33,19,8095,8114
2022/09/11,02:30:00,537.06,13,8043,8056
2022/09/11,03:00:00,539.1,13,7971,7984
2022/09/11,03:30:00,538.59,8,7888,7896
2022/09/11,04:00:00,537.57,13,7825,7838
2022/09/11,04:30:00,538.08,12,7834,7846
2022/09/11,05:00:00,537.57,9,7861,7870
2022/09/11,05:30:00,539.1,7,7961,7968
2022/09/11,06:00:00,537.82,6,8030,8036
2022/09/11,06:30:00,538.33,4,8171,8175
2022/09/11,07:00:00,539.87,153,8358,8511
2022/09/11,07:30:00,535.79,398,8510,8908
2022/09/11,08:00:00,538.59,742,8419,9161
2022/09/11,08:30:00,538.08,1075,8560,9635
2022/09/11,09:00:00,539.1,1514,8452,9966
2022/09/11,09:30:00,537.57,1893,8424,10317
2022/09/11,10:00:00,538.08,2187,8324,10511
2022/09/11,10:30:00,538.59,2411,8333,10744
2022/09/11,11:00:00,539.87,2650,8312,10962
2022/09/11,11:30:00,539.1,2702,8455,11157
2022/09/11,12:00:00,538.33,2724,8558,11282
2022/09/11,12:30:00,538.08,2750,8689,11439
2022/09/11,13:00:00,539.62,2763,8840,11603
2022/09/11,13:30:00,538.33,2769,9110,11879
2022/09/11,14:00:00,540.13,2708,9253,11961
2022/09/11,14:30:00,538.85,2670,9563,12233
2022/09/11,15:00:00,538.59,2610,9811,12421
2022/09/11,15:30:00,538.85,2331,10011,12342
2022/09/11,16:00:00,538.85,2021,10120,12141
2022/09/11,16:30:00,539.1,1717,10373,12090
2022/09/11,17:00:00,539.1,1297,10588,11885
2022/09/11,17:30:00,523.65,984,10808,11792
2022/09/11,18:00:00,520.24,633,10953,11586
2022/09/11,18:30:00,519.14,342,10984,11326
2022/09/11,19:00:00,518.7,161,11029,11190
2022/09/11,19:30:00,519.14,189,11016,11205
2022/09/11,20:00:00,519.36,194,10929,11123
2022/09/11,20:30:00,519.14,191,10853,11044
2022/09/11,21:00:00,533.53,185,10690,10875
2022/09/11,21:30:00,539.36,181,10514,10695
2022/09/11,22:00:00,539.62,183,10209,10392
2022/09/11,22:30:00,540.13,148,9944,10092
2022/09/11,23:00:00,539.36,141,9608,9749
2022/09/11,23:30:00,540.13,134,9267,9401
2022/09/12,00:00:00,538.59,128,8915,9043
2022/09/12,00:30:00,538.33,121,8617,8738
2022/09/12,01:00:00,538.59,117,8347,8464
2022/09/12,01:30:00,538.59,54,8185,8239
2022/09/12,02:00:00,539.36,1,8187,8188
2022/09/12,02:30:00,538.85,1,8039,8040
2022/09/12,03:00:00,538.85,1,7916,7917
2022/09/12,03:30:00,538.59,1,7817,7818
2022/09/12,04:00:00,538.85,1,7771,7772
2022/09/12,04:30:00,538.59,1,7772,7773
2022/09/12,05:00:00,538.33,1,7758,7759
2022/09/12,05:30:00,538.85,1,7852,7853
2022/09/12,06:00:00,539.36,1,7917,7918
2022/09/12,06:30:00,539.36,1,8009,8010
2022/09/12,07:00:00,538.59,160,8207,8367
2022/09/12,07:30:00,536.3,456,8346,8802
2022/09/12,08:00:00,536.81,735,8315,9050
2022/09/12,08:30:00,537.06,1093,8342,9435
2022/09/12,09:00:00,536.55,1532,8215,9747
2022/09/12,09:30:00,538.08,1910,8132,10042
2022/09/12,10:00:00,538.59,2209,8028,10237
2022/09/12,10:30:00,539.36,2437,7965,10402
2022/09/12,11:00:00,537.82,2651,8006,10657
2022/09/12,11:30:00,538.08,2664,8129,10793
2022/09/12,12:00:00,538.08,2708,8183,10891
2022/09/12,12:30:00,536.55,2742,8184,10926
2022/09/12,13:00:00,537.06,2735,8415,11150
2022/09/12,13:30:00,536.05,2744,8707,11451
2022/09/12,14:00:00,535.04,2724,8980,11704
2022/09/12,14:30:00,534.78,2674,9300,11974
2022/09/12,15:00:00,537.06,2623,9511,12134
2022/09/12,15:30:00,535.54,2332,9764,12096
2022/09/12,16:00:00,535.29,2003,9952,11955
2022/09/12,16:30:00,536.3,1721,10226,11947
2022/09/12,17:00:00,529.59,1328,10448,11776
2022/09/12,17:30:00,522.04,1040,10673,11713
2022/09/12,18:00:00,521.59,645,10842,11487
2022/09/12,18:30:00,516.76,391,10938,11329
2022/09/12,19:00:00,522.5,182,11012,11194
2022/09/12,19:30:00,522.5,200,11038,11238
2022/09/12,20:00:00,522.73,182,10985,11167
2022/09/12,20:30:00,521.82,188,10964,11152
2022/09/12,21:00:00,529.34,169,10827,10996
2022/09/12,21:30:00,539.62,187,10625,10812
2022/09/12,22:00:00,539.36,194,10337,10531
2022/09/12,22:30:00,539.62,199,10017,10216
2022/09/12,23:00:00,539.1,198,9674,9872
2022/09/12,23:30:00,540.13,193,9336,9529
2022/09/13,00:00:00,540.13,190,8988,9178
2022/09/13,00:30:00,539.62,199,8698,8897
2022/09/13,01:00:00,538.85,206,8420,8626
2022/09/13,01:30:00,538.85,194,8206,8400
2022/09/13,02:00:00,538.85,183,8189,8372
2022/09/13,02:30:00,538.85,117,8109,8226
2022/09/13,03:00:00,539.87,79,8049,8128
2022/09/13,03:30:00,539.87,70,7974,8044
2022/09/13,04:00:00,539.87,69,7931,8000
2022/09/13,04:30:00,540.13,64,7943,8007
2022/09/13,05:00:00,538.85,60,7985,8045
2022/09/13,05:30:00,540.13,67,8087,8154
2022/09/13,06:00:00,540.13,61,8141,8202
2022/09/13,06:30:00,539.62,61,8254,8315
2022/09/13,07:00:00,539.36,56,8490,8546
2022/09/13,07:30:00,539.36,434,8518,8952
2022/09/13,08:00:00,539.36,754,8531,9285
2022/09/13,08:30:00,539.87,1084,8656,9740
2022/09/13,09:00:00,538.85,1524,8554,10078
2022/09/13,09:30:00,538.33,1875,8602,10477
2022/09/13,10:00:00,539.1,2208,8516,10724
2022/09/13,10:30:00,538.85,2444,8463,10907
2022/09/13,11:00:00,538.85,2448,8535,10983
2022/09/13,11:30:00,538.08,2589,8546,11135
2022/09/13,12:00:00,536.55,2643,8519,11162
2022/09/13,12:30:00,539.87,2694,8657,11351
2022/09/13,13:00:00,539.62,2714,8861,11575
2022/09/13,13:30:00,539.1,2758,9127,11885
2022/09/13,14:00:00,539.36,2715,9395,12110
2022/09/13,14:30:00,539.62,2657,9717,12374
2022/09/13,15:00:00,521.59,2532,9977,12509
2022/09/13,15:30:00,507.26,2303,10210,12513
2022/09/13,16:00:00,507.96,2015,10373,12388
2022/09/13,16:30:00,508.32,1606,10603,12209
2022/09/13,17:00:00,500.29,1304,10770,12074
2022/09/13,17:30:00,495.58,936,10997,11933
2022/09/13,18:00:00,495.17,518,11122,11640
2022/09/13,18:30:00,495.65,281,11155,11436
2022/09/13,19:00:00,495.44,155,11236,11391
2022/09/13,19:30:00,495.05,166,11293,11459
2022/09/13,20:00:00,494.93,161,11315,11476
2022/09/13,20:30:00,495.05,166,11174,11340
2022/09/13,21:00:00,496.11,179,11005,11184
2022/09/13,21:30:00,497.45,191,10815,11006
2022/09/13,22:00:00,497.06,175,10600,10775
2022/09/13,22:30:00,508.32,154,10338,10492
2022/09/13,23:00:00,526.7,143,10048,10191
2022/09/13,23:30:00,538.08,133,9687,9820
2022/09/14,00:00:00,538.59,72,9329,9401
2022/09/14,00:30:00,538.59,12,9108,9120
2022/09/14,01:00:00,538.33,14,8853,8867
2022/09/14,01:30:00,538.59,10,8643,8653
2022/09/14,02:00:00,538.59,11,8599,8610
2022/09/14,02:30:00,538.33,13,8471,8484
2022/09/14,03:00:00,539.1,18,8326,8344
2022/09/14,03:30:00,537.57,27,8223,8250
2022/09/14,04:00:00,538.59,42,8158,8200
2022/09/14,04:30:00,538.08,55,8176,8231
2022/09/14,05:00:00,538.85,43,8174,8217
2022/09/14,05:30:00,538.33,28,8339,8367
2022/09/14,06:00:00,538.08,30,8489,8519
2022/09/14,06:30:00,539.36,31,8421,8452
2022/09/14,07:00:00,538.59,171,8599,8770
2022/09/14,07:30:00,536.81,400,8739,9139
2022/09/14,08:00:00,539.62,655,8739,9394
2022/09/14,08:30:00,537.06,918,8889,9807
2022/09/14,09:00:00,538.85,1308,8847,10155
2022/09/14,09:30:00,539.1,1498,8808,10306
2022/09/14,10:00:00,533.28,1803,8741,10544
2022/09/14,10:30:00,538.33,1976,8665,10641
2022/09/14,11:00:00,539.1,2225,8486,10711
2022/09/14,11:30:00,496.32,2475,8444,10919
2022/09/14,12:00:00,536.55,2536,8338,10874
2022/09/14,12:30:00,494.27,2594,8386,10980
2022/09/14,13:00:00,538.85,2658,8485,11143
2022/09/14,13:30:00,539.36,2596,8723,11319
2022/09/14,14:00:00,536.3,2540,8893,11433
2022/09/14,14:30:00,516.55,2601,9165,11766
2022/09/14,15:00:00,538.33,2523,9346,11869
2022/09/14,15:30:00,516.13,2282,9433,11715
2022/09/14,16:00:00,539.62,2016,9535,11551
2022/09/14,16:30:00,516.13,1679,9815,11494
2022/09/14,17:00:00,515.71,1297,9964,11261
2022/09/14,17:30:00,538.59,996,10210,11206
2022/09/14,18:00:00,525.05,574,10369,10943
2022/09/14,18:30:00,527.17,309,10391,10700
2022/09/14,19:00:00,527.17,273,10425,10698
2022/09/14,19:30:00,526.94,202,10551,10753
2022/09/14,20:00:00,536.3,212,10440,10652
2022/09/14,20:30:00,537.57,226,10349,10575
2022/09/14,21:00:00,537.31,221,10219,10440
2022/09/14,21:30:00,538.33,188,10103,10291
2022/09/14,22:00:00,538.59,183,9822,10005
2022/09/14,22:30:00,539.87,129,9697,9826
2022/09/14,23:00:00,539.36,90,9490,9580
2022/09/14,23:30:00,539.87,39,9221,9260
2022/09/15,00:00:00,538.59,42,8927,8969
2022/09/15,00:30:00,538.59,34,8573,8607
2022/09/15,01:00:00,538.85,39,8363,8402
2022/09/15,01:30:00,536.55,44,8145,8189
2022/09/15,02:00:00,540.13,48,8001,8049
2022/09/15,02:30:00,539.62,40,7905,7945
2022/09/15,03:00:00,538.59,45,7775,7820
2022/09/15,03:30:00,538.08,50,7717,7767
2022/09/15,04:00:00,538.33,59,7613,7672
2022/09/15,04:30:00,539.36,62,7649,7711
2022/09/15,05:00:00,538.85,55,7682,7737
2022/09/15,05:30:00,538.33,35,7812,7847
2022/09/15,06:00:00,539.62,28,7877,7905
2022/09/15,06:30:00,538.85,21,7971,7992
2022/09/15,07:00:00,538.33,28,8233,8261
2022/09/15,07:30:00,539.87,462,8364,8826
2022/09/15,08:00:00,538.85,837,8253,9090
2022/09/15,08:30:00,538.85,1253,8099,9352
2022/09/15,09:00:00,540.13,1646,8043,9689
2022/09/15,09:30:00,537.57,1920,8024,9944
2022/09/15,10:00:00,539.36,2140,8042,10182
2022/09/15,10:30:00,538.85,2420,7885,10305
2022/09/15,11:00:00,538.85,2629,7938,10567
2022/09/15,11:30:00,538.33,2708,7876,10584
2022/09/15,12:00:00,538.85,2710,7880,10590
2022/09/15,12:30:00,538.33,2700,8013,10713
2022/09/15,13:00:00,537.57,2765,8183,10948
2022/09/15,13:30:00,538.59,2770,8305,11075
2022/09/15,14:00:00,538.59,2732,8570,11302
2022/09/15,14:30:00,538.08,2665,8790,11455
2022/09/15,15:00:00,538.59,2569,8960,11529
2022/09/15,15:30:00,538.33,2295,9215,11510
2022/09/15,16:00:00,538.08,1953,9319,11272
2022/09/15,16:30:00,538.33,1613,9604,11217
2022/09/15,17:00:00,538.33,1245,9833,11078
2022/09/15,17:30:00,538.08,910,10130,11040
2022/09/15,18:00:00,520.24,505,10307,10812
2022/09/15,18:30:00,516.55,423,10357,10780
2022/09/15,19:00:00,515.5,160,10463,10623
2022/09/15,19:30:00,506.4,162,10515,10677
2022/09/15,20:00:00,506.74,164,10361,10525
2022/09/15,20:30:00,517.83,166,10229,10395
2022/09/15,21:00:00,536.55,165,10007,10172
2022/09/15,21:30:00,538.59,160,9894,10054
2022/09/15,22:00:00,537.82,160,9597,9757
2022/09/15,22:30:00,539.62,127,9431,9558
2022/09/15,23:00:00,539.1,126,9218,9344
2022/09/15,23:30:00,537.82,123,8930,9053
2022/09/16,00:00:00,538.59,121,8603,8724
2022/09/16,00:30:00,537.57,120,8405,8525
2022/09/16,01:00:00,537.82,83,8201,8284
2022/09/16,01:30:00,538.85,1,8070,8071
2022/09/16,02:00:00,537.31,2,7887,7889
2022/09/16,02:30:00,493.78,1,7845,7846
2022/09/16,03:00:00,537.31,1,7774,7775
2022/09/16,03:30:00,538.33,0,7699,7699
2022/09/16,04:00:00,537.31,0,7611,7611
2022/09/16,04:30:00,538.85,1,7582,7583
2022/09/16,05:00:00,538.85,0,7590,7590
2022/09/16,05:30:00,537.31,0,7626,7626
2022/09/16,06:00:00,539.36,0,7688,7688
2022/09/16,06:30:00,538.85,0,7599,7599
2022/09/16,07:00:00,538.08,14,7637,7651
2022/09/16,07:30:00,537.57,422,7670,8092
2022/09/16,08:00:00,539.36,790,7501,8291
2022/09/16,08:30:00,537.57,1170,7463,8633
2022/09/16,09:00:00,538.33,1604,7362,8966
2022/09/16,09:30:00,538.59,1931,7339,9270
2022/09/16,10:00:00,537.57,2243,7312,9555
2022/09/16,10:30:00,538.33,2468,7294,9762
2022/09/16,11:00:00,538.59,2621,7385,10006
2022/09/16,11:30:00,538.85,2667,7456,10123
2022/09/16,12:00:00,538.08,2684,7527,10211
2022/09/16,12:30:00,538.33,2744,7771,10515
2022/09/16,13:00:00,538.33,2742,7942,10684
2022/09/16,13:30:00,538.85,2706,8053,10759
2022/09/16,14:00:00,537.82,2691,8189,10880
2022/09/16,14:30:00,538.08,2613,8296,10909
2022/09/16,15:00:00,538.85,2496,8323,10819
2022/09/16,15:30:00,539.1,2274,8454,10728
2022/09/16,16:00:00,537.57,1942,8709,10651
2022/09/16,16:30:00,538.33,1550,9000,10550
2022/09/16,17:00:00,532.54,1219,9400,10619
2022/09/16,17:30:00,538.08,858,9830,10688
2022/09/16,18:00:00,528.38,469,10148,10617
2022/09/16,18:30:00,526.46,135,10250,10385
2022/09/16,19:00:00,538.85,156,10230,10386
2022/09/16,19:30:00,538.85,167,10171,10338
2022/09/16,20:00:00,539.62,172,9959,10131
2022/09/16,20:30:00,539.1,175,9818,9993
2022/09/16,21:00:00,539.62,176,9646,9822
2022/09/16,21:30:00,538.85,174,9482,9656
2022/09/16,22:00:00,537.57,168,9361,9529
2022/09/16,22:30:00,537.57,135,9280,9415
2022/09/16,23:00:00,537.82,134,9154,9288
2022/09/16,23:30:00,538.33,134,8933,9067
2022/09/17,00:00:00,538.33,123,8701,8824
2022/09/17,00:30:00,538.85,68,8542,8610
2022/09/17,01:00:00,539.1,18,8355,8373
2022/09/17,01:30:00,538.08,16,8241,8257
2022/09/17,02:00:00,537.57,12,8077,8089
2022/09/17,02:30:00,538.33,12,7959,7971
2022/09/17,03:00:00,537.57,11,7845,7856
2022/09/17,03:30:00,537.57,16,7779,7795
2022/09/17,04:00:00,537.57,11,7718,7729
2022/09/17,04:30:00,539.62,5,7662,7667
2022/09/17,05:00:00,538.08,5,7659,7664
2022/09/17,05:30:00,538.59,6,7655,7661
2022/09/17,06:00:00,537.82,3,7642,7645
2022/09/17,06:30:00,537.31,3,7466,7469
2022/09/17,07:00:00,538.08,10,7282,7292
2022/09/17,07:30:00,538.08,341,7276,7617
2022/09/17,08:00:00,538.33,694,7113,7807
2022/09/17,08:30:00,539.87,1005,7026,8031
2022/09/17,09:00:00,537.57,1338,6962,8300
2022/09/17,09:30:00,538.08,1628,6958,8586
2022/09/17,10:00:00,536.55,2025,6960,8985
2022/09/17,10:30:00,537.57,2320,6959,9279
2022/09/17,11:00:00,537.57,2543,6988,9531
2022/09/17,11:30:00,538.33,2635,7060,9695
2022/09/17,12:00:00,539.1,2683,7237,9920
2022/09/17,12:30:00,538.85,2695,7346,10041
2022/09/17,13:00:00,538.08,2687,7437,10124
2022/09/17,13:30:00,538.85,2715,7567,10282
2022/09/17,14:00:00,538.33,2683,7685,10368
2022/09/17,14:30:00,539.1,2603,7876,10479
2022/09/17,15:00:00,539.36,2485,8075,10560
2022/09/17,15:30:00,538.08,2250,8161,10411
2022/09/17,16:00:00,539.36,1946,8424,10370
2022/09/17,16:30:00,539.36,1543,8751,10294
2022/09/17,17:00:00,538.85,1227,9076,10303
2022/09/17,17:30:00,538.59,835,9338,10173
2022/09/17,18:00:00,538.85,463,9561,10024
2022/09/17,18:30:00,538.33,482,9650,10132
2022/09/17,19:00:00,536.55,168,9812,9980
2022/09/17,19:30:00,520.69,180,9872,10052
2022/09/17,20:00:00,512.66,178,9902,10080
2022/09/17,20:30:00,507.08,172,9898,10070
2022/09/17,21:00:00,507.08,162,9912,10074
2022/09/17,21:30:00,507.43,105,9848,9953
2022/09/17,22:00:00,507.96,45,9803,9848
2022/09/17,22:30:00,512.07,27,9677,9704
2022/09/17,23:00:00,512.26,34,9401,9435
2022/09/17,23:30:00,512.07,37,9077,9114
2022/09/18,00:00:00,528.38,24,8828,8852
2022/09/18,00:30:00,538.85,6,8564,8570
2022/09/18,01:00:00,538.33,11,8331,8342
2022/09/18,01:30:00,539.1,8,8081,8089
2022/09/18,02:00:00,539.87,5,7963,7968
2022/09/18,02:30:00,539.62,6,7792,7798
2022/09/18,03:00:00,539.36,12,7658,7670
2022/09/18,03:30:00,538.85,11,7557,7568
2022/09/18,04:00:00,538.85,9,7495,7504
2022/09/18,04:30:00,538.59,6,7548,7554
2022/09/18,05:00:00,538.33,5,7612,7617
2022/09/18,05:30:00,538.85,3,7734,7737
2022/09/18,06:00:00,538.08,3,7872,7875
2022/09/18,06:30:00,539.36,3,7890,7893
2022/09/18,07:00:00,538.08,131,8141,8272
2022/09/18,07:30:00,538.59,336,8402,8738
2022/09/18,08:00:00,539.1,673,8423,9096
2022/09/18,08:30:00,539.62,972,8613,9585
2022/09/18,09:00:00,539.1,1310,8638,9948
2022/09/18,09:30:00,538.85,1498,8726,10224
2022/09/18,10:00:00,540.13,1722,8620,10342
2022/09/18,10:30:00,538.59,2044,8691,10735
2022/09/18,11:00:00,537.57,2271,8603,10874
2022/09/18,11:30:00,540.13,2415,8538,10953
2022/09/18,12:00:00,539.62,2514,8553,11067
2022/09/18,12:30:00,540.13,2415,8756,11171
2022/09/18,13:00:00,495.28,2323,8943,11266
2022/09/18,13:30:00,539.62,2489,9052,11541
2022/09/18,14:00:00,540.13,2433,9410,11843
2022/09/18,14:30:00,540.13,2424,9575,11999
2022/09/18,15:00:00,537.06,2382,9726,12108
2022/09/18,15:30:00,538.85,2157,9933,12090
2022/09/18,16:00:00,532.78,1903,10044,11947
2022/09/18,16:30:00,523.88,1537,10278,11815
2022/09/18,17:00:00,507.26,1140,10464,11604
2022/09/18,17:30:00,503.21,799,10634,11433
2022/09/18,18:00:00,502.04,445,10696,11141
2022/09/18,18:30:00,501.21,164,10788,10952
2022/09/18,19:00:00,500.16,193,10871,11064
2022/09/18,19:30:00,499.42,197,10869,11066
2022/09/18,20:00:00,499.66,196,10872,11068
2022/09/18,20:30:00,498.95,192,10762,10954
2022/09/18,21:00:00,503.81,185,10611,10796
2022/09/18,21:30:00,506.91,181,10445,10626
2022/09/18,22:00:00,524.34,178,10190,10368
2022/09/18,22:30:00,538.33,143,9916,10059
2022/09/18,23:00:00,538.08,81,9675,9756
2022/09/18,23:30:00,538.85,49,9330,9379
2022/09/19,00:00:00,493.29,36,8985,9021
2022/09/19,00:30:00,539.87,35,8689,8724
2022/09/19,01:00:00,539.87,34,8427,8461
2022/09/19,01:30:00,540.13,30,8236,8266
2022/09/19,02:00:00,539.36,35,8063,8098
2022/09/19,02:30:00,539.62,35,7933,7968
2022/09/19,03:00:00,538.08,32,7858,7890
2022/09/19,03:30:00,538.08,32,7773,7805
2022/09/19,04:00:00,539.36,42,7718,7760
2022/09/19,04:30:00,539.36,34,7742,7776
2022/09/19,05:00:00,539.1,43,7789,7832
2022/09/19,05:30:00,538.59,42,7902,7944
2022/09/19,06:00:00,539.36,55,8032,8087
2022/09/19,06:30:00,538.85,44,8117,8161
2022/09/19,07:00:00,538.33,52,8388,8440
2022/09/19,07:30:00,539.62,377,8604,8981
2022/09/19,08:00:00,539.1,614,8646,9260
2022/09/19,08:30:00,539.62,863,8753,9616
2022/09/19,09:00:00,538.85,1160,8793,9953
2022/09/19,09:30:00,529.83,1455,8847,10302
2022/09/19,10:00:00,538.59,1526,8807,10333
2022/09/19,10:30:00,539.87,1918,8679,10597
2022/09/19,11:00:00,539.87,2132,8556,10688
2022/09/19,11:30:00,538.85,2030,8577,10607
2022/09/19,12:00:00,539.87,2041,8628,10669
2022/09/19,12:30:00,540.13,2236,8600,10836
2022/09/19,13:00:00,539.36,2141,8830,10971
2022/09/19,13:30:00,539.62,2290,8813,11103
2022/09/19,14:00:00,539.87,2400,8985,11385
2022/09/19,14:30:00,534.78,2087,9326,11413
2022/09/19,15:00:00,534.28,1994,9462,11456
2022/09/19,15:30:00,531.55,1839,9635,11474
2022/09/19,16:00:00,534.28,1684,9773,11457
2022/09/19,16:30:00,532.54,1497,9830,11327
2022/09/19,17:00:00,532.29,1139,9976,11115
2022/09/19,17:30:00,518.05,845,10158,11003
2022/09/19,18:00:00,516.55,481,10297,10778
2022/09/19,18:30:00,509.78,545,10382,10927
2022/09/19,19:00:00,506.57,114,10582,10696
2022/09/19,19:30:00,506.74,112,10584,10696
2022/09/19,20:00:00,506.57,108,10554,10662
2022/09/19,20:30:00,506.06,119,10439,10558
2022/09/19,21:00:00,506.4,114,10289,10403
2022/09/19,21:30:00,524.11,109,10160,10269
2022/09/19,22:00:00,536.81,102,9887,9989
2022/09/19,22:30:00,538.59,79,9646,9725
2022/09/19,23:00:00,539.36,100,9324,9424
2022/09/19,23:30:00,538.33,62,9041,9103
2022/09/20,00:00:00,538.85,52,8729,8781
2022/09/20,00:30:00,538.59,39,8447,8486
2022/09/20,01:00:00,538.33,37,8203,8240
2022/09/20,01:30:00,538.08,55,7968,8023
2022/09/20,02:00:00,538.08,56,7809,7865
2022/09/20,02:30:00,539.62,53,7662,7715
2022/09/20,03:00:00,538.85,53,7579,7632
2022/09/20,03:30:00,538.08,50,7472,7522
2022/09/20,04:00:00,537.82,45,7461,7506
2022/09/20,04:30:00,539.36,53,7452,7505
2022/09/20,05:00:00,538.08,54,7482,7536
2022/09/20,05:30:00,537.82,51,7633,7684
2022/09/20,06:00:00,537.57,49,7754,7803
2022/09/20,06:30:00,539.1,45,7854,7899
2022/09/20,07:00:00,539.1,45,8075,8120
2022/09/20,07:30:00,537.31,391,8260,8651
2022/09/20,08:00:00,539.1,689,8206,8895
2022/09/20,08:30:00,539.62,1009,8202,9211
2022/09/20,09:00:00,539.36,1525,8053,9578
2022/09/20,09:30:00,538.59,1870,8038,9908
2022/09/20,10:00:00,538.59,1956,8140,10096
2022/09/20,10:30:00,539.1,1953,8342,10295
2022/09/20,11:00:00,536.55,1858,8405,10263
2022/09/20,11:30:00,537.31,2038,8456,10494
2022/09/20,12:00:00,537.57,2058,8502,10560
2022/09/20,12:30:00,538.08,2163,8537,10700
2022/09/20,13:00:00,539.1,1984,8743,10727
2022/09/20,13:30:00,538.08,2102,8897,10999
2022/09/20,14:00:00,538.59,2131,9128,11259
2022/09/20,14:30:00,537.57,2154,9276,11430
2022/09/20,15:00:00,539.36,2067,9455,11522
2022/09/20,15:30:00,537.31,1907,9572,11479
2022/09/20,16:00:00,535.54,1623,9672,11295
2022/09/20,16:30:00,535.54,1515,9766,11281
2022/09/20,17:00:00,535.29,1194,9928,11122
2022/09/20,17:30:00,521.14,839,10119,10958
2022/09/20,18:00:00,518.05,533,10211,10744
2022/09/20,18:30:00,509.78,679,10198,10877
2022/09/20,19:00:00,506.91,233,10372,10605
2022/09/20,19:30:00,506.06,234,10378,10612
2022/09/20,20:00:00,506.74,227,10313,10540
2022/09/20,20:30:00,506.57,227,10195,10422
2022/09/20,21:00:00,506.4,216,10097,10313
2022/09/20,21:30:00,523.88,208,9936,10144
2022/09/20,22:00:00,521.59,152,9696,9848
2022/09/20,22:30:00,539.87,81,9611,9692
2022/09/20,23:00:00,538.85,78,9253,9331
2022/09/20,23:30:00,538.59,68,8970,9038
2022/09/21,00:00:00,539.1,78,8617,8695
2022/09/21,00:30:00,538.33,76,8316,8392
2022/09/21,01:00:00,538.33,75,8056,8131
2022/09/21,01:30:00,538.85,78,7825,7903
2022/09/21,02:00:00,539.36,85,7702,7787
2022/09/21,02:30:00,538.59,71,7573,7644
2022/09/21,03:00:00,538.85,69,7474,7543
2022/09/21,03:30:00,538.85,67,7351,7418
2022/09/21,04:00:00,538.59,59,7320,7379
2022/09/21,04:30:00,538.85,63,7345,7408
2022/09/21,05:00:00,537.57,61,7430,7491
2022/09/21,05:30:00,538.85,51,7499,7550
2022/09/21,06:00:00,538.08,54,7630,7684
2022/09/21,06:30:00,538.85,50,7737,7787
2022/09/21,07:00:00,539.36,159,7909,8068
2022/09/21,07:30:00,539.36,423,8104,8527
2022/09/21,08:00:00,539.36,738,8045,8783
2022/09/21,08:30:00,538.59,1091,7976,9067
2022/09/21,09:00:00,538.33,1538,7762,9300
2022/09/21,09:30:00,538.08,1682,7919,9601
2022/09/21,10:00:00,538.33,1740,7955,9695
2022/09/21,10:30:00,537.31,1840,7986,9826
2022/09/21,11:00:00,539.36,1999,8010,10009
2022/09/21,11:30:00,539.1,2100,7937,10037
2022/09/21,12:00:00,537.57,2106,7912,10018
2022/09/21,12:30:00,539.62,2054,7927,9981
2022/09/21,13:00:00,539.36,2164,8056,10220
2022/09/21,13:30:00,539.1,2271,7925,10196
2022/09/21,14:00:00,538.08,2404,8057,10461
2022/09/21,14:30:00,539.36,2387,8369,10756
2022/09/21,15:00:00,538.85,2344,8535,10879
2022/09/21,15:30:00,538.85,2137,8645,10782
2022/09/21,16:00:00,538.33,1724,8941,10665
2022/09/21,16:30:00,538.08,1508,9091,10599
2022/09/21,17:00:00,538.08,1254,9274,10528
2022/09/21,17:30:00,538.33,897,9415,10312
2022/09/21,18:00:00,538.33,485,9677,10162
2022/09/21,18:30:00,527.17,362,9813,10175
2022/09/21,19:00:00,526.94,179,10027,10206
2022/09/21,19:30:00,517.83,164,10101,10265
2022/09/21,20:00:00,516.34,157,10019,10176
2022/09/21,20:30:00,516.34,150,9931,10081
2022/09/21,21:00:00,516.34,139,9821,9960
2022/09/21,21:30:00,517.4,97,9744,9841
2022/09/21,22:00:00,516.76,42,9561,9603
2022/09/21,22:30:00,529.34,29,9330,9359
2022/09/21,23:00:00,538.85,22,9083,9105
2022/09/21,23:30:00,537.31,26,8786,8812
2022/09/22,00:00:00,538.85,18,8457,8475
2022/09/22,00:30:00,538.85,19,8199,8218
2022/09/22,01:00:00,539.1,24,7899,7923
2022/09/22,01:30:00,539.62,19,7700,7719
2022/09/22,02:00:00,539.62,16,7571,7587
2022/09/22,02:30:00,539.1,19,7386,7405
2022/09/22,03:00:00,538.33,21,7345,7366
2022/09/22,03:30:00,538.08,22,7246,7268
2022/09/22,04:00:00,538.59,25,7238,7263
2022/09/22,04:30:00,538.59,30,7217,7247
2022/09/22,05:00:00,538.08,22,7262,7284
2022/09/22,05:30:00,538.08,18,7462,7480
2022/09/22,06:00:00,536.81,15,7612,7627
2022/09/22,06:30:00,539.1,16,7671,7687
2022/09/22,07:00:00,538.08,23,7792,7815
2022/09/22,07:30:00,538.85,437,7933,8370
2022/09/22,08:00:00,538.85,810,7814,8624
2022/09/22,08:30:00,539.36,1185,7771,8956
2022/09/22,09:00:00,539.1,1603,7672,9275
2022/09/22,09:30:00,537.57,1893,7692,9585
2022/09/22,10:00:00,538.59,2096,7797,9893
2022/09/22,10:30:00,538.08,2260,7671,9931
2022/09/22,11:00:00,538.33,2522,7608,10130
2022/09/22,11:30:00,538.59,2509,7555,10064
2022/09/22,12:00:00,540.13,2588,7493,10081
2022/09/22,12:30:00,537.31,2651,7559,10210
2022/09/22,13:00:00,538.85,2664,7636,10300
2022/09/22,13:30:00,538.85,2678,7732,10410
2022/09/22,14:00:00,539.1,2650,7992,10642
2022/09/22,14:30:00,539.36,2652,8143,10795
2022/09/22,15:00:00,538.33,2520,8335,10855
2022/09/22,15:30:00,538.08,2267,8525,10792
2022/09/22,16:00:00,538.59,1936,8782,10718
2022/09/22,16:30:00,539.62,1636,8959,10595
2022/09/22,17:00:00,533.78,1270,9264,10534
2022/09/22,17:30:00,532.29,857,9552,10409
2022/09/22,18:00:00,532.78,442,9792,10234
2022/09/22,18:30:00,532.04,446,9882,10328
2022/09/22,19:00:00,526.46,195,10048,10243
2022/09/22,19:30:00,526.46,193,10033,10226
2022/09/22,20:00:00,539.62,192,9916,10108
2022/09/22,20:30:00,539.62,174,9812,9986
2022/09/22,21:00:00,538.85,163,9676,9839
2022/09/22,21:30:00,539.62,161,9559,9720
2022/09/22,22:00:00,539.87,154,9379,9533
2022/09/22,22:30:00,538.85,118,9211,9329
2022/09/22,23:00:00,539.62,65,9024,9089
2022/09/22,23:30:00,539.62,4,8790,8794
2022/09/23,00:00:00,539.1,4,8478,8482
2022/09/23,00:30:00,538.85,4,8153,8157
2022/09/23,01:00:00,540.13,3,7922,7925
2022/09/23,01:30:00,538.85,1,7763,7764
2022/09/23,02:00:00,538.08,1,7604,7605
2022/09/23,02:30:00,539.62,0,7423,7423
2022/09/23,03:00:00,539.1,0,7365,7365
2022/09/23,03:30:00,540.13,0,7218,7218
2022/09/23,04:00:00,539.36,0,7237,7237
2022/09/23,04:30:00,538.59,0,7201,7201
2022/09/23,05:00:00,538.85,1,7173,7174
2022/09/23,05:30:00,539.1,1,7317,7318
2022/09/23,06:00:00,539.36,2,7291,7293
2022/09/23,06:30:00,539.62,3,7249,7252
2022/09/23,07:00:00,539.1,8,7256,7264
2022/09/23,07:30:00,538.85,380,7247,7627
2022/09/23,08:00:00,539.62,787,7140,7927
2022/09/23,08:30:00,538.85,1157,7102,8259
2022/09/23,09:00:00,538.85,1592,7002,8594
2022/09/23,09:30:00,495.8,1921,6972,8893
2022/09/23,10:00:00,540.13,2200,6936,9136
2022/09/23,10:30:00,492.81,2474,6949,9423
2022/09/23,11:00:00,537.31,2603,7044,9647
2022/09/23,11:30:00,538.59,2635,7093,9728
2022/09/23,12:00:00,537.57,2687,7110,9797
2022/09/23,12:30:00,538.85,2646,7278,9924
2022/09/23,13:00:00,537.06,2636,7428,10064
2022/09/23,13:30:00,539.36,2642,7507,10149
2022/09/23,14:00:00,538.85,2617,7617,10234
2022/09/23,14:30:00,538.59,2571,7752,10323
2022/09/23,15:00:00,538.08,2453,7924,10377
2022/09/23,15:30:00,538.85,2201,8068,10269
2022/09/23,16:00:00,538.59,1866,8350,10216
2022/09/23,16:30:00,523.65,1490,8679,10169
2022/09/23,17:00:00,538.08,1175,9073,10248
2022/09/23,17:30:00,538.85,767,9493,10260
2022/09/23,18:00:00,538.08,371,9807,10178
2022/09/23,18:30:00,538.33,498,9755,10253
2022/09/23,19:00:00,537.57,162,9822,9984
2022/09/23,19:30:00,538.85,155,9701,9856
2022/09/23,20:00:00,537.82,153,9525,9678
2022/09/23,20:30:00,539.36,150,9366,9516
2022/09/23,21:00:00,537.57,152,9186,9338
2022/09/23,21:30:00,538.08,113,9023,9136
2022/09/23,22:00:00,538.08,74,8913,8987
2022/09/23,22:30:00,538.59,25,8822,8847
2022/09/23,23:00:00,538.08,29,8620,8649
2022/09/23,23:30:00,537.31,26,8395,8421
2022/09/24,00:00:00,537.57,31,8162,8193
2022/09/24,00:30:00,538.85,23,7940,7963
2022/09/24,01:00:00,539.1,23,7752,7775
2022/09/24,01:30:00,538.59,17,7587,7604
2022/09/24,02:00:00,535.54,20,7514,7534
2022/09/24,02:30:00,536.05,22,7328,7350
2022/09/24,03:00:00,535.79,27,7211,7238
2022/09/24,03:30:00,539.87,31,7101,7132
2022/09/24,04:00:00,493.29,34,7041,7075
2022/09/24,04:30:00,539.62,18,7104,7122
2022/09/24,05:00:00,539.62,21,7030,7051
2022/09/24,05:30:00,539.62,20,7104,7124
2022/09/24,06:00:00,539.36,21,7088,7109
2022/09/24,06:30:00,539.87,22,6931,6953
2022/09/24,07:00:00,539.87,16,6838,6854
2022/09/24,07:30:00,539.62,335,6680,7015
2022/09/24,08:00:00,539.87,749,6442,7191
2022/09/24,08:30:00,539.87,1088,6299,7387
2022/09/24,09:00:00,538.85,1497,6063,7560
2022/09/24,09:30:00,539.1,1890,5983,7873
2022/09/24,10:00:00,539.62,2205,5962,8167
2022/09/24,10:30:00,539.87,2422,6003,8425
2022/09/24,11:00:00,539.62,2576,6074,8650
2022/09/24,11:30:00,539.62,2617,6196,8813
2022/09/24,12:00:00,538.59,2658,6311,8969
2022/09/24,12:30:00,539.36,2682,6470,9152
2022/09/24,13:00:00,531.05,2650,6629,9279
2022/09/24,13:30:00,539.36,2665,6794,9459
2022/09/24,14:00:00,539.62,2638,6894,9532
2022/09/24,14:30:00,538.85,2581,7026,9607
2022/09/24,15:00:00,539.36,2440,7290,9730
2022/09/24,15:30:00,538.85,2192,7541,9733
2022/09/24,16:00:00,538.59,1875,7848,9723
2022/09/24,16:30:00,534.78,1482,8184,9666
2022/09/24,17:00:00,525.05,1138,8521,9659
2022/09/24,17:30:00,525.28,728,8843,9571
2022/09/24,18:00:00,525.75,371,9009,9380
2022/09/24,18:30:00,538.59,153,9087,9240
2022/09/24,19:00:00,537.57,153,9322,9475
2022/09/24,19:30:00,538.33,100,9371,9471
2022/09/24,20:00:00,538.33,53,9417,9470
2022/09/24,20:30:00,538.08,59,9424,9483
2022/09/24,21:00:00,538.33,62,9365,9427
2022/09/24,21:30:00,539.36,70,9322,9392
2022/09/24,22:00:00,538.59,69,9215,9284
2022/09/24,22:30:00,538.08,37,9096,9133
2022/09/24,23:00:00,539.36,36,8903,8939
2022/09/24,23:30:00,538.08,35,8635,8670
2022/09/25,00:00:00,538.85,31,8375,8406
2022/09/25,00:30:00,538.33,29,8123,8152
2022/09/25,01:00:00,538.85,19,7865,7884
2022/09/25,01:30:00,538.85,20,7637,7657
2022/09/25,02:00:00,538.59,23,7451,7474
2022/09/25,02:30:00,539.36,16,7343,7359
2022/09/25,03:00:00,538.08,15,7216,7231
2022/09/25,03:30:00,538.33,13,7105,7118
2022/09/25,04:00:00,538.08,18,7066,7084
2022/09/25,04:30:00,538.08,17,7068,7085
2022/09/25,05:00:00,538.59,12,7078,7090
2022/09/25,05:30:00,538.08,9,7157,7166
2022/09/25,06:00:00,538.85,4,7226,7230
2022/09/25,06:30:00,539.1,2,7180,7182
2022/09/25,07:00:00,538.85,5,7211,7216
2022/09/25,07:30:00,538.08,305,7273,7578
2022/09/25,08:00:00,538.08,720,7238,7958
2022/09/25,08:30:00,538.08,1041,7220,8261
2022/09/25,09:00:00,538.33,1431,7190,8621
2022/09/25,09:30:00,538.33,1821,7131,8952
2022/09/25,10:00:00,538.33,2177,7155,9332
2022/09/25,10:30:00,538.08,2399,7255,9654
2022/09/25,11:00:00,538.59,2550,7342,9892
2022/09/25,11:30:00,538.85,2618,7572,10190
2022/09/25,12:00:00,539.1,2663,7726,10389
2022/09/25,12:30:00,538.08,2646,7891,10537
2022/09/25,13:00:00,539.36,2646,8064,10710
2022/09/25,13:30:00,538.33,2640,8250,10890
2022/09/25,14:00:00,540.13,2601,8444,11045
2022/09/25,14:30:00,538.33,2522,8630,11152
2022/09/25,15:00:00,539.1,2378,8815,11193
2022/09/25,15:30:00,538.85,2156,8984,11140
2022/09/25,16:00:00,538.59,1836,9184,11020
2022/09/25,16:30:00,538.08,1455,9459,10914
2022/09/25,17:00:00,531.05,1089,9800,10889
2022/09/25,17:30:00,516.76,672,10046,10718
2022/09/25,18:00:00,507.78,349,10115,10464
2022/09/25,18:30:00,512.46,408,9858,10266
2022/09/25,19:00:00,521.36,413,9759,10172
2022/09/25,19:30:00,539.87,101,9521,9622
2022/09/25,20:00:00,539.62,59,9321,9380
2022/09/25,20:30:00,540.13,53,9086,9139
2022/09/25,21:00:00,538.33,60,8914,8974
2022/09/25,21:30:00,539.36,50,8798,8848
2022/09/25,22:00:00,538.59,47,8650,8697
2022/09/25,22:30:00,538.08,6,8599,8605
2022/09/25,23:00:00,538.59,2,8455,8457
2022/09/25,23:30:00,537.57,11,8317,8328
2022/09/26,00:00:00,539.1,13,8101,8114
2022/09/26,00:30:00,538.33,20,7921,7941
2022/09/26,01:00:00,538.85,22,7704,7726
2022/09/26,01:30:00,538.33,17,7546,7563
2022/09/26,02:00:00,538.08,15,7375,7390
2022/09/26,02:30:00,539.1,20,7259,7279
2022/09/26,03:00:00,539.62,16,7140,7156
2022/09/26,03:30:00,538.85,17,7068,7085
2022/09/26,04:00:00,539.36,16,7008,7024
2022/09/26,04:30:00,538.85,14,6966,6980
2022/09/26,05:00:00,539.36,20,6981,7001
2022/09/26,05:30:00,538.33,17,6983,7000
2022/09/26,06:00:00,538.85,14,6988,7002
2022/09/26,06:30:00,539.87,14,6934,6948
2022/09/26,07:00:00,538.33,15,6770,6785
2022/09/26,07:30:00,538.08,317,6626,6943
2022/09/26,08:00:00,539.36,735,6418,7153
2022/09/26,08:30:00,537.57,1068,6259,7327
2022/09/26,09:00:00,539.36,1489,6066,7555
2022/09/26,09:30:00,537.82,1881,5987,7868
2022/09/26,10:00:00,538.08,2195,5958,8153
2022/09/26,10:30:00,538.08,2401,5989,8390
2022/09/26,11:00:00,537.57,2539,6070,8609
2022/09/26,11:30:00,538.59,2610,6175,8785
2022/09/26,12:00:00,538.33,2637,6239,8876
2022/09/26,12:30:00,538.33,2667,6317,8984
2022/09/26,13:00:00,539.36,2649,6417,9066
2022/09/26,13:30:00,538.85,2643,6573,9216
2022/09/26,14:00:00,538.85,2589,6753,9342
2022/09/26,14:30:00,539.87,2530,6963,9493
2022/09/26,15:00:00,538.08,2403,7216,9619
2022/09/26,15:30:00,538.85,2162,7489,9651
2022/09/26,16:00:00,538.08,1825,7782,9607
2022/09/26,16:30:00,538.85,1485,8153,9638
2022/09/26,17:00:00,538.85,1123,8505,9628
2022/09/26,17:30:00,538.08,702,8796,9498
2022/09/26,18:00:00,533.53,358,8993,9351
2022/09/26,18:30:00,537.57,161,9002,9163
2022/09/26,19:00:00,537.57,166,9229,9395
2022/09/26,19:30:00,538.59,171,9229,9400
2022/09/26,20:00:00,538.33,69,9202,9271
2022/09/26,20:30:00,539.1,70,9090,9160
2022/09/26,21:00:00,538.85,75,9012,9087
2022/09/26,21:30:00,538.33,64,8916,8980
2022/09/26,22:00:00,538.59,61,8748,8809
2022/09/26,22:30:00,539.36,42,8658,8700
2022/09/26,23:00:00,538.08,30,8476,8506
2022/09/26,23:30:00,537.06,32,8253,8285
2022/09/27,00:00:00,537.82,51,8040,8091
2022/09/27,00:30:00,538.08,59,7798,7857
2022/09/27,01:00:00,537.31,69,7613,7682
2022/09/27,01:30:00,538.08,70,7445,7515
2022/09/27,02:00:00,537.31,69,7314,7383
2022/09/27,02:30:00,538.33,54,7203,7257
2022/09/27,03:00:00,538.59,36,7115,7151
2022/09/27,03:30:00,538.33,30,7039,7069
2022/09/27,04:00:00,539.87,33,6977,7010
2022/09/27,04:30:00,538.33,27,6925,6952
2022/09/27,05:00:00,537.82,18,6956,6974
2022/09/27,05:30:00,536.81,20,6987,7007
2022/09/27,06:00:00,538.33,22,6956,6978
2022/09/27,06:30:00,539.1,28,6919,6947
2022/09/27,07:00:00,537.82,36,6763,6799
2022/09/27,07:30:00,538.33,346,6629,6975
2022/09/27,08:00:00,538.08,764,6404,7168
2022/09/27,08:30:00,538.08,1117,6267,7384
2022/09/27,09:00:00,538.33,1522,6091,7613
2022/09/27,09:30:00,538.08,1956,5976,7932
2022/09/27,10:00:00,536.81,2276,5948,8224
2022/09/27,10:30:00,538.33,2492,5984,8476
2022/09/27,11:00:00,537.57,2621,6020,8641
2022/09/27,11:30:00,537.57,2665,6148,8813
2022/09/27,12:00:00,538.85,2688,6234,8922
2022/09/27,12:30:00,537.82,2723,6321,9044
2022/09/27,13:00:00,538.08,2723,6445,9168
2022/09/27,13:30:00,538.08,2729,6580,9309
2022/09/27,14:00:00,539.87,2659,6697,9356
2022/09/27,14:30:00,536.81,2621,6898,9519
2022/09/27,15:00:00,539.1,2495,7098,9593
2022/09/27,15:30:00,538.08,2273,7365,9638
2022/09/27,16:00:00,537.06,1952,7697,9649
2022/09/27,16:30:00,538.08,1563,8039,9602
2022/09/27,17:00:00,528.38,1212,8460,9672
2022/09/27,17:30:00,536.55,774,8740,9514
2022/09/27,18:00:00,536.81,440,8948,9388
2022/09/27,18:30:00,537.31,220,9035,9255
2022/09/27,19:00:00,536.81,209,9254,9463
2022/09/27,19:30:00,536.3,203,9282,9485
2022/09/27,20:00:00,536.81,154,9358,9512
2022/09/27,20:30:00,531.3,87,9374,9461
2022/09/27,21:00:00,536.3,99,9333,9432
2022/09/27,21:30:00,538.33,99,9236,9335
2022/09/27,22:00:00,538.08,99,9076,9175
2022/09/27,22:30:00,538.85,63,8961,9024
2022/09/27,23:00:00,538.33,54,8715,8769
2022/09/27,23:30:00,538.33,52,8413,8465
2022/09/28,00:00:00,538.59,58,8123,8181
2022/09/28,00:30:00,538.08,85,7861,7946
2022/09/28,01:00:00,538.08,80,7606,7686
2022/09/28,01:30:00,538.33,73,7438,7511
2022/09/28,02:00:00,538.08,72,7244,7316
2022/09/28,02:30:00,537.31,62,7142,7204
2022/09/28,03:00:00,528.62,64,7058,7122
2022/09/28,03:30:00,539.1,75,6938,7013
2022/09/28,04:00:00,538.08,75,6928,7003
2022/09/28,04:30:00,529.59,77,6911,6988
2022/09/28,05:00:00,536.3,82,6997,7079
2022/09/28,05:30:00,537.57,76,7115,7191
2022/09/28,06:00:00,538.08,79,7259,7338
2022/09/28,06:30:00,537.57,77,7378,7455
2022/09/28,07:00:00,538.08,70,7544,7614
2022/09/28,07:30:00,538.85,452,7678,8130
2022/09/28,08:00:00,537.57,876,7578,8454
2022/09/28,08:30:00,527.17,1241,7551,8792
2022/09/28,09:00:00,539.36,1690,7458,9148
2022/09/28,09:30:00,539.62,1940,7561,9501
2022/09/28,10:00:00,538.33,2135,7535,9670
2022/09/28,10:30:00,538.85,2389,7540,9929
2022/09/28,11:00:00,538.08,2559,7479,10038
2022/09/28,11:30:00,538.59,2648,7533,10181
2022/09/28,12:00:00,538.33,2749,7578,10327
2022/09/28,12:30:00,539.36,2737,7656,10393
2022/09/28,13:00:00,539.1,2718,7840,10558
2022/09/28,13:30:00,537.57,2658,7984,10642
2022/09/28,14:00:00,537.82,2618,8157,10775
2022/09/28,14:30:00,538.33,2478,8409,10887
2022/09/28,15:00:00,538.59,2354,8561,10915
2022/09/28,15:30:00,539.62,2109,8832,10941
2022/09/28,16:00:00,539.62,1855,8997,10852
2022/09/28,16:30:00,521.59,1564,9296,10860
2022/09/28,17:00:00,520.69,1225,9486,10711
2022/09/28,17:30:00,502.18,830,9726,10556
2022/09/28,18:00:00,500.03,439,9882,10321
2022/09/28,18:30:00,499.06,199,9941,10140
2022/09/28,19:00:00,499.18,204,10130,10334
2022/09/28,19:30:00,499.42,210,10031,10241
2022/09/28,20:00:00,499.78,198,9963,10161
2022/09/28,20:30:00,500.03,168,9858,10026
2022/09/28,21:00:00,508.5,159,9709,9868
2022/09/28,21:30:00,507.43,149,9595,9744
2022/09/28,22:00:00,520.02,144,9334,9478
2022/09/28,22:30:00,536.81,130,9155,9285
2022/09/28,23:00:00,538.08,134,8866,9000
2022/09/28,23:30:00,539.36,151,8549,8700
2022/09/29,00:00:00,538.59,145,8249,8394
2022/09/29,00:30:00,539.1,156,7967,8123
2022/09/29,01:00:00,538.59,130,7737,7867
2022/09/29,01:30:00,538.59,107,7603,7710
2022/09/29,02:00:00,538.59,40,7497,7537
2022/09/29,02:30:00,538.33,61,7327,7388
2022/09/29,03:00:00,538.59,55,7238,7293
2022/09/29,03:30:00,539.87,45,7184,7229
2022/09/29,04:00:00,538.33,54,7149,7203
2022/09/29,04:30:00,537.57,58,7160,7218
2022/09/29,05:00:00,538.33,54,7207,7261
2022/09/29,05:30:00,539.62,64,7340,7404
2022/09/29,06:00:00,538.59,71,7420,7491
2022/09/29,06:30:00,539.36,57,7571,7628
2022/09/29,07:00:00,538.33,74,7691,7765
2022/09/29,07:30:00,530.56,356,7946,8302
2022/09/29,08:00:00,531.3,770,7895,8665
2022/09/29,08:30:00,539.36,1106,7958,9064
2022/09/29,09:00:00,539.87,1511,7853,9364
2022/09/29,09:30:00,536.81,1847,7823,9670
2022/09/29,10:00:00,538.85,2120,7731,9851
2022/09/29,10:30:00,539.87,2367,7754,10121
2022/09/29,11:00:00,538.85,2495,7742,10237
2022/09/29,11:30:00,539.1,2580,7788,10368
2022/09/29,12:00:00,539.36,2681,7875,10556
2022/09/29,12:30:00,539.87,2714,7995,10709
2022/09/29,13:00:00,539.87,2711,8240,10951
2022/09/29,13:30:00,538.85,2632,8512,11144
2022/09/29,14:00:00,539.62,2580,8773,11353
2022/09/29,14:30:00,528.86,2475,9067,11542
2022/09/29,15:00:00,518.7,2329,9314,11643
2022/09/29,15:30:00,506.4,2060,9512,11572
2022/09/29,16:00:00,507.96,1758,9676,11434
2022/09/29,16:30:00,499.18,1426,10041,11467
2022/09/29,17:00:00,2412.56,1066,10269,11335
2022/09/29,17:30:00,2405.77,662,10486,11148
2022/09/29,18:00:00,2558.16,349,10518,10867
2022/09/29,18:30:00,2558.16,209,10513,10722
2022/09/29,19:00:00,2416.62,185,10638,10823
2022/09/29,19:30:00,2586.96,184,10580,10764
2022/09/29,20:00:00,495.17,200,10446,10646
2022/09/29,20:30:00,499.06,188,10301,10489
2022/09/29,21:00:00,501.07,198,10090,10288
2022/09/29,21:30:00,516.34,183,9923,10106
2022/09/29,22:00:00,515.71,158,9726,9884
2022/09/29,22:30:00,516.97,69,9538,9607
2022/09/29,23:00:00,538.08,60,9296,9356
2022/09/29,23:30:00,537.57,50,9017,9067
2022/09/30,00:00:00,539.36,31,8734,8765
2022/09/30,00:30:00,538.08,32,8496,8528
2022/09/30,01:00:00,538.85,14,8246,8260
2022/09/30,01:30:00,539.1,8,8069,8077
2022/09/30,02:00:00,538.59,12,7890,7902
2022/09/30,02:30:00,539.87,11,7754,7765
2022/09/30,03:00:00,539.1,7,7616,7623
2022/09/30,03:30:00,538.08,5,7537,7542
2022/09/30,04:00:00,538.59,4,7486,7490
2022/09/30,04:30:00,537.82,3,7428,7431
2022/09/30,05:00:00,538.33,2,7429,7431
2022/09/30,05:30:00,539.1,2,7495,7497
2022/09/30,06:00:00,537.57,2,7513,7515
2022/09/30,06:30:00,538.59,2,7513,7515
2022/09/30,07:00:00,539.1,3,7497,7500
2022/09/30,07:30:00,540.13,292,7555,7847
2022/09/30,08:00:00,539.1,692,7453,8145
2022/09/30,08:30:00,539.62,1078,7377,8455
2022/09/30,09:00:00,538.85,1432,7254,8686
2022/09/30,09:30:00,539.87,1744,7315,9059
2022/09/30,10:00:00,539.62,1961,7332,9293
2022/09/30,10:30:00,539.62,2160,7411,9571
2022/09/30,11:00:00,539.62,2272,7570,9842
2022/09/30,11:30:00,539.62,2352,7701,10053
2022/09/30,12:00:00,538.59,2448,7797,10245
2022/09/30,12:30:00,539.36,2472,8064,10536
2022/09/30,13:00:00,538.08,2470,8272,10742
2022/09/30,13:30:00,538.08,2378,8508,10886
2022/09/30,14:00:00,538.85,2331,8674,11005
2022/09/30,14:30:00,537.57,2244,8847,11091
2022/09/30,15:00:00,538.08,2106,9031,11137
2022/09/30,15:30:00,528.62,1913,9219,11132
2022/09/30,16:00:00,524.34,1610,9500,11110
2022/09/30,16:30:00,508.32,1303,9860,11163
2022/09/30,17:00:00,503.51,937,10239,11176
2022/09/30,17:30:00,2412.56,613,10623,11236
2022/09/30,18:00:00,2429.47,316,10794,11110
2022/09/30,18:30:00,2429.47,147,10676,10823
2022/09/30,19:00:00,495.65,156,10686,10842
2022/09/30,19:30:00,495.87,155,10540,10695
2022/09/30,20:00:00,496.11,150,10351,10501
2022/09/30,20:30:00,496.44,153,10132,10285
2022/09/30,21:00:00,509.04,91,10015,10106
2022/09/30,21:30:00,526.94,34,9886,9920
2022/09/30,22:00:00,527.41,41,9709,9750
2022/09/30,22:30:00,526.94,4,9601,9605
2022/09/30,23:00:00,539.62,2,9455,9457
2022/09/30,23:30:00,538.33,2,9209,9211
2022/10/01,00:00:00,605.08,4,8979,8983
2022/10/01,00:30:00,604.44,4,8718,8722
2022/10/01,01:00:00,573.24,4,8502,8506
2022/10/01,01:30:00,603.17,7,8316,8323
2022/10/01,02:00:00,603.8,20,8156,8176
2022/10/01,02:30:00,605.73,26,7994,8020
2022/10/01,03:00:00,605.73,16,7906,7922
2022/10/01,03:30:00,605.73,16,7776,7792
2022/10/01,04:00:00,605.08,5,7707,7712
2022/10/01,04:30:00,604.76,4,7681,7685
2022/10/01,05:00:00,604.12,5,7666,7671
2022/10/01,05:30:00,605.73,3,7660,7663
2022/10/01,06:00:00,603.48,3,7626,7629
2022/10/01,06:30:00,605.73,0,7544,7544
2022/10/01,07:00:00,604.12,0,7370,7370
2022/10/01,07:30:00,604.12,225,7312,7537
2022/10/01,08:00:00,605.73,469,7239,7708
2022/10/01,08:30:00,605.73,723,7201,7924
2022/10/01,09:00:00,604.76,1081,7072,8153
2022/10/01,09:30:00,605.73,1477,7053,8530
2022/10/01,10:00:00,604.12,2009,6995,9004
2022/10/01,10:30:00,605.73,2304,7120,9424
2022/10/01,11:00:00,605.08,2457,7259,9716
2022/10/01,11:30:00,604.12,2516,7421,9937
2022/10/01,12:00:00,605.08,2620,7526,10146
2022/10/01,12:30:00,604.76,2641,7665,10306
2022/10/01,13:00:00,604.12,2662,7846,10508
2022/10/01,13:30:00,601.91,2574,8034,10608
2022/10/01,14:00:00,602.54,2521,8149,10670
2022/10/01,14:30:00,604.76,2433,8322,10755
2022/10/01,15:00:00,603.8,2292,8493,10785
2022/10/01,15:30:00,588.15,2030,8802,10832
2022/10/01,16:00:00,590.27,1709,9080,10789
2022/10/01,16:30:00,583.61,1408,9404,10812
2022/10/01,17:00:00,575.57,1029,9735,10764
2022/10/01,17:30:00,567.14,600,9984,10584
2022/10/01,18:00:00,561.59,297,10115,10412
2022/10/01,18:30:00,561.59,500,10253,10753
2022/10/01,19:00:00,561.81,92,10386,10478
2022/10/01,19:30:00,561.81,74,10365,10439
2022/10/01,20:00:00,559.7,56,10415,10471
2022/10/01,20:30:00,559.79,45,10365,10410
2022/10/01,21:00:00,559.61,43,10317,10360
2022/10/01,21:30:00,559.53,40,10176,10216
2022/10/01,22:00:00,562.27,36,10029,10065
2022/10/01,22:30:00,561.7,13,9872,9885
2022/10/01,23:00:00,572.81,13,9571,9584
2022/10/01,23:30:00,598.84,19,9237,9256
2022/10/02,00:00:00,603.17,23,8901,8924
2022/10/02,00:30:00,603.48,20,8609,8629
2022/10/02,01:00:00,603.48,12,8333,8345
2022/10/02,01:30:00,604.44,9,8122,8131
2022/10/02,02:00:00,604.12,7,7958,7965
2022/10/02,02:30:00,604.44,3,7800,7803
2022/10/02,03:00:00,603.8,1,7670,7671
2022/10/02,03:30:00,604.12,2,7597,7599
2022/10/02,04:00:00,603.17,1,7524,7525
2022/10/02,04:30:00,603.8,2,7564,7566
2022/10/02,05:00:00,604.12,1,7583,7584
2022/10/02,05:30:00,603.8,1,7734,7735
2022/10/02,06:00:00,605.73,0,7849,7849
2022/10/02,06:30:00,603.17,1,8002,8003
2022/10/02,07:00:00,604.12,0,8186,8186
2022/10/02,07:30:00,604.76,261,8448,8709
2022/10/02,08:00:00,604.12,569,8465,9034
2022/10/02,08:30:00,604.12,815,8624,9439
2022/10/02,09:00:00,605.08,1252,8557,9809
2022/10/02,09:30:00,507.05,1568,8498,10066
2022/10/02,10:00:00,506.51,1916,8341,10257
2022/10/02,10:30:00,505.45,2212,8291,10503
2022/10/02,11:00:00,603.8,2415,8314,10729
2022/10/02,11:30:00,605.08,2478,8337,10815
2022/10/02,12:00:00,604.44,2599,8430,11029
2022/10/02,12:30:00,604.12,2611,8570,11181
2022/10/02,13:00:00,605.08,2595,8765,11360
2022/10/02,13:30:00,603.17,2532,9041,11573
2022/10/02,14:00:00,603.17,2471,9366,11837
2022/10/02,14:30:00,594.72,2384,9653,12037
2022/10/02,15:00:00,577.66,2248,9906,12154
2022/10/02,15:30:00,570.09,2014,10115,12129
2022/10/02,16:00:00,562.39,1716,10311,12027
2022/10/02,16:30:00,561.7,1438,10605,12043
2022/10/02,17:00:00,2304.95,1088,10880,11968
2022/10/02,17:30:00,2440.78,690,11033,11723
2022/10/02,18:00:00,2468.12,340,10803,11143
2022/10/02,18:30:00,557.68,192,10906,11098
2022/10/02,19:00:00,559.35,215,10953,11168
2022/10/02,19:30:00,559.61,216,10874,11090
2022/10/02,20:00:00,560.07,214,10804,11018
2022/10/02,20:30:00,559.7,206,10663,10869
2022/10/02,21:00:00,562.15,185,10474,10659
2022/10/02,21:30:00,569.07,193,10404,10597
2022/10/02,22:00:00,573,183,10011,10194
2022/10/02,22:30:00,591.63,149,9794,9943
2022/10/02,23:00:00,603.17,144,9466,9610
2022/10/02,23:30:00,604.12,140,9104,9244
2022/10/03,00:00:00,572.61,146,8785,8931
2022/10/03,00:30:00,590.81,94,8518,8612
2022/10/03,01:00:00,592.46,31,8293,8324
2022/10/03,01:30:00,598.54,26,8090,8116
2022/10/03,02:00:00,598.84,30,7894,7924
2022/10/03,02:30:00,599.15,35,7729,7764
2022/10/03,03:00:00,599.15,38,7563,7601
2022/10/03,03:30:00,600.67,34,7499,7533
2022/10/03,04:00:00,605.73,31,7415,7446
2022/10/03,04:30:00,505.45,22,7392,7414
2022/10/03,05:00:00,599.45,23,7440,7463
2022/10/03,05:30:00,594.15,28,7539,7567
2022/10/03,06:00:00,589.47,23,7630,7653
2022/10/03,06:30:00,590,15,7771,7786
2022/10/03,07:00:00,591.63,13,7920,7933
2022/10/03,07:30:00,592.46,286,8090,8376
2022/10/03,08:00:00,591.91,658,8079,8737
2022/10/03,08:30:00,591.36,1020,8126,9146
2022/10/03,09:00:00,594.15,1439,8022,9461
2022/10/03,09:30:00,603.8,1782,8029,9811
2022/10/03,10:00:00,600.67,2009,8032,10041
2022/10/03,10:30:00,600.67,2171,8129,10300
2022/10/03,11:00:00,600.67,2301,8151,10452
2022/10/03,11:30:00,600.98,2464,8193,10657
2022/10/03,12:00:00,599.45,2559,8361,10920
2022/10/03,12:30:00,601.29,2463,8546,11009
2022/10/03,13:00:00,600.67,2522,8775,11297
2022/10/03,13:30:00,599.45,2439,9121,11560
2022/10/03,14:00:00,591.36,2274,9517,11791
2022/10/03,14:30:00,581.7,2195,9766,11961
2022/10/03,15:00:00,564.8,2119,9952,12071
2022/10/03,15:30:00,559.61,1877,10167,12044
2022/10/03,16:00:00,559.19,1573,10296,11869
2022/10/03,16:30:00,559.35,1250,10447,11697
2022/10/03,17:00:00,559.19,905,10640,11545
2022/10/03,17:30:00,559.02,518,10703,11221
2022/10/03,18:00:00,561.59,334,10664,10998
2022/10/03,18:30:00,561.7,495,10771,11266
2022/10/03,19:00:00,559.61,168,10814,10982
2022/10/03,19:30:00,559.44,176,10745,10921
2022/10/03,20:00:00,564.53,172,10675,10847
2022/10/03,20:30:00,563.87,169,10525,10694
2022/10/03,21:00:00,571.88,105,10454,10559
2022/10/03,21:30:00,570.97,51,10317,10368
2022/10/03,22:00:00,570.97,41,10085,10126
2022/10/03,22:30:00,582.65,18,9826,9844
2022/10/03,23:00:00,600.98,19,9486,9505
2022/10/03,23:30:00,602.54,18,9189,9207
2022/10/04,00:00:00,600.98,12,8820,8832
2022/10/04,00:30:00,588.41,18,8512,8530
2022/10/04,01:00:00,586.09,19,8238,8257
2022/10/04,01:30:00,585.08,20,8021,8041
2022/10/04,02:00:00,584.59,19,7811,7830
2022/10/04,02:30:00,584.34,11,7721,7732
2022/10/04,03:00:00,585.58,6,7596,7602
2022/10/04,03:30:00,584.34,12,7523,7535
2022/10/04,04:00:00,584.84,11,7456,7467
2022/10/04,04:30:00,585.08,8,7467,7475
2022/10/04,05:00:00,585.08,4,7452,7456
2022/10/04,05:30:00,585.08,4,7505,7509
2022/10/04,06:00:00,584.34,3,7571,7574
2022/10/04,06:30:00,584.84,3,7538,7541
2022/10/04,07:00:00,584.34,3,7541,7544
2022/10/04,07:30:00,587.62,250,7548,7798
2022/10/04,08:00:00,589.73,616,7516,8132
2022/10/04,08:30:00,589.73,1008,7540,8548
2022/10/04,09:00:00,589.47,1346,7506,8852
2022/10/04,09:30:00,600.67,1716,7453,9169
2022/10/04,10:00:00,600.67,2042,7429,9471
2022/10/04,10:30:00,589.73,2264,7486,9750
2022/10/04,11:00:00,589.47,2397,7569,9966
2022/10/04,11:30:00,589.47,2351,7690,10041
2022/10/04,12:00:00,588.15,2520,7747,10267
2022/10/04,12:30:00,594.15,2590,7856,10446
2022/10/04,13:00:00,602.54,2564,8006,10570
2022/10/04,13:30:00,603.17,2520,8107,10627
2022/10/04,14:00:00,603.48,2434,8251,10685
2022/10/04,14:30:00,603.17,2358,8403,10761
2022/10/04,15:00:00,604.76,2189,8624,10813
2022/10/04,15:30:00,594.72,1959,8833,10792
2022/10/04,16:00:00,589.2,1580,9119,10699
2022/10/04,16:30:00,595.3,1289,9436,10725
2022/10/04,17:00:00,582.65,872,9685,10557
2022/10/04,17:30:00,577.88,479,9796,10275
2022/10/04,18:00:00,579.19,312,9671,9983
2022/10/04,18:30:00,593.87,409,9561,9970
2022/10/04,19:00:00,601.6,104,9380,9484
2022/10/04,19:30:00,602.54,38,9252,9290
2022/10/04,20:00:00,601.6,37,9067,9104
2022/10/04,20:30:00,602.22,33,8959,8992
2022/10/04,21:00:00,601.91,35,8866,8901
2022/10/04,21:30:00,602.54,34,8747,8781
2022/10/04,22:00:00,603.8,32,8590,8622
2022/10/04,22:30:00,593.59,0,8461,8461
2022/10/04,23:00:00,590,2,8269,8271
2022/10/04,23:30:00,589.47,5,8034,8039
2022/10/05,00:00:00,591.36,4,7802,7806
2022/10/05,00:30:00,591.09,4,7643,7647
2022/10/05,01:00:00,590,10,7471,7481
2022/10/05,01:30:00,589.47,11,7339,7350
2022/10/05,02:00:00,590.27,9,7218,7227
2022/10/05,02:30:00,590.81,8,7108,7116
2022/10/05,03:00:00,589.73,7,7020,7027
2022/10/05,03:30:00,589.73,12,6941,6953
2022/10/05,04:00:00,589.47,13,6887,6900
2022/10/05,04:30:00,590.81,13,6858,6871
2022/10/05,05:00:00,589.47,18,6867,6885
2022/10/05,05:30:00,589.2,18,6909,6927
2022/10/05,06:00:00,589.73,17,6911,6928
2022/10/05,06:30:00,589.73,19,6875,6894
2022/10/05,07:00:00,588.67,18,6751,6769
2022/10/05,07:30:00,590.54,230,6608,6838
2022/10/05,08:00:00,589.2,596,6403,6999
2022/10/05,08:30:00,590,944,6245,7189
2022/10/05,09:00:00,590.81,1249,6053,7302
2022/10/05,09:30:00,589.2,1574,5913,7487
2022/10/05,10:00:00,590,1657,5928,7585
2022/10/05,10:30:00,589.73,1865,5805,7670
2022/10/05,11:00:00,590,2269,5706,7975
2022/10/05,11:30:00,589.73,2476,5714,8190
2022/10/05,12:00:00,589.47,2536,5811,8347
2022/10/05,12:30:00,590,2618,5988,8606
2022/10/05,13:00:00,589.73,2617,6157,8774
2022/10/05,13:30:00,589.73,2532,6345,8877
2022/10/05,14:00:00,589.47,2487,6547,9034
2022/10/05,14:30:00,589.47,2389,6729,9118
2022/10/05,15:00:00,586.6,2224,6982,9206
2022/10/05,15:30:00,589.73,1981,7192,9173
2022/10/05,16:00:00,588.67,1638,7481,9119
2022/10/05,16:30:00,589.47,1308,7775,9083
2022/10/05,17:00:00,590.81,931,8077,9008
2022/10/05,17:30:00,589.2,542,8301,8843
2022/10/05,18:00:00,589.73,347,8394,8741
2022/10/05,18:30:00,589.2,464,8595,9059
2022/10/05,19:00:00,589.47,41,9028,9069
2022/10/05,19:30:00,587.37,43,9008,9051
2022/10/05,20:00:00,588.67,41,8935,8976
2022/10/05,20:30:00,589.2,51,8891,8942
2022/10/05,21:00:00,588.67,49,8808,8857
2022/10/05,21:30:00,589.2,43,8782,8825
2022/10/05,22:00:00,588.93,48,8685,8733
2022/10/05,22:30:00,585.08,15,8591,8606
2022/10/05,23:00:00,590.81,14,8413,8427
2022/10/05,23:30:00,589.2,9,8187,8196
2022/10/06,00:00:00,589.47,10,7944,7954
2022/10/06,00:30:00,589.47,9,7725,7734
2022/10/06,01:00:00,588.41,8,7497,7505
2022/10/06,01:30:00,587.88,9,7286,7295
2022/10/06,02:00:00,588.41,11,7116,7127
2022/10/06,02:30:00,588.67,18,6964,6982
2022/10/06,03:00:00,588.67,26,6853,6879
2022/10/06,03:30:00,588.67,37,6788,6825
2022/10/06,04:00:00,588.93,30,6752,6782
2022/10/06,04:30:00,589.47,19,6794,6813
2022/10/06,05:00:00,589.2,20,6865,6885
2022/10/06,05:30:00,588.67,15,7036,7051
2022/10/06,06:00:00,589.73,12,7184,7196
2022/10/06,06:30:00,588.15,16,7312,7328
2022/10/06,07:00:00,587.62,12,7523,7535
2022/10/06,07:30:00,588.93,269,7664,7933
2022/10/06,08:00:00,589.73,676,7671,8347
2022/10/06,08:30:00,588.67,1015,7711,8726
2022/10/06,09:00:00,588.67,1468,7608,9076
2022/10/06,09:30:00,588.93,1815,7473,9288
2022/10/06,10:00:00,589.47,2071,7415,9486
2022/10/06,10:30:00,588.67,2291,7392,9683
2022/10/06,11:00:00,588.67,2445,7341,9786
2022/10/06,11:30:00,590.81,2506,7386,9892
2022/10/06,12:00:00,587.88,2591,7447,10038
2022/10/06,12:30:00,589.47,2610,7590,10200
2022/10/06,13:00:00,591.63,2617,7757,10374
2022/10/06,13:30:00,605.73,2552,7937,10489
2022/10/06,14:00:00,604.44,2501,8149,10650
2022/10/06,14:30:00,603.17,2394,8403,10797
2022/10/06,15:00:00,603.17,2196,8558,10754
2022/10/06,15:30:00,604.12,1886,8777,10663
2022/10/06,16:00:00,605.08,1611,8937,10548
2022/10/06,16:30:00,605.73,1282,9190,10472
2022/10/06,17:00:00,604.12,892,9428,10320
2022/10/06,17:30:00,602.54,493,9598,10091
2022/10/06,18:00:00,596.46,319,9579,9898
2022/10/06,18:30:00,593.3,541,9774,10315
2022/10/06,19:00:00,594.44,148,9756,9904
2022/10/06,19:30:00,604.44,147,9638,9785
2022/10/06,20:00:00,603.8,131,9583,9714
2022/10/06,20:30:00,603.17,36,9537,9573
2022/10/06,21:00:00,604.12,35,9401,9436
2022/10/06,21:30:00,603.17,35,9188,9223
2022/10/06,22:00:00,604.76,33,8988,9021
2022/10/06,22:30:00,603.17,3,8822,8825
2022/10/06,23:00:00,603.48,3,8597,8600
2022/10/06,23:30:00,603.48,5,8361,8366
2022/10/07,00:00:00,604.76,5,8132,8137
2022/10/07,00:30:00,602.54,3,7900,7903
2022/10/07,01:00:00,603.17,4,7650,7654
2022/10/07,01:30:00,601.6,4,7487,7491
2022/10/07,02:00:00,602.54,5,7296,7301
2022/10/07,02:30:00,603.17,5,7201,7206
2022/10/07,03:00:00,604.12,6,7062,7068
2022/10/07,03:30:00,603.48,6,6989,6995
2022/10/07,04:00:00,602.54,4,6936,6940
2022/10/07,04:30:00,603.8,1,6944,6945
2022/10/07,05:00:00,601.91,3,6997,7000
2022/10/07,05:30:00,603.48,0,7104,7104
2022/10/07,06:00:00,604.12,6,7129,7135
2022/10/07,06:30:00,605.08,15,7165,7180
2022/10/07,07:00:00,603.17,3,7228,7231
2022/10/07,07:30:00,591.09,200,7432,7632
2022/10/07,08:00:00,597.35,346,7497,7843
2022/10/07,08:30:00,604.76,500,7486,7986
2022/10/07,09:00:00,603.48,731,7427,8158
2022/10/07,09:30:00,604.76,866,7497,8363
2022/10/07,10:00:00,602.54,926,7580,8506
2022/10/07,10:30:00,604.76,955,7645,8600
2022/10/07,11:00:00,605.08,1089,7568,8657
2022/10/07,11:30:00,604.12,1238,7541,8779
2022/10/07,12:00:00,605.73,1530,7368,8898
2022/10/07,12:30:00,603.17,1559,7409,8968
2022/10/07,13:00:00,604.12,1589,7422,9011
2022/10/07,13:30:00,605.08,1589,7357,8946
2022/10/07,14:00:00,605.08,1646,7231,8877
2022/10/07,14:30:00,603.17,1586,7322,8908
2022/10/07,15:00:00,604.44,1529,7378,8907
2022/10/07,15:30:00,605.41,1489,7420,8909
2022/10/07,16:00:00,604.12,1225,7542,8767
2022/10/07,16:30:00,604.12,1012,7882,8894
2022/10/07,17:00:00,605.73,783,8229,9012
2022/10/07,17:30:00,605.08,528,8555,9083
2022/10/07,18:00:00,604.12,312,8703,9015
2022/10/07,18:30:00,605.08,293,8886,9179
2022/10/07,19:00:00,603.8,68,8886,8954
2022/10/07,19:30:00,605.41,73,8733,8806
2022/10/07,20:00:00,604.12,70,8551,8621
2022/10/07,20:30:00,604.12,75,8389,8464
2022/10/07,21:00:00,605.73,70,8230,8300
2022/10/07,21:30:00,605.73,77,8092,8169
2022/10/07,22:00:00,604.76,83,7969,8052
2022/10/07,22:30:00,604.76,63,7862,7925
2022/10/07,23:00:00,604.76,53,7723,7776
2022/10/07,23:30:00,603.17,59,7554,7613
2022/10/08,00:00:00,602.54,54,7388,7442
2022/10/08,00:30:00,603.17,78,7181,7259
2022/10/08,01:00:00,602.54,65,7008,7073
2022/10/08,01:30:00,601.91,51,6896,6947
2022/10/08,02:00:00,603.48,61,6751,6812
2022/10/08,02:30:00,605.08,72,6616,6688
2022/10/08,03:00:00,604.12,86,6536,6622
2022/10/08,03:30:00,602.22,87,6489,6576
2022/10/08,04:00:00,602.54,77,6444,6521
2022/10/08,04:30:00,605.08,74,6438,6512
2022/10/08,05:00:00,603.17,83,6418,6501
2022/10/08,05:30:00,603.8,86,6453,6539
2022/10/08,06:00:00,603.17,90,6452,6542
2022/10/08,06:30:00,603.8,85,6365,6450
2022/10/08,07:00:00,603.48,69,6239,6308
2022/10/08,07:30:00,603.17,334,6095,6429
2022/10/08,08:00:00,603.17,780,5864,6644
2022/10/08,08:30:00,603.17,1151,5571,6722
2022/10/08,09:00:00,573.45,1502,5389,6891
2022/10/08,09:30:00,507.05,1865,5248,7113
2022/10/08,10:00:00,507.05,2112,5258,7370
2022/10/08,10:30:00,444.36,2292,5294,7586
2022/10/08,11:00:00,444.24,2380,5374,7754
2022/10/08,11:30:00,604.76,2330,5423,7753
2022/10/08,12:00:00,573.87,2438,5494,7932
2022/10/08,12:30:00,604.76,2347,5529,7876
2022/10/08,13:00:00,604.44,2381,5597,7978
2022/10/08,13:30:00,604.12,2325,5722,8047
2022/10/08,14:00:00,602.54,2135,5825,7960
2022/10/08,14:30:00,602.54,2028,5956,7984
2022/10/08,15:00:00,603.17,1798,6210,8008
2022/10/08,15:30:00,603.17,1567,6442,8009
2022/10/08,16:00:00,604.76,1298,6768,8066
2022/10/08,16:30:00,605.73,1201,6955,8156
2022/10/08,17:00:00,603.48,903,7309,8212
2022/10/08,17:30:00,604.76,553,7600,8153
2022/10/08,18:00:00,603.17,289,7803,8092
2022/10/08,18:30:00,603.17,202,8138,8340
2022/10/08,19:00:00,603.17,202,8289,8491
2022/10/08,19:30:00,603.17,186,8335,8521
2022/10/08,20:00:00,604.12,190,8374,8564
2022/10/08,20:30:00,603.17,197,8288,8485
2022/10/08,21:00:00,603.8,185,8276,8461
2022/10/08,21:30:00,603.8,190,8220,8410
2022/10/08,22:00:00,603.8,127,8150,8277
2022/10/08,22:30:00,603.48,25,8123,8148
2022/10/08,23:00:00,605.08,57,7887,7944
2022/10/08,23:30:00,602.54,46,7705,7751
2022/10/09,00:00:00,604.76,32,7471,7503
2022/10/09,00:30:00,605.08,34,7246,7280
2022/10/09,01:00:00,604.76,27,7043,7070
2022/10/09,01:30:00,605.08,23,6873,6896
2022/10/09,02:00:00,605.08,19,6738,6757
2022/10/09,02:30:00,603.8,21,6609,6630
2022/10/09,03:00:00,602.54,29,6505,6534
2022/10/09,03:30:00,603.17,29,6383,6412
2022/10/09,04:00:00,604.12,45,6325,6370
2022/10/09,04:30:00,603.8,45,6328,6373
2022/10/09,05:00:00,604.12,43,6374,6417
2022/10/09,05:30:00,603.17,40,6476,6516
2022/10/09,06:00:00,602.54,33,6571,6604
2022/10/09,06:30:00,603.8,19,6685,6704
2022/10/09,07:00:00,603.17,13,6686,6699
2022/10/09,07:30:00,602.54,279,6732,7011
2022/10/09,08:00:00,602.54,624,6649,7273
2022/10/09,08:30:00,603.48,948,6602,7550
2022/10/09,09:00:00,603.17,1241,6576,7817
2022/10/09,09:30:00,602.54,1557,6485,8042
2022/10/09,10:00:00,603.48,1535,6534,8069
2022/10/09,10:30:00,602.54,1719,6473,8192
2022/10/09,11:00:00,602.54,1883,6470,8353
2022/10/09,11:30:00,602.54,1966,6547,8513
2022/10/09,12:00:00,603.17,2037,6703,8740
2022/10/09,12:30:00,602.54,1884,6738,8622
2022/10/09,13:00:00,604.44,1960,6658,8618
2022/10/09,13:30:00,601.91,1836,6582,8418
2022/10/09,14:00:00,604.44,2009,6599,8608
2022/10/09,14:30:00,605.08,1781,6748,8529
2022/10/09,15:00:00,605.41,1806,6867,8673
2022/10/09,15:30:00,603.8,1687,6999,8686
2022/10/09,16:00:00,604.12,1439,7175,8614
2022/10/09,16:30:00,604.12,1286,7413,8699
2022/10/09,17:00:00,604.76,946,7811,8757
2022/10/09,17:30:00,604.76,565,8200,8765
2022/10/09,18:00:00,605.08,326,8359,8685
2022/10/09,18:30:00,603.17,169,8465,8634
2022/10/09,19:00:00,605.08,173,8381,8554
2022/10/09,19:30:00,604.12,175,8115,8290
2022/10/09,20:00:00,605.73,180,7849,8029
2022/10/09,20:30:00,604.76,113,7752,7865
2022/10/09,21:00:00,604.12,24,7702,7726
2022/10/09,21:30:00,603.8,18,7597,7615
2022/10/09,22:00:00,604.76,17,7485,7502
2022/10/09,22:30:00,605.08,15,7383,7398
2022/10/09,23:00:00,604.44,18,7246,7264
2022/10/09,23:30:00,573.66,26,7085,7111
2022/10/10,00:00:00,605.41,28,6914,6942
2022/10/10,00:30:00,605.73,23,6743,6766
2022/10/10,01:00:00,573.45,27,6546,6573
2022/10/10,01:30:00,603.17,31,6437,6468
2022/10/10,02:00:00,604.12,32,6317,6349
2022/10/10,02:30:00,603.17,29,6226,6255
2022/10/10,03:00:00,603.17,20,6160,6180
2022/10/10,03:30:00,603.8,18,6124,6142
2022/10/10,04:00:00,603.17,15,6092,6107
2022/10/10,04:30:00,601.91,6,6107,6113
2022/10/10,05:00:00,604.12,3,6140,6143
2022/10/10,05:30:00,602.54,1,6194,6195
2022/10/10,06:00:00,603.17,0,6270,6270
2022/10/10,06:30:00,603.8,0,6283,6283
2022/10/10,07:00:00,602.54,0,6162,6162
2022/10/10,07:30:00,603.48,281,5987,6268
2022/10/10,08:00:00,602.54,743,5693,6436
2022/10/10,08:30:00,603.48,1124,5433,6557
2022/10/10,09:00:00,602.54,1562,5121,6683
2022/10/10,09:30:00,504.42,1849,4958,6807
2022/10/10,10:00:00,505.45,2070,4847,6917
2022/10/10,10:30:00,505.98,2276,4861,7137
2022/10/10,11:00:00,505.98,2415,4829,7244
2022/10/10,11:30:00,505.45,2379,4864,7243
2022/10/10,12:00:00,504.93,2616,4827,7443
2022/10/10,12:30:00,505.98,2536,4886,7422
2022/10/10,13:00:00,504.93,2593,4925,7518
2022/10/10,13:30:00,504.93,2494,5042,7536
2022/10/10,14:00:00,503.42,2471,5059,7530
2022/10/10,14:30:00,504.42,2353,5341,7694
2022/10/10,15:00:00,504.93,2227,5459,7686
2022/10/10,15:30:00,505.98,1990,5756,7746
2022/10/10,16:00:00,503.92,1636,6147,7783
2022/10/10,16:30:00,604.44,1247,6633,7880
2022/10/10,17:00:00,574.08,953,6984,7937
2022/10/10,17:30:00,604.44,562,7383,7945
2022/10/10,18:00:00,605.08,334,7643,7977
2022/10/10,18:30:00,592.46,405,7968,8373
2022/10/10,19:00:00,590,154,8115,8269
2022/10/10,19:30:00,589.73,152,8159,8311
2022/10/10,20:00:00,590.54,146,8158,8304
2022/10/10,20:30:00,590,145,8123,8268
2022/10/10,21:00:00,601.6,145,8077,8222
2022/10/10,21:30:00,562.33,114,8039,8153
2022/10/10,22:00:00,604.12,114,7885,7999
2022/10/10,22:30:00,605.08,112,7682,7794
2022/10/10,23:00:00,605.08,56,7546,7602
2022/10/10,23:30:00,604.12,0,7370,7370
2022/10/11,00:00:00,604.12,0,7164,7164
2022/10/11,00:30:00,603.17,0,6951,6951
2022/10/11,01:00:00,603.8,0,6763,6763
2022/10/11,01:30:00,604.12,0,6599,6599
2022/10/11,02:00:00,604.12,0,6449,6449
2022/10/11,02:30:00,605.08,0,6364,6364
2022/10/11,03:00:00,605.73,0,6271,6271
2022/10/11,03:30:00,605.08,5,6202,6207
2022/10/11,04:00:00,605.08,8,6199,6207
2022/10/11,04:30:00,604.76,12,6242,6254
2022/10/11,05:00:00,604.12,18,6309,6327
2022/10/11,05:30:00,605.73,22,6467,6489
2022/10/11,06:00:00,603.8,29,6592,6621
2022/10/11,06:30:00,604.44,28,6711,6739
2022/10/11,07:00:00,603.48,25,6828,6853
2022/10/11,07:30:00,605.08,281,6890,7171
2022/10/11,08:00:00,604.76,704,6785,7489
2022/10/11,08:30:00,573.66,1020,6716,7736
2022/10/11,09:00:00,605.08,1483,6447,7930
2022/10/11,09:30:00,603.48,1858,6335,8193
2022/10/11,10:00:00,604.76,2064,6264,8328
2022/10/11,10:30:00,604.12,2154,6273,8427
2022/10/11,11:00:00,574.08,2309,6226,8535
2022/10/11,11:30:00,605.73,2433,6165,8598
2022/10/11,12:00:00,605.08,2551,6161,8712
2022/10/11,12:30:00,604.12,2591,6214,8805
2022/10/11,13:00:00,604.12,2585,6341,8926
2022/10/11,13:30:00,605.08,2509,6505,9014
2022/10/11,14:00:00,604.44,2460,6683,9143
2022/10/11,14:30:00,604.12,2371,6889,9260
2022/10/11,15:00:00,605.73,2215,7079,9294
2022/10/11,15:30:00,604.44,1958,7277,9235
2022/10/11,16:00:00,603.48,1620,7474,9094
2022/10/11,16:30:00,604.44,1310,7889,9199
2022/10/11,17:00:00,604.12,911,8201,9112
2022/10/11,17:30:00,605.73,481,8444,8925
2022/10/11,18:00:00,605.08,355,8622,8977
2022/10/11,18:30:00,589.73,392,8903,9295
2022/10/11,19:00:00,589.73,146,8951,9097
2022/10/11,19:30:00,591.09,137,8851,8988
2022/10/11,20:00:00,502.45,136,8818,8954
2022/10/11,20:30:00,604.12,134,8724,8858
2022/10/11,21:00:00,604.12,88,8637,8725
2022/10/11,21:30:00,605.73,33,8470,8503
2022/10/11,22:00:00,605.73,33,8349,8382
2022/10/11,22:30:00,604.44,1,8221,8222
2022/10/11,23:00:00,604.76,0,7989,7989
2022/10/11,23:30:00,603.17,0,7735,7735
2022/10/12,00:00:00,603.17,0,7498,7498
2022/10/12,00:30:00,603.17,0,7277,7277
2022/10/12,01:00:00,573.24,5,7063,7068
2022/10/12,01:30:00,605.08,10,6875,6885
2022/10/12,02:00:00,603.8,9,6742,6751
2022/10/12,02:30:00,604.12,12,6628,6640
2022/10/12,03:00:00,604.76,12,6544,6556
2022/10/12,03:30:00,604.12,18,6487,6505
2022/10/12,04:00:00,604.44,23,6447,6470
2022/10/12,04:30:00,603.8,19,6478,6497
2022/10/12,05:00:00,585.58,22,6533,6555
2022/10/12,05:30:00,582.65,22,6655,6677
2022/10/12,06:00:00,583.61,22,6781,6803
2022/10/12,06:30:00,582.65,24,6867,6891
2022/10/12,07:00:00,582.89,21,6985,7006
2022/10/12,07:30:00,577.02,259,7051,7310
2022/10/12,08:00:00,565.94,665,6917,7582
2022/10/12,08:30:00,563.74,1023,6835,7858
2022/10/12,09:00:00,569.07,1413,6670,8083
2022/10/12,09:30:00,574.56,1786,6542,8328
2022/10/12,10:00:00,576.6,1960,6473,8433
2022/10/12,10:30:00,593.87,2047,6512,8559
2022/10/12,11:00:00,604.44,2314,6342,8656
2022/10/12,11:30:00,602.54,2427,6333,8760
2022/10/12,12:00:00,605.08,2528,6358,8886
2022/10/12,12:30:00,592.46,2487,6480,8967
2022/10/12,13:00:00,590.27,2438,6707,9145
2022/10/12,13:30:00,590.27,2391,6848,9239
2022/10/12,14:00:00,589.2,2279,6973,9252
2022/10/12,14:30:00,586.09,2125,7106,9231
2022/10/12,15:00:00,582.17,1948,7341,9289
2022/10/12,15:30:00,569.4,1721,7449,9170
2022/10/12,16:00:00,576.81,1377,7715,9092
2022/10/12,16:30:00,566.83,999,8048,9047
2022/10/12,17:00:00,559.7,719,8217,8936
2022/10/12,17:30:00,560.45,470,8392,8862
2022/10/12,18:00:00,560.65,606,8542,9148
2022/10/12,18:30:00,558.27,147,8893,9040
2022/10/12,19:00:00,558.27,145,8885,9030
2022/10/12,19:30:00,560.35,143,8839,8982
2022/10/12,20:00:00,561.06,145,8740,8885
2022/10/12,20:30:00,560.75,152,8601,8753
2022/10/12,21:00:00,560.95,112,8484,8596
2022/10/12,21:30:00,560.75,47,8430,8477
2022/10/12,22:00:00,560.26,50,8310,8360
2022/10/12,22:30:00,560.85,18,8155,8173
2022/10/12,23:00:00,561.48,15,7980,7995
2022/10/12,23:30:00,560.55,19,7706,7725
2022/10/13,00:00:00,565.22,24,7487,7511
2022/10/13,00:30:00,563.23,34,7257,7291
2022/10/13,01:00:00,563.11,47,7067,7114
2022/10/13,01:30:00,566.68,40,6914,6954
2022/10/13,02:00:00,567.29,22,6759,6781
2022/10/13,02:30:00,566.83,27,6665,6692
2022/10/13,03:00:00,566.83,21,6586,6607
2022/10/13,03:30:00,566.68,19,6535,6554
2022/10/13,04:00:00,567.14,21,6505,6526
2022/10/13,04:30:00,567.6,20,6515,6535
2022/10/13,05:00:00,567.29,28,6580,6608
2022/10/13,05:30:00,567.6,24,6726,6750
2022/10/13,06:00:00,569.07,22,6809,6831
2022/10/13,06:30:00,581.7,21,6938,6959
2022/10/13,07:00:00,588.15,12,7019,7031
2022/10/13,07:30:00,572.25,225,7186,7411
2022/10/13,08:00:00,584.59,569,7098,7667
2022/10/13,08:30:00,589.73,847,7062,7909
2022/10/13,09:00:00,596.17,1292,6795,8087
2022/10/13,09:30:00,572.2,1493,6880,8373
2022/10/13,10:00:00,603.17,1615,6947,8562
2022/10/13,10:30:00,604.44,1673,6921,8594
2022/10/13,11:00:00,587.88,1769,6881,8650
2022/10/13,11:30:00,581.24,1718,6878,8596
2022/10/13,12:00:00,579.42,1891,6832,8723
2022/10/13,12:30:00,581.47,2088,6638,8726
2022/10/13,13:00:00,587.88,1951,6790,8741
2022/10/13,13:30:00,589.73,1950,6766,8716
2022/10/13,14:00:00,589.73,1864,6872,8736
2022/10/13,14:30:00,589.47,1972,6864,8836
2022/10/13,15:00:00,589.73,1954,6944,8898
2022/10/13,15:30:00,589.73,1667,7098,8765
2022/10/13,16:00:00,589.2,1417,7361,8778
2022/10/13,16:30:00,589.73,1123,7708,8831
2022/10/13,17:00:00,583.37,865,7970,8835
2022/10/13,17:30:00,583.37,493,8210,8703
2022/10/13,18:00:00,582.65,615,8410,9025
2022/10/13,18:30:00,583.13,121,8775,8896
2022/10/13,19:00:00,583.13,93,8810,8903
2022/10/13,19:30:00,582.17,106,8716,8822
2022/10/13,20:00:00,573.58,101,8615,8716
2022/10/13,20:30:00,562.27,62,8523,8585
2022/10/13,21:00:00,558.34,49,8408,8457
2022/10/13,21:30:00,558.48,59,8229,8288
2022/10/13,22:00:00,558.27,53,8123,8176
2022/10/13,22:30:00,560.55,45,7994,8039
2022/10/13,23:00:00,564.53,33,7811,7844
2022/10/13,23:30:00,564.8,36,7609,7645
2022/10/14,00:00:00,565.5,39,7369,7408
2022/10/14,00:30:00,576.39,36,7149,7185
2022/10/14,01:00:00,572.06,32,6965,6997
2022/10/14,01:30:00,576.6,27,6799,6826
2022/10/14,02:00:00,584.84,30,6671,6701
2022/10/14,02:30:00,598.84,25,6538,6563
2022/10/14,03:00:00,602.54,22,6425,6447
2022/10/14,03:30:00,602.54,25,6343,6368
2022/10/14,04:00:00,601.6,24,6314,6338
2022/10/14,04:30:00,600.98,19,6333,6352
2022/10/14,05:00:00,600.67,20,6342,6362
2022/10/14,05:30:00,603.17,23,6433,6456
2022/10/14,06:00:00,603.17,27,6511,6538
2022/10/14,06:30:00,603.48,21,6509,6530
2022/10/14,07:00:00,604.76,22,6451,6473
2022/10/14,07:30:00,605.73,233,6440,6673
2022/10/14,08:00:00,575.37,649,6294,6943
2022/10/14,08:30:00,604.12,979,6148,7127
2022/10/14,09:00:00,573.03,1317,6027,7344
2022/10/14,09:30:00,603.17,1603,5956,7559
2022/10/14,10:00:00,604.44,1715,5907,7622
2022/10/14,10:30:00,603.8,1918,5898,7816
2022/10/14,11:00:00,603.8,2000,5940,7940
2022/10/14,11:30:00,605.08,2144,5856,8000
2022/10/14,12:00:00,604.12,2210,5836,8046
2022/10/14,12:30:00,605.73,2179,5911,8090
2022/10/14,13:00:00,605.08,2109,6014,8123
2022/10/14,13:30:00,602.54,1922,6148,8070
2022/10/14,14:00:00,605.73,2062,6113,8175
2022/10/14,14:30:00,605.41,2155,6107,8262
2022/10/14,15:00:00,604.76,1927,6396,8323
2022/10/14,15:30:00,597.65,1818,6473,8291
2022/10/14,16:00:00,594.44,1470,6820,8290
2022/10/14,16:30:00,582.17,1182,7194,8376
2022/10/14,17:00:00,574.56,866,7631,8497
2022/10/14,17:30:00,569.91,463,8056,8519
2022/10/14,18:00:00,572.43,369,8117,8486
2022/10/14,18:30:00,573.58,175,8330,8505
2022/10/14,19:00:00,574.16,186,8293,8479
2022/10/14,19:30:00,574.36,175,8125,8300
2022/10/14,20:00:00,588.15,170,7952,8122
2022/10/14,20:30:00,602.54,132,7849,7981
2022/10/14,21:00:00,593.59,124,7736,7860
2022/10/14,21:30:00,593.02,124,7616,7740
2022/10/14,22:00:00,592.74,121,7492,7613
2022/10/14,22:30:00,592.74,114,7386,7500
2022/10/14,23:00:00,592.46,112,7192,7304
2022/10/14,23:30:00,593.3,34,7140,7174
2022/10/15,00:00:00,593.3,15,6959,6974
2022/10/15,00:30:00,592.74,9,6799,6808
2022/10/15,01:00:00,605.73,9,6648,6657
2022/10/15,01:30:00,603.17,13,6499,6512
2022/10/15,02:00:00,605.08,21,6393,6414
2022/10/15,02:30:00,604.12,16,6305,6321
2022/10/15,03:00:00,604.76,20,6233,6253
2022/10/15,03:30:00,603.48,16,6199,6215
2022/10/15,04:00:00,603.17,10,6183,6193
2022/10/15,04:30:00,603.17,6,6154,6160
2022/10/15,05:00:00,603.17,7,6166,6173
2022/10/15,05:30:00,603.8,3,6257,6260
2022/10/15,06:00:00,603.8,2,6280,6282
2022/10/15,06:30:00,603.17,1,6252,6253
2022/10/15,07:00:00,604.12,0,6103,6103
2022/10/15,07:30:00,604.76,215,6011,6226
2022/10/15,08:00:00,603.17,619,5800,6419
2022/10/15,08:30:00,603.48,1016,5512,6528
2022/10/15,09:00:00,602.54,1377,5315,6692
2022/10/15,09:30:00,573.24,1782,5055,6837
2022/10/15,10:00:00,602.54,2051,4984,7035
2022/10/15,10:30:00,503.42,2256,4913,7169
2022/10/15,11:00:00,503.92,2383,4858,7241
2022/10/15,11:30:00,503.92,2461,4817,7278
2022/10/15,12:00:00,503.92,2550,4807,7357
2022/10/15,12:30:00,503.92,2594,4856,7450
2022/10/15,13:00:00,503.42,2593,4937,7530
2022/10/15,13:30:00,503.42,2496,5061,7557
2022/10/15,14:00:00,573.45,2462,5169,7631
2022/10/15,14:30:00,604.44,2351,5343,7694
2022/10/15,15:00:00,603.17,2206,5546,7752
2022/10/15,15:30:00,605.41,1905,5853,7758
2022/10/15,16:00:00,603.8,1543,6189,7732
2022/10/15,16:30:00,594.15,1237,6680,7917
2022/10/15,17:00:00,578.97,818,7125,7943
2022/10/15,17:30:00,567.92,422,7453,7875
2022/10/15,18:00:00,568.9,506,7718,8224
2022/10/15,18:30:00,568.9,148,8055,8203
2022/10/15,19:00:00,571.51,147,8153,8300
2022/10/15,19:30:00,575.77,144,8234,8378
2022/10/15,20:00:00,573.58,142,8223,8365
2022/10/15,20:30:00,573.58,144,8155,8299
2022/10/15,21:00:00,574.16,143,8074,8217
2022/10/15,21:30:00,571.88,111,8046,8157
2022/10/15,22:00:00,564.53,102,7947,8049
2022/10/15,22:30:00,564.26,55,7862,7917
2022/10/15,23:00:00,568.08,14,7705,7719
2022/10/15,23:30:00,568.73,19,7466,7485
2022/10/16,00:00:00,568.08,18,7243,7261
2022/10/16,00:30:00,575.98,22,7025,7047
2022/10/16,01:00:00,590.27,29,6831,6860
2022/10/16,01:30:00,603.8,30,6682,6712
2022/10/16,02:00:00,602.54,29,6528,6557
2022/10/16,02:30:00,604.76,30,6407,6437
2022/10/16,03:00:00,604.76,27,6305,6332
2022/10/16,03:30:00,603.8,25,6267,6292
2022/10/16,04:00:00,603.48,34,6230,6264
2022/10/16,04:30:00,603.17,30,6251,6281
2022/10/16,05:00:00,603.17,36,6263,6299
2022/10/16,05:30:00,604.44,46,6375,6421
2022/10/16,06:00:00,603.17,50,6445,6495
2022/10/16,06:30:00,605.08,54,6515,6569
2022/10/16,07:00:00,604.12,69,6507,6576
2022/10/16,07:30:00,574.08,294,6498,6792
2022/10/16,08:00:00,603.48,710,6392,7102
2022/10/16,08:30:00,603.17,1128,6229,7357
2022/10/16,09:00:00,506.51,1497,6094,7591
2022/10/16,09:30:00,600.98,1834,5976,7810
2022/10/16,10:00:00,603.8,2073,5967,8040
2022/10/16,10:30:00,603.17,2295,5899,8194
2022/10/16,11:00:00,603.48,2438,5918,8356
2022/10/16,11:30:00,603.17,2502,5987,8489
2022/10/16,12:00:00,602.54,2586,6054,8640
2022/10/16,12:30:00,603.17,2582,6117,8699
2022/10/16,13:00:00,603.17,2543,6208,8751
2022/10/16,13:30:00,587.11,2483,6361,8844
2022/10/16,14:00:00,582.89,2416,6592,9008
2022/10/16,14:30:00,579.64,2261,6782,9043
2022/10/16,15:00:00,573,2098,6930,9028
2022/10/16,15:30:00,574.16,1913,7075,8988
2022/10/16,16:00:00,564.26,1501,7412,8913
2022/10/16,16:30:00,2304.95,1124,7923,9047
2022/10/16,17:00:00,2304.95,696,8364,9060
2022/10/16,17:30:00,2414.62,382,8691,9073
2022/10/16,18:00:00,2414.62,537,8668,9205
2022/10/16,18:30:00,2440.78,150,8818,8968
2022/10/16,19:00:00,2440.78,148,8685,8833
2022/10/16,19:30:00,2440.78,144,8496,8640
2022/10/16,20:00:00,2440.78,94,8395,8489
2022/10/16,20:30:00,2440.78,0,8337,8337
2022/10/16,21:00:00,2440.78,0,8181,8181
2022/10/16,21:30:00,2440.78,0,8039,8039
2022/10/16,22:00:00,2468.12,0,7877,7877
2022/10/16,22:30:00,2030.6,0,7731,7731
2022/10/16,23:00:00,556.54,0,7562,7562
2022/10/16,23:30:00,558.86,0,7387,7387
2022/10/17,00:00:00,562.86,0,7187,7187
2022/10/17,00:30:00,562.15,0,7007,7007
2022/10/17,01:00:00,562.04,0,6807,6807
2022/10/17,01:30:00,568.57,0,6681,6681
2022/10/17,02:00:00,568.57,0,6546,6546
2022/10/17,02:30:00,568.41,0,6451,6451
2022/10/17,03:00:00,569.07,0,6358,6358
2022/10/17,03:30:00,568.57,0,6318,6318
2022/10/17,04:00:00,569.57,0,6285,6285
2022/10/17,04:30:00,568.9,0,6302,6302
2022/10/17,05:00:00,579.42,1,6333,6334
2022/10/17,05:30:00,577.24,3,6378,6381
2022/10/17,06:00:00,591.36,6,6413,6419
2022/10/17,06:30:00,605.08,2,6459,6461
2022/10/17,07:00:00,603.17,0,6363,6363
2022/10/17,07:30:00,591.36,160,6282,6442
2022/10/17,08:00:00,590,537,6069,6606
2022/10/17,08:30:00,604.12,941,5892,6833
2022/10/17,09:00:00,604.76,1284,5645,6929
2022/10/17,09:30:00,506.51,1671,5436,7107
2022/10/17,10:00:00,573.87,1979,5235,7214
2022/10/17,10:30:00,505.98,2243,5173,7416
2022/10/17,11:00:00,505.98,2402,5124,7526
2022/10/17,11:30:00,506.51,2466,5089,7555
2022/10/17,12:00:00,506.51,2549,5155,7704
2022/10/17,12:30:00,603.17,2562,5183,7745
2022/10/17,13:00:00,602.54,2549,5266,7815
2022/10/17,13:30:00,603.17,2485,5385,7870
2022/10/17,14:00:00,604.44,2401,5503,7904
2022/10/17,14:30:00,603.17,2304,5635,7939
2022/10/17,15:00:00,603.17,2084,5869,7953
2022/10/17,15:30:00,603.48,1909,6076,7985
2022/10/17,16:00:00,604.12,1581,6407,7988
2022/10/17,16:30:00,603.8,1262,6799,8061
2022/10/17,17:00:00,595.88,833,7283,8116
2022/10/17,17:30:00,589.73,411,7589,8000
2022/10/17,18:00:00,590,509,7853,8362
2022/10/17,18:30:00,582.41,68,8266,8334
2022/10/17,19:00:00,579.42,60,8358,8418
2022/10/17,19:30:00,580.32,59,8445,8504
2022/10/17,20:00:00,577.66,52,8449,8501
2022/10/17,20:30:00,565.65,43,8376,8419
2022/10/17,21:00:00,564.26,41,8294,8335
2022/10/17,21:30:00,564.26,3,8257,8260
2022/10/17,22:00:00,561.37,3,8106,8109
2022/10/17,22:30:00,558.48,0,7962,7962
2022/10/17,23:00:00,557.93,0,7727,7727
2022/10/17,23:30:00,557.74,0,7499,7499
2022/10/18,00:00:00,557.8,4,7264,7268
2022/10/18,00:30:00,557.74,2,7045,7047
2022/10/18,01:00:00,560.35,2,6834,6836
2022/10/18,01:30:00,560.07,6,6693,6699
2022/10/18,02:00:00,561.06,9,6531,6540
2022/10/18,02:30:00,564.8,19,6406,6425
2022/10/18,03:00:00,566.53,16,6329,6345
2022/10/18,03:30:00,569.91,20,6264,6284
2022/10/18,04:00:00,571.88,15,6246,6261
2022/10/18,04:30:00,570.44,12,6270,6282
2022/10/18,05:00:00,566.68,10,6359,6369
2022/10/18,05:30:00,560.55,7,6541,6548
2022/10/18,06:00:00,560.07,5,6718,6723
2022/10/18,06:30:00,558.94,5,6963,6968
2022/10/18,07:00:00,560.07,7,7079,7086
2022/10/18,07:30:00,565.08,207,7255,7462
2022/10/18,08:00:00,567.76,586,7189,7775
2022/10/18,08:30:00,569.07,932,7151,8083
2022/10/18,09:00:00,567.45,1277,6991,8268
2022/10/18,09:30:00,567.6,1600,6917,8517
2022/10/18,10:00:00,564.53,1777,6981,8758
2022/10/18,10:30:00,561.16,1571,7099,8670
2022/10/18,11:00:00,560.85,1780,7092,8872
2022/10/18,11:30:00,562.04,1802,7048,8850
2022/10/18,12:00:00,562.86,1862,7051,8913
2022/10/18,12:30:00,562.27,1936,7044,8980
2022/10/18,13:00:00,564.26,2019,7143,9162
2022/10/18,13:30:00,561.27,1993,7284,9277
2022/10/18,14:00:00,560.95,1838,7478,9316
2022/10/18,14:30:00,558.27,1763,7657,9420
2022/10/18,15:00:00,556.35,1700,7746,9446
2022/10/18,15:30:00,556.54,1688,7846,9534
2022/10/18,16:00:00,556.54,1434,8055,9489
2022/10/18,16:30:00,556.44,1077,8373,9450
2022/10/18,17:00:00,3278.45,736,8607,9343
2022/10/18,17:30:00,3109.28,342,8838,9180
2022/10/18,18:00:00,2468.12,137,8985,9122
2022/10/18,18:30:00,2468.12,147,9280,9427
2022/10/18,19:00:00,2440.78,145,9264,9409
2022/10/18,19:30:00,2414.62,144,9193,9337
2022/10/18,20:00:00,1975.31,144,9057,9201
2022/10/18,20:30:00,2163.5,144,8956,9100
2022/10/18,21:00:00,2163.5,143,8793,8936
2022/10/18,21:30:00,2147.59,141,8658,8799
2022/10/18,22:00:00,2171.44,140,8385,8525
2022/10/18,22:30:00,2295.27,105,8201,8306
2022/10/18,23:00:00,2414.62,105,7883,7988
2022/10/18,23:30:00,2468.12,105,7592,7697
2022/10/19,00:00:00,560.85,73,7348,7421
2022/10/19,00:30:00,559.97,4,7185,7189
2022/10/19,01:00:00,559.61,2,6956,6958
2022/10/19,01:30:00,559.88,1,6767,6768
2022/10/19,02:00:00,561.27,3,6625,6628
2022/10/19,02:30:00,564.67,1,6509,6510
2022/10/19,03:00:00,569.91,1,6402,6403
2022/10/19,03:30:00,572.06,0,6348,6348
2022/10/19,04:00:00,573.58,3,6315,6318
2022/10/19,04:30:00,573.19,1,6361,6362
2022/10/19,05:00:00,569.07,0,6453,6453
2022/10/19,05:30:00,564.13,0,6632,6632
2022/10/19,06:00:00,568.08,0,6764,6764
2022/10/19,06:30:00,568.57,0,7023,7023
2022/10/19,07:00:00,568.08,0,7213,7213
2022/10/19,07:30:00,569.07,168,7346,7514
2022/10/19,08:00:00,568.9,540,7198,7738
2022/10/19,08:30:00,573,890,7110,8000
2022/10/19,09:00:00,596.46,1259,6912,8171
2022/10/19,09:30:00,605.08,1647,6712,8359
2022/10/19,10:00:00,602.54,1811,6600,8411
2022/10/19,10:30:00,603.17,2007,6513,8520
2022/10/19,11:00:00,604.12,2106,6459,8565
2022/10/19,11:30:00,602.54,2154,6436,8590
2022/10/19,12:00:00,602.54,2141,6493,8634
2022/10/19,12:30:00,602.54,2139,6583,8722
2022/10/19,13:00:00,604.44,2122,6704,8826
2022/10/19,13:30:00,597.94,1970,6976,8946
2022/10/19,14:00:00,581.24,1834,7238,9072
2022/10/19,14:30:00,568.41,1703,7462,9165
2022/10/19,15:00:00,568.57,1525,7602,9127
2022/10/19,15:30:00,567.76,1414,7862,9276
2022/10/19,16:00:00,568.08,1363,7913,9276
2022/10/19,16:30:00,568.41,1155,8096,9251
2022/10/19,17:00:00,562.62,787,8422,9209
2022/10/19,17:30:00,2282.53,369,8659,9028
2022/10/19,18:00:00,2389.6,152,8842,8994
2022/10/19,18:30:00,2301.36,166,9148,9314
2022/10/19,19:00:00,2304.95,164,9143,9307
2022/10/19,19:30:00,2414.62,164,9107,9271
2022/10/19,20:00:00,2304.95,158,9008,9166
2022/10/19,20:30:00,2282.53,147,8932,9079
2022/10/19,21:00:00,556.47,54,8843,8897
2022/10/19,21:30:00,557.62,37,8676,8713
2022/10/19,22:00:00,557.56,27,8445,8472
2022/10/19,22:30:00,557.68,13,8227,8240
2022/10/19,23:00:00,561.7,16,7962,7978
2022/10/19,23:30:00,560.75,21,7657,7678
2022/10/20,00:00:00,573.97,22,7354,7376
2022/10/20,00:30:00,575.57,24,7076,7100
2022/10/20,01:00:00,575.57,34,6827,6861
2022/10/20,01:30:00,576.18,35,6650,6685
2022/10/20,02:00:00,575.57,36,6511,6547
2022/10/20,02:30:00,575.98,46,6388,6434
2022/10/20,03:00:00,575.77,48,6316,6364
2022/10/20,03:30:00,574.96,55,6251,6306
2022/10/20,04:00:00,574.36,58,6240,6298
2022/10/20,04:30:00,575.16,67,6273,6340
2022/10/20,05:00:00,574.76,75,6395,6470
2022/10/20,05:30:00,574.76,83,6585,6668
2022/10/20,06:00:00,574.36,73,6714,6787
2022/10/20,06:30:00,566.23,53,6986,7039
2022/10/20,07:00:00,562.15,46,7141,7187
2022/10/20,07:30:00,558.34,208,7345,7553
2022/10/20,08:00:00,568.73,550,7232,7782
2022/10/20,08:30:00,569.07,935,7108,8043
2022/10/20,09:00:00,570.09,1285,6973,8258
2022/10/20,09:30:00,582.65,1651,6799,8450
2022/10/20,10:00:00,595.59,1892,6697,8589
2022/10/20,10:30:00,604.44,2059,6755,8814
2022/10/20,11:00:00,604.12,2065,6719,8784
2022/10/20,11:30:00,604.44,2075,6729,8804
2022/10/20,12:00:00,574.08,2115,6768,8883
2022/10/20,12:30:00,598.84,2048,6755,8803
2022/10/20,13:00:00,600.67,2166,6738,8904
2022/10/20,13:30:00,599.45,2157,6825,8982
2022/10/20,14:00:00,599.45,2170,6947,9117
2022/10/20,14:30:00,598.84,2059,7143,9202
2022/10/20,15:00:00,598.24,1952,7272,9224
2022/10/20,15:30:00,587.62,1693,7499,9192
2022/10/20,16:00:00,582.41,1222,7922,9144
2022/10/20,16:30:00,578.97,893,8246,9139
2022/10/20,17:00:00,568.73,489,8519,9008
2022/10/20,17:30:00,569.07,338,8639,8977
2022/10/20,18:00:00,568.24,167,8780,8947
2022/10/20,18:30:00,563.48,160,9087,9247
2022/10/20,19:00:00,565.94,157,9080,9237
2022/10/20,19:30:00,566.68,162,8983,9145
2022/10/20,20:00:00,566.83,174,8813,8987
2022/10/20,20:30:00,567.14,177,8720,8897
2022/10/20,21:00:00,566.08,186,8546,8732
2022/10/20,21:30:00,578.53,55,8478,8533
2022/10/20,22:00:00,585.33,43,8323,8366
2022/10/20,22:30:00,582.89,8,8172,8180
2022/10/20,23:00:00,582.89,15,7947,7962
2022/10/20,23:30:00,602.54,10,7681,7691
2022/10/21,00:00:00,604.44,22,7444,7466
2022/10/21,00:30:00,605.73,15,7161,7176
2022/10/21,01:00:00,603.48,13,6953,6966
2022/10/21,01:30:00,603.17,9,6831,6840
2022/10/21,02:00:00,604.44,6,6665,6671
2022/10/21,02:30:00,604.12,5,6541,6546
2022/10/21,03:00:00,604.76,5,6439,6444
2022/10/21,03:30:00,573.66,12,6320,6332
2022/10/21,04:00:00,603.8,17,6288,6305
2022/10/21,04:30:00,604.44,16,6318,6334
2022/10/21,05:00:00,604.12,10,6302,6312
2022/10/21,05:30:00,604.44,5,6430,6435
2022/10/21,06:00:00,604.76,4,6535,6539
2022/10/21,06:30:00,603.8,8,6620,6628
2022/10/21,07:00:00,604.12,5,6673,6678
2022/10/21,07:30:00,604.44,3,6938,6941
2022/10/21,08:00:00,602.54,177,7007,7184
2022/10/21,08:30:00,602.22,312,7165,7477
2022/10/21,09:00:00,603.8,425,7119,7544
2022/10/21,09:30:00,601.6,929,6953,7882
2022/10/21,10:00:00,602.54,979,6912,7891
2022/10/21,10:30:00,603.17,1061,6914,7975
2022/10/21,11:00:00,599.45,1066,6863,7929
2022/10/21,11:30:00,599.15,1143,6872,8015
2022/10/21,12:00:00,603.17,1163,6732,7895
2022/10/21,12:30:00,603.17,1524,6551,8075
2022/10/21,13:00:00,602.22,1616,6449,8065
2022/10/21,13:30:00,603.17,1668,6536,8204
2022/10/21,14:00:00,605.73,1657,6524,8181
2022/10/21,14:30:00,603.17,1874,6408,8282
2022/10/21,15:00:00,501.97,1777,6543,8320
2022/10/21,15:30:00,604.44,1637,6732,8369
2022/10/21,16:00:00,604.76,1325,7083,8408
2022/10/21,16:30:00,604.12,973,7472,8445
2022/10/21,17:00:00,603.17,653,7920,8573
2022/10/21,17:30:00,592.46,280,8233,8513
2022/10/21,18:00:00,589.47,47,8333,8380
2022/10/21,18:30:00,583.85,46,8525,8571
2022/10/21,19:00:00,583.61,43,8457,8500
2022/10/21,19:30:00,591.63,41,8292,8333
2022/10/21,20:00:00,602.54,43,8122,8165
2022/10/21,20:30:00,600.98,12,8032,8044
2022/10/21,21:00:00,602.22,12,7834,7846
2022/10/21,21:30:00,601.91,10,7726,7736
2022/10/21,22:00:00,604.12,16,7551,7567
2022/10/21,22:30:00,603.8,39,7396,7435
2022/10/21,23:00:00,603.17,34,7259,7293
2022/10/21,23:30:00,605.73,29,7073,7102
2022/10/22,00:00:00,573.24,48,6888,6936
2022/10/22,00:30:00,605.08,28,6734,6762
2022/10/22,01:00:00,605.73,35,6590,6625
2022/10/22,01:30:00,604.76,36,6470,6506
2022/10/22,02:00:00,605.08,52,6339,6391
2022/10/22,02:30:00,604.12,49,6257,6306
2022/10/22,03:00:00,604.76,36,6158,6194
2022/10/22,03:30:00,604.12,24,6132,6156
2022/10/22,04:00:00,605.08,29,6085,6114
2022/10/22,04:30:00,605.73,15,6080,6095
2022/10/22,05:00:00,605.08,3,6133,6136
2022/10/22,05:30:00,605.08,5,6176,6181
2022/10/22,06:00:00,604.76,13,6228,6241
2022/10/22,06:30:00,605.73,26,6220,6246
2022/10/22,07:00:00,605.08,20,6083,6103
2022/10/22,07:30:00,605.73,134,6043,6177
2022/10/22,08:00:00,604.76,409,5916,6325
2022/10/22,08:30:00,604.12,760,5833,6593
2022/10/22,09:00:00,605.73,1096,5609,6705
2022/10/22,09:30:00,604.76,1373,5433,6806
2022/10/22,10:00:00,605.08,1651,5230,6881
2022/10/22,10:30:00,602.54,1893,5128,7021
2022/10/22,11:00:00,603.17,2034,5062,7096
2022/10/22,11:30:00,605.08,2102,5028,7130
2022/10/22,12:00:00,605.08,2131,5014,7145
2022/10/22,12:30:00,605.08,2145,5027,7172
2022/10/22,13:00:00,604.76,2095,5056,7151
2022/10/22,13:30:00,502.93,2080,5111,7191
2022/10/22,14:00:00,605.08,2033,5232,7265
2022/10/22,14:30:00,604.12,1935,5370,7305
2022/10/22,15:00:00,603.17,1848,5587,7435
2022/10/22,15:30:00,603.17,1613,5877,7490
2022/10/22,16:00:00,605.08,1299,6251,7550
2022/10/22,16:30:00,604.76,1028,6659,7687
2022/10/22,17:00:00,604.12,681,7066,7747
2022/10/22,17:30:00,605.08,259,7448,7707
2022/10/22,18:00:00,605.08,51,7750,7801
2022/10/22,18:30:00,593.59,45,8148,8193
2022/10/22,19:00:00,603.8,40,8272,8312
2022/10/22,19:30:00,603.48,40,8354,8394
2022/10/22,20:00:00,603.17,35,8265,8300
2022/10/22,20:30:00,602.85,32,8204,8236
2022/10/22,21:00:00,603.17,36,8066,8102
2022/10/22,21:30:00,604.12,2,8016,8018
2022/10/22,22:00:00,603.17,2,7879,7881
2022/10/22,22:30:00,604.12,1,7707,7708
2022/10/22,23:00:00,604.12,8,7454,7462
2022/10/22,23:30:00,603.8,13,7182,7195
2022/10/23,00:00:00,603.17,14,6935,6949
2022/10/23,00:30:00,602.54,30,6703,6733
2022/10/23,01:00:00,603.48,27,6454,6481
2022/10/23,01:30:00,603.17,28,6286,6314
2022/10/23,02:00:00,604.76,37,6094,6131
2022/10/23,02:30:00,603.8,39,6029,6068
2022/10/23,03:00:00,604.76,36,5920,5956
2022/10/23,03:30:00,604.44,29,5893,5922
2022/10/23,04:00:00,603.17,33,5871,5904
2022/10/23,04:30:00,604.12,40,5925,5965
2022/10/23,05:00:00,602.54,42,6033,6075
2022/10/23,05:30:00,603.17,57,6203,6260
2022/10/23,06:00:00,603.48,79,6350,6429
2022/10/23,06:30:00,605.08,76,6681,6757
2022/10/23,07:00:00,603.17,73,6892,6965
2022/10/23,07:30:00,591.09,233,7129,7362
2022/10/23,08:00:00,589.2,504,7042,7546
2022/10/23,08:30:00,503.92,917,6889,7806
2022/10/23,09:00:00,604.76,1315,6640,7955
2022/10/23,09:30:00,605.08,1621,6450,8071
2022/10/23,10:00:00,505.98,1921,6329,8250
2022/10/23,10:30:00,503.42,2142,6168,8310
2022/10/23,11:00:00,500.87,2314,6076,8390
2022/10/23,11:30:00,499.48,2379,6128,8507
2022/10/23,12:00:00,498.81,2305,6291,8596
2022/10/23,12:30:00,506.51,2184,6442,8626
2022/10/23,13:00:00,592.46,2088,6699,8787
2022/10/23,13:30:00,592.46,1884,7039,8923
2022/10/23,14:00:00,604.44,1792,7306,9098
2022/10/23,14:30:00,605.08,1692,7406,9098
2022/10/23,15:00:00,605.73,1392,7537,8929
2022/10/23,15:30:00,573.45,1357,7648,9005
2022/10/23,16:00:00,605.41,1155,7833,8988
2022/10/23,16:30:00,605.08,959,7955,8914
2022/10/23,17:00:00,592.19,673,8177,8850
2022/10/23,17:30:00,571.69,311,8424,8735
2022/10/23,18:00:00,568.73,118,8641,8759
2022/10/23,18:30:00,561.81,133,8886,9019
2022/10/23,19:00:00,562.15,142,8862,9004
2022/10/23,19:30:00,567.45,119,8796,8915
2022/10/23,20:00:00,568.24,64,8668,8732
2022/10/23,20:30:00,568.41,44,8587,8631
2022/10/23,21:00:00,580.09,12,8442,8454
2022/10/23,21:30:00,600.98,8,8240,8248
2022/10/23,22:00:00,601.6,9,7989,7998
2022/10/23,22:30:00,603.17,32,7706,7738
2022/10/23,23:00:00,602.54,69,7399,7468
2022/10/23,23:30:00,603.48,59,7111,7170
2022/10/24,00:00:00,605.08,50,6807,6857
2022/10/24,00:30:00,605.08,41,6614,6655
2022/10/24,01:00:00,605.08,45,6389,6434
2022/10/24,01:30:00,605.08,55,6230,6285
2022/10/24,02:00:00,605.08,47,6072,6119
2022/10/24,02:30:00,574.94,47,5982,6029
2022/10/24,03:00:00,605.73,42,5918,5960
2022/10/24,03:30:00,605.08,46,5865,5911
2022/10/24,04:00:00,604.76,40,5906,5946
2022/10/24,04:30:00,605.08,39,5959,5998
2022/10/24,05:00:00,605.08,34,6068,6102
2022/10/24,05:30:00,604.76,34,6292,6326
2022/10/24,06:00:00,595.88,35,6487,6522
2022/10/24,06:30:00,595.59,44,6805,6849
2022/10/24,07:00:00,600.98,54,6991,7045
2022/10/24,07:30:00,603.17,225,7093,7318
2022/10/24,08:00:00,602.22,618,6890,7508
2022/10/24,08:30:00,601.91,951,6833,7784
2022/10/24,09:00:00,601.91,1275,6561,7836
2022/10/24,09:30:00,601.6,1707,6288,7995
2022/10/24,10:00:00,602.54,1976,6093,8069
2022/10/24,10:30:00,600.36,2138,6077,8215
2022/10/24,11:00:00,601.91,2103,6127,8230
2022/10/24,11:30:00,600.67,2017,6160,8177
2022/10/24,12:00:00,601.29,2203,6095,8298
2022/10/24,12:30:00,600.98,1998,6303,8301
2022/10/24,13:00:00,601.6,2025,6363,8388
2022/10/24,13:30:00,602.54,1966,6464,8430
2022/10/24,14:00:00,601.91,2048,6599,8647
2022/10/24,14:30:00,600.98,1876,6790,8666
2022/10/24,15:00:00,601.91,1797,6891,8688
2022/10/24,15:30:00,603.17,1692,7123,8815
2022/10/24,16:00:00,602.54,1379,7454,8833
2022/10/24,16:30:00,602.22,1027,7830,8857
2022/10/24,17:00:00,600.67,648,8165,8813
2022/10/24,17:30:00,589.73,265,8478,8743
2022/10/24,18:00:00,581.7,25,8812,8837
2022/10/24,18:30:00,564.53,35,9082,9117
2022/10/24,19:00:00,562.27,43,9038,9081
2022/10/24,19:30:00,564.26,46,8950,8996
2022/10/24,20:00:00,573,50,8822,8872
2022/10/24,20:30:00,574.56,49,8694,8743
2022/10/24,21:00:00,578.53,56,8548,8604
2022/10/24,21:30:00,602.54,62,8325,8387
2022/10/24,22:00:00,597.05,66,8121,8187
2022/10/24,22:30:00,602.54,59,7867,7926
2022/10/24,23:00:00,605.08,59,7578,7637
2022/10/24,23:30:00,603.17,52,7293,7345
2022/10/25,00:00:00,602.54,71,6980,7051
2022/10/25,00:30:00,603.8,69,6711,6780
2022/10/25,01:00:00,605.73,65,6501,6566
2022/10/25,01:30:00,603.48,65,6328,6393
2022/10/25,02:00:00,602.54,71,6225,6296
2022/10/25,02:30:00,603.17,68,6086,6154
2022/10/25,03:00:00,603.17,66,6039,6105
2022/10/25,03:30:00,602.54,69,5955,6024
2022/10/25,04:00:00,602.54,74,5973,6047
2022/10/25,04:30:00,602.54,91,5993,6084
2022/10/25,05:00:00,602.54,95,6108,6203
2022/10/25,05:30:00,603.17,96,6327,6423
2022/10/25,06:00:00,603.17,97,6489,6586
2022/10/25,06:30:00,605.73,91,6844,6935
2022/10/25,07:00:00,602.54,84,7050,7134
2022/10/25,07:30:00,590,259,7226,7485
2022/10/25,08:00:00,591.63,502,7085,7587
2022/10/25,08:30:00,603.8,823,6999,7822
2022/10/25,09:00:00,604.12,1223,6813,8036
2022/10/25,09:30:00,603.17,1405,6739,8144
2022/10/25,10:00:00,505.98,1639,6485,8124
2022/10/25,10:30:00,604.44,1921,6488,8409
2022/10/25,11:00:00,603.17,2095,6492,8587
2022/10/25,11:30:00,605.08,2327,6359,8686
2022/10/25,12:00:00,505.98,2390,6246,8636
2022/10/25,12:30:00,605.08,2399,6180,8579
2022/10/25,13:00:00,505.98,2447,6121,8568
2022/10/25,13:30:00,603.8,2286,6585,8871
2022/10/25,14:00:00,602.54,1864,7164,9028
2022/10/25,14:30:00,595.3,1633,7238,8871
2022/10/25,15:00:00,605.73,1794,7129,8923
2022/10/25,15:30:00,599.75,1729,7231,8960
2022/10/25,16:00:00,596.17,1373,7599,8972
2022/10/25,16:30:00,596.17,996,8032,9028
2022/10/25,17:00:00,595.88,592,8336,8928
2022/10/25,17:30:00,595.88,267,8675,8942
2022/10/25,18:00:00,592.74,67,8991,9058
2022/10/25,18:30:00,587.11,74,9233,9307
2022/10/25,19:00:00,586.85,75,9221,9296
2022/10/25,19:30:00,585.58,83,9110,9193
2022/10/25,20:00:00,586.09,84,8976,9060
2022/10/25,20:30:00,587.62,77,8858,8935
2022/10/25,21:00:00,587.62,58,8724,8782
2022/10/25,21:30:00,604.76,53,8522,8575
2022/10/25,22:00:00,603.8,37,8327,8364
2022/10/25,22:30:00,603.17,38,8056,8094
2022/10/25,23:00:00,604.76,26,7787,7813
2022/10/25,23:30:00,603.17,23,7520,7543
2022/10/26,00:00:00,602.54,13,7236,7249
2022/10/26,00:30:00,605.73,13,6984,6997
2022/10/26,01:00:00,605.08,31,6754,6785
2022/10/26,01:30:00,603.17,68,6522,6590
2022/10/26,02:00:00,603.48,69,6397,6466
2022/10/26,02:30:00,604.12,71,6296,6367
2022/10/26,03:00:00,604.76,60,6220,6280
2022/10/26,03:30:00,604.12,46,6184,6230
2022/10/26,04:00:00,603.48,48,6155,6203
2022/10/26,04:30:00,603.17,43,6222,6265
2022/10/26,05:00:00,604.12,30,6327,6357
2022/10/26,05:30:00,605.08,23,6562,6585
2022/10/26,06:00:00,604.12,17,6775,6792
2022/10/26,06:30:00,603.17,48,7087,7135
2022/10/26,07:00:00,603.8,52,7296,7348
2022/10/26,07:30:00,591.91,49,7551,7600
2022/10/26,08:00:00,590,371,7511,7882
2022/10/26,08:30:00,597.35,596,7511,8107
2022/10/26,09:00:00,600.06,909,7315,8224
2022/10/26,09:30:00,604.44,1286,7092,8378
2022/10/26,10:00:00,605.08,1502,6859,8361
2022/10/26,10:30:00,605.73,1731,6743,8474
2022/10/26,11:00:00,605.08,1909,6648,8557
2022/10/26,11:30:00,603.8,1994,6692,8686
2022/10/26,12:00:00,605.73,1990,6641,8631
2022/10/26,12:30:00,603.48,1820,6808,8628
2022/10/26,13:00:00,603.48,1793,6865,8658
2022/10/26,13:30:00,603.17,1863,6852,8715
2022/10/26,14:00:00,604.44,1679,7118,8797
2022/10/26,14:30:00,603.8,1706,7230,8936
2022/10/26,15:00:00,605.08,1546,7286,8832
2022/10/26,15:30:00,601.29,1372,7653,9025
2022/10/26,16:00:00,602.54,1080,7900,8980
2022/10/26,16:30:00,602.22,802,8138,8940
2022/10/26,17:00:00,594.44,514,8349,8863
2022/10/26,17:30:00,572.82,332,8551,8883
2022/10/26,18:00:00,572.2,145,8881,9026
2022/10/26,18:30:00,561.7,107,9232,9339
2022/10/26,19:00:00,560.62,67,9236,9303
2022/10/26,19:30:00,562.17,82,9130,9212
2022/10/26,20:00:00,573.45,66,9000,9066
2022/10/26,20:30:00,571.99,77,8818,8895
2022/10/26,21:00:00,573.03,68,8598,8666
2022/10/26,21:30:00,586.85,61,8403,8464
2022/10/26,22:00:00,600.98,57,8177,8234
2022/10/26,22:30:00,604.12,22,7968,7990
2022/10/26,23:00:00,604.76,30,7688,7718
2022/10/26,23:30:00,604.76,35,7388,7423
2022/10/27,00:00:00,505.98,40,7083,7123
2022/10/27,00:30:00,603.17,39,6811,6850
2022/10/27,01:00:00,605.08,56,6560,6616
2022/10/27,01:30:00,603.17,57,6402,6459
2022/10/27,02:00:00,604.12,54,6264,6318
2022/10/27,02:30:00,602.54,34,6181,6215
2022/10/27,03:00:00,604.44,40,6104,6144
2022/10/27,03:30:00,603.17,38,6048,6086
2022/10/27,04:00:00,603.17,42,6065,6107
2022/10/27,04:30:00,603.17,35,6125,6160
2022/10/27,05:00:00,602.54,25,6245,6270
2022/10/27,05:30:00,603.48,24,6494,6518
2022/10/27,06:00:00,505.45,25,6615,6640
2022/10/27,06:30:00,603.17,23,6969,6992
2022/10/27,07:00:00,602.54,21,7209,7230
2022/10/27,07:30:00,603.8,30,7373,7403
2022/10/27,08:00:00,603.17,415,7282,7697
2022/10/27,08:30:00,604.76,754,7126,7880
2022/10/27,09:00:00,603.48,1026,6949,7975
2022/10/27,09:30:00,605.08,1431,6754,8185
2022/10/27,10:00:00,602.54,1731,6569,8300
2022/10/27,10:30:00,605.41,2000,6390,8390
2022/10/27,11:00:00,602.54,2247,6235,8482
2022/10/27,11:30:00,603.17,2273,6261,8534
2022/10/27,12:00:00,605.73,2261,6288,8549
2022/10/27,12:30:00,602.54,2341,6409,8750
2022/10/27,13:00:00,602.54,2257,6569,8826
2022/10/27,13:30:00,603.17,2111,6784,8895
2022/10/27,14:00:00,605.73,1984,6838,8822
2022/10/27,14:30:00,605.73,2037,6968,9005
2022/10/27,15:00:00,602.54,1819,7214,9033
2022/10/27,15:30:00,605.08,1577,7465,9042
2022/10/27,16:00:00,604.76,1280,7730,9010
2022/10/27,16:30:00,604.76,1003,8040,9043
2022/10/27,17:00:00,603.8,596,8393,8989
2022/10/27,17:30:00,604.76,286,8583,8869
2022/10/27,18:00:00,603.17,139,8903,9042
2022/10/27,18:30:00,589.47,140,9162,9302
2022/10/27,19:00:00,596.46,139,9107,9246
2022/10/27,19:30:00,604.44,126,9004,9130
2022/10/27,20:00:00,604.76,78,8912,8990
2022/10/27,20:30:00,605.73,39,8789,8828
2022/10/27,21:00:00,603.8,42,8644,8686
2022/10/27,21:30:00,604.12,45,8476,8521
2022/10/27,22:00:00,603.8,43,8275,8318
2022/10/27,22:30:00,604.12,14,8034,8048
2022/10/27,23:00:00,574.08,17,7808,7825
2022/10/27,23:30:00,604.12,23,7577,7600
2022/10/28,00:00:00,605.08,27,7221,7248
2022/10/28,00:30:00,605.08,23,6998,7021
2022/10/28,01:00:00,603.8,19,6806,6825
2022/10/28,01:30:00,604.12,19,6626,6645
2022/10/28,02:00:00,605.08,16,6434,6450
2022/10/28,02:30:00,603.17,13,6370,6383
2022/10/28,03:00:00,597.94,11,6264,6275
2022/10/28,03:30:00,596.76,15,6177,6192
2022/10/28,04:00:00,600.67,17,6123,6140
2022/10/28,04:30:00,600.67,16,6137,6153
2022/10/28,05:00:00,597.35,19,6220,6239
2022/10/28,05:30:00,597.94,22,6356,6378
2022/10/28,06:00:00,599.75,20,6489,6509
2022/10/28,06:30:00,602.22,20,6594,6614
2022/10/28,07:00:00,604.12,28,6544,6572
2022/10/28,07:30:00,602.54,153,6708,6861
2022/10/28,08:00:00,605.08,469,6514,6983
2022/10/28,08:30:00,600.98,860,6361,7221
2022/10/28,09:00:00,601.29,1207,6156,7363
2022/10/28,09:30:00,603.8,1576,5992,7568
2022/10/28,10:00:00,605.08,1847,5757,7604
2022/10/28,10:30:00,605.41,2134,5662,7796
2022/10/28,11:00:00,602.54,2305,5570,7875
2022/10/28,11:30:00,604.76,2361,5542,7903
2022/10/28,12:00:00,603.17,2455,5506,7961
2022/10/28,12:30:00,603.17,2437,5568,8005
2022/10/28,13:00:00,604.12,2432,5580,8012
2022/10/28,13:30:00,603.17,2328,5762,8090
2022/10/28,14:00:00,603.48,2223,5897,8120
2022/10/28,14:30:00,604.12,2111,6036,8147
2022/10/28,15:00:00,603.8,1872,6243,8115
2022/10/28,15:30:00,604.12,1577,6538,8115
2022/10/28,16:00:00,602.54,1264,6912,8176
2022/10/28,16:30:00,592.19,873,7500,8373
2022/10/28,17:00:00,592.46,533,7967,8500
2022/10/28,17:30:00,592.46,239,8254,8493
2022/10/28,18:00:00,592.19,41,8456,8497
2022/10/28,18:30:00,590.27,40,8594,8634
2022/10/28,19:00:00,594.15,34,8506,8540
2022/10/28,19:30:00,597.94,33,8309,8342
2022/10/28,20:00:00,596.17,33,8096,8129
2022/10/28,20:30:00,596.17,0,7976,7976
2022/10/28,21:00:00,598.84,0,7878,7878
2022/10/28,21:30:00,604.12,1,7743,7744
2022/10/28,22:00:00,604.76,3,7592,7595
2022/10/28,22:30:00,603.17,5,7418,7423
2022/10/28,23:00:00,605.73,3,7258,7261
2022/10/28,23:30:00,602.22,4,7060,7064
2022/10/29,00:00:00,603.17,5,6830,6835
2022/10/29,00:30:00,602.22,5,6725,6730
2022/10/29,01:00:00,605.41,7,6526,6533
2022/10/29,01:30:00,604.44,8,6415,6423
2022/10/29,02:00:00,604.44,8,6262,6270
2022/10/29,02:30:00,603.8,8,6186,6194
2022/10/29,03:00:00,605.08,11,6067,6078
2022/10/29,03:30:00,605.08,16,6008,6024
2022/10/29,04:00:00,603.8,21,6033,6054
2022/10/29,04:30:00,604.12,26,6028,6054
2022/10/29,05:00:00,604.76,39,6041,6080
2022/10/29,05:30:00,603.48,38,6077,6115
2022/10/29,06:00:00,601.29,34,6107,6141
2022/10/29,06:30:00,603.17,42,6121,6163
2022/10/29,07:00:00,605.08,37,5951,5988
2022/10/29,07:30:00,604.12,154,5917,6071
2022/10/29,08:00:00,605.08,425,5768,6193
2022/10/29,08:30:00,605.08,780,5588,6368
2022/10/29,09:00:00,605.08,1155,5363,6518
2022/10/29,09:30:00,605.08,1407,5216,6623
2022/10/29,10:00:00,604.12,1717,5033,6750
2022/10/29,10:30:00,604.12,2008,4897,6905
2022/10/29,11:00:00,603.8,2228,4782,7010
2022/10/29,11:30:00,603.48,2365,4732,7097
2022/10/29,12:00:00,604.44,2441,4673,7114
2022/10/29,12:30:00,502.45,2467,4757,7224
2022/10/29,13:00:00,502.93,2433,4838,7271
2022/10/29,13:30:00,502.45,2420,4920,7340
2022/10/29,14:00:00,604.76,2295,5143,7438
2022/10/29,14:30:00,605.41,2171,5327,7498
2022/10/29,15:00:00,605.08,1966,5542,7508
2022/10/29,15:30:00,601.91,1698,5885,7583
2022/10/29,16:00:00,602.54,1322,6328,7650
2022/10/29,16:30:00,604.44,964,6830,7794
2022/10/29,17:00:00,604.12,524,7279,7803
2022/10/29,17:30:00,605.08,208,7563,7771
2022/10/29,18:00:00,603.17,50,7920,7970
2022/10/29,18:30:00,587.88,56,8206,8262
2022/10/29,19:00:00,588.41,54,8310,8364
2022/10/29,19:30:00,580.32,14,8406,8420
2022/10/29,20:00:00,579.64,11,8353,8364
2022/10/29,20:30:00,580.55,15,8249,8264
2022/10/29,21:00:00,603.17,23,8204,8227
2022/10/29,21:30:00,604.12,33,8074,8107
2022/10/29,22:00:00,605.73,38,7916,7954
2022/10/29,22:30:00,604.44,35,7693,7728
2022/10/29,23:00:00,604.12,43,7475,7518
2022/10/29,23:30:00,605.08,34,7265,7299
2022/10/30,00:00:00,604.12,28,7030,7057
2022/10/30,00:30:00,602.54,38,6759,6797
2022/10/30,01:00:00,604.44,85,6503,6588
2022/10/30,01:00:00,604.44,89,6156,6245
2022/10/30,01:30:00,602.54,94,6327,6421
2022/10/30,01:30:00,602.54,78,6129,6207
2022/10/30,02:00:00,603.8,58,6061,6119
2022/10/30,02:30:00,603.8,74,5993,6067
2022/10/30,03:00:00,605.08,78,5884,5963
2022/10/30,03:30:00,603.48,77,5895,5973
2022/10/30,04:00:00,603.8,85,5905,5990
2022/10/30,04:30:00,604.12,87,6007,6094
2022/10/30,05:00:00,604.12,85,6154,6240
2022/10/30,05:30:00,603.17,86,6344,6430
2022/10/30,06:00:00,605.08,94,6368,6462
2022/10/30,06:30:00,603.8,96,6612,6708
2022/10/30,07:00:00,605.08,259,6748,7007
2022/10/30,07:30:00,604.12,501,6874,7374
2022/10/30,08:00:00,605.73,826,6772,7598
2022/10/30,08:30:00,604.76,1149,6714,7862
2022/10/30,09:00:00,590,1342,6637,7978
2022/10/30,09:30:00,579.87,1572,6811,8383
2022/10/30,10:00:00,572.81,1663,6692,8354
2022/10/30,10:30:00,572.25,1761,6768,8529
2022/10/30,11:00:00,569.91,1956,6840,8796
2022/10/30,11:30:00,572.62,1942,6809,8750
2022/10/30,12:00:00,575.77,2086,6844,8930
2022/10/30,12:30:00,581.01,1935,6940,8874
2022/10/30,13:00:00,589.73,1894,7148,9042
2022/10/30,13:30:00,588.67,1761,7398,9159
2022/10/30,14:00:00,588.67,1415,7681,9095
2022/10/30,14:30:00,575.77,1346,7974,9320
2022/10/30,15:00:00,586.85,1091,8219,9310
2022/10/30,15:30:00,568.9,778,8530,9307
2022/10/30,16:00:00,568.57,479,8646,9125
2022/10/30,16:30:00,578.31,333,8831,9165
2022/10/30,17:00:00,577.66,128,9074,9202
2022/10/30,17:30:00,572.25,132,9273,9405
2022/10/30,18:00:00,577.45,135,9240,9375
2022/10/30,18:30:00,573.97,140,9142,9282
2022/10/30,19:00:00,591.09,104,9049,9154
2022/10/30,19:30:00,598.84,41,9049,9090
2022/10/30,20:00:00,606.06,42,8881,8923
2022/10/30,20:30:00,603.48,42,8736,8778
2022/10/30,21:00:00,605.73,39,8578,8617
2022/10/30,21:30:00,604.12,42,8435,8477
2022/10/30,22:00:00,603.8,39,8176,8215
2022/10/30,22:30:00,604.12,10,7961,7971
2022/10/30,23:00:00,604.12,11,7678,7689
2022/10/30,23:30:00,605.08,10,7397,7407
2022/10/31,00:00:00,603.8,8,7082,7090
2022/10/31,00:30:00,573.87,10,6831,6841
2022/10/31,01:00:00,505.98,10,6618,6628
2022/10/31,01:30:00,602.54,5,6492,6497
2022/10/31,02:00:00,605.08,13,6381,6394
2022/10/31,02:30:00,604.44,21,6271,6292
2022/10/31,03:00:00,604.76,15,6181,6196
2022/10/31,03:30:00,505.45,17,6202,6219
2022/10/31,04:00:00,602.54,13,6248,6261
2022/10/31,04:30:00,605.73,20,6348,6368
2022/10/31,05:00:00,605.73,21,6447,6468
2022/10/31,05:30:00,602.54,17,6575,6592
2022/10/31,06:00:00,603.48,22,6649,6671
2022/10/31,06:30:00,603.17,28,6857,6885
2022/10/31,07:00:00,506.51,407,6886,7293
2022/10/31,07:30:00,605.08,844,6835,7679
2022/10/31,08:00:00,603.8,1135,6640,7775
2022/10/31,08:30:00,505.98,1477,6574,8051
2022/10/31,09:00:00,501.04,1845,6392,8237
2022/10/31,09:30:00,602.22,2069,6428,8497
2022/10/31,10:00:00,600.67,1901,6590,8491
2022/10/31,10:30:00,601.91,1919,6605,8524
2022/10/31,11:00:00,501.04,2021,6536,8557
2022/10/31,11:30:00,602.54,2037,6562,8599
2022/10/31,12:00:00,602.54,1971,6600,8571
2022/10/31,12:30:00,603.48,1943,6614,8557
2022/10/31,13:00:00,603.48,1929,6850,8779
2022/10/31,13:30:00,604.76,1845,6964,8809
2022/10/31,14:00:00,605.08,1631,7219,8850
2022/10/31,14:30:00,604.12,1416,7466,8882
2022/10/31,15:00:00,603.17,1117,7821,8938
2022/10/31,15:30:00,605.08,846,8080,8926
2022/10/31,16:00:00,604.12,574,8282,8856
2022/10/31,16:30:00,603.17,332,8465,8797
2022/10/31,17:00:00,604.76,216,8765,8981
2022/10/31,17:30:00,605.08,214,8925,9139
2022/10/31,18:00:00,604.12,222,8859,9081
2022/10/31,18:30:00,604.76,211,8781,8992
2022/10/31,19:00:00,605.08,204,8628,8832
2022/10/31,19:30:00,605.73,145,8628,8773
2022/10/31,20:00:00,605.08,92,8529,8621
2022/10/31,20:30:00,602.54,83,8365,8448
2022/10/31,21:00:00,605.08,74,8217,8291
2022/10/31,21:30:00,605.73,73,8055,8128
2022/10/31,22:00:00,603.8,69,7840,7909
2022/10/31,22:30:00,603.48,41,7651,7692
2022/10/31,23:00:00,605.73,42,7414,7456
2022/10/31,23:30:00,604.12,44,7168,7212
2022/11/01,00:00:00,536.82,48,6863,6911
2022/11/01,00:30:00,538.48,44,6639,6683
2022/11/01,01:00:00,534.2,45,6473,6518
2022/11/01,01:30:00,535.22,37,6341,6378
2022/11/01,02:00:00,535.75,33,6177,6210
2022/11/01,02:30:00,534.71,37,6089,6126
2022/11/01,03:00:00,534.71,34,6022,6056
2022/11/01,03:30:00,535.75,33,5970,6003
2022/11/01,04:00:00,535.75,34,5984,6018
2022/11/01,04:30:00,534.71,30,6069,6099
2022/11/01,05:00:00,534.71,32,6137,6169
2022/11/01,05:30:00,534.71,34,6222,6256
2022/11/01,06:00:00,535.22,29,6048,6077
2022/11/01,06:30:00,535.75,40,6030,6070
2022/11/01,07:00:00,535.22,450,5808,6258
2022/11/01,07:30:00,537.92,851,5673,6524
2022/11/01,08:00:00,538.48,1220,5490,6710
2022/11/01,08:30:00,537.92,1439,5455,6894
2022/11/01,09:00:00,537.92,1701,5464,7165
2022/11/01,09:30:00,539.05,1835,5524,7359
2022/11/01,10:00:00,537.92,1743,5645,7388
2022/11/01,10:30:00,539.05,1853,5600,7453
2022/11/01,11:00:00,538.48,1924,5504,7428
2022/11/01,11:30:00,537.92,2087,5465,7552
2022/11/01,12:00:00,537.92,1929,5542,7471
2022/11/01,12:30:00,537.92,1761,5690,7451
2022/11/01,13:00:00,537.92,1909,5662,7571
2022/11/01,13:30:00,537.92,1857,5822,7679
2022/11/01,14:00:00,538.48,1757,5973,7730
2022/11/01,14:30:00,538.48,1543,6161,7704
2022/11/01,15:00:00,539.05,1298,6424,7722
2022/11/01,15:30:00,537.36,996,6751,7747
2022/11/01,16:00:00,537.36,657,7110,7767
2022/11/01,16:30:00,537.36,307,7408,7715
2022/11/01,17:00:00,537.36,189,7853,8042
2022/11/01,17:30:00,537.92,143,8153,8296
2022/11/01,18:00:00,536.82,65,8250,8315
2022/11/01,18:30:00,537.92,55,8274,8329
2022/11/01,19:00:00,537.36,52,8251,8303
2022/11/01,19:30:00,536.82,54,8186,8240
2022/11/01,20:00:00,536.82,52,8073,8125
2022/11/01,20:30:00,536.82,42,7981,8023
2022/11/01,21:00:00,536.82,39,7849,7888
2022/11/01,21:30:00,537.36,6,7723,7729
2022/11/01,22:00:00,536.82,6,7537,7543
2022/11/01,22:30:00,537.36,6,7322,7328
2022/11/01,23:00:00,537.36,6,7095,7101
2022/11/01,23:30:00,537.36,4,6856,6860
2022/11/02,00:00:00,537.92,0,6588,6588
2022/11/02,00:30:00,538.48,0,6341,6341
2022/11/02,01:00:00,445.26,1,6172,6173
2022/11/02,01:30:00,445.77,2,6023,6025
2022/11/02,02:00:00,332.15,0,5905,5905
2022/11/02,02:30:00,331.98,2,5831,5833
2022/11/02,03:00:00,331.98,8,5755,5763
2022/11/02,03:30:00,332.15,10,5771,5781
2022/11/02,04:00:00,331.98,16,5753,5769
2022/11/02,04:30:00,331.98,12,5900,5912
2022/11/02,05:00:00,536.82,13,6006,6019
2022/11/02,05:30:00,536.82,9,6206,6215
2022/11/02,06:00:00,537.36,3,6214,6217
2022/11/02,06:30:00,537.36,210,6397,6607
2022/11/02,07:00:00,536.82,481,6398,6879
2022/11/02,07:30:00,538.48,819,6281,7100
2022/11/02,08:00:00,536.82,1236,6068,7304
2022/11/02,08:30:00,536.28,1630,5904,7534
2022/11/02,09:00:00,537.92,1936,5803,7739
2022/11/02,09:30:00,536.82,2048,5897,7945
2022/11/02,10:00:00,537.36,1964,6021,7985
2022/11/02,10:30:00,537.36,1845,6067,7912
2022/11/02,11:00:00,537.36,1820,6101,7921
2022/11/02,11:30:00,536.82,1936,6106,8042
2022/11/02,12:00:00,534.71,1919,6106,8025
2022/11/02,12:30:00,537.36,2078,6155,8233
2022/11/02,13:00:00,534.71,1908,6321,8229
2022/11/02,13:30:00,535.22,1813,6423,8236
2022/11/02,14:00:00,536.28,1626,6622,8248
2022/11/02,14:30:00,536.28,1473,6886,8359
2022/11/02,15:00:00,535.22,1287,7079,8366
2022/11/02,15:30:00,535.22,1057,7426,8483
2022/11/02,16:00:00,527.01,695,7780,8475
2022/11/02,16:30:00,526.49,342,8142,8484
2022/11/02,17:00:00,527.54,197,8529,8726
2022/11/02,17:30:00,527.01,203,8690,8893
2022/11/02,18:00:00,526.49,155,8750,8905
2022/11/02,18:30:00,527.54,119,8708,8827
2022/11/02,19:00:00,527.01,82,8653,8735
2022/11/02,19:30:00,527.54,77,8600,8677
2022/11/02,20:00:00,527.01,65,8423,8488
2022/11/02,20:30:00,528.08,64,8292,8356
2022/11/02,21:00:00,538.48,53,8133,8186
2022/11/02,21:30:00,539.62,24,7963,7987
2022/11/02,22:00:00,539.05,21,7789,7810
2022/11/02,22:30:00,539.05,19,7532,7551
2022/11/02,23:00:00,539.05,14,7269,7283
2022/11/02,23:30:00,538.48,9,6972,6981
2022/11/03,00:00:00,539.05,10,6690,6700
2022/11/03,00:30:00,539.05,13,6402,6415
2022/11/03,01:00:00,538.48,12,6229,6241
2022/11/03,01:30:00,539.62,5,6084,6089
2022/11/03,02:00:00,539.62,2,5975,5977
2022/11/03,02:30:00,539.05,0,5873,5873
2022/11/03,03:00:00,539.05,0,5846,5846
2022/11/03,03:30:00,539.62,0,5845,5845
2022/11/03,04:00:00,539.62,0,5887,5887
2022/11/03,04:30:00,539.05,0,5975,5975
2022/11/03,05:00:00,539.62,0,6088,6088
2022/11/03,05:30:00,538.48,0,6266,6266
2022/11/03,06:00:00,539.62,0,6336,6336
2022/11/03,06:30:00,539.62,16,6468,6484
2022/11/03,07:00:00,539.62,456,6483,6939
2022/11/03,07:30:00,539.62,918,6324,7242
2022/11/03,08:00:00,539.62,1342,6020,7362
2022/11/03,08:30:00,539.05,1688,5876,7564
2022/11/03,09:00:00,539.62,1985,5736,7721
2022/11/03,09:30:00,539.62,2225,5680,7905
2022/11/03,10:00:00,539.62,2353,5690,8043
2022/11/03,10:30:00,539.05,2341,5736,8077
2022/11/03,11:00:00,537.92,2374,5751,8125
2022/11/03,11:30:00,539.05,2211,5899,8110
2022/11/03,12:00:00,538.48,2221,5948,8169
2022/11/03,12:30:00,538.48,2305,6053,8358
2022/11/03,13:00:00,538.48,2157,6181,8338
2022/11/03,13:30:00,538.48,2006,6416,8422
2022/11/03,14:00:00,538.48,1849,6678,8527
2022/11/03,14:30:00,538.48,1573,6957,8530
2022/11/03,15:00:00,537.36,1317,7277,8594
2022/11/03,15:30:00,536.82,1000,7644,8644
2022/11/03,16:00:00,537.36,599,7909,8508
2022/11/03,16:30:00,537.36,336,8193,8529
2022/11/03,17:00:00,536.82,190,8560,8750
2022/11/03,17:30:00,537.36,194,8708,8902
2022/11/03,18:00:00,537.36,193,8694,8887
2022/11/03,18:30:00,536.82,192,8648,8840
2022/11/03,19:00:00,537.92,184,8557,8741
2022/11/03,19:30:00,537.92,184,8467,8651
2022/11/03,20:00:00,537.92,176,8360,8536
2022/11/03,20:30:00,536.82,110,8264,8374
2022/11/03,21:00:00,537.36,59,8146,8205
2022/11/03,21:30:00,537.36,53,7978,8031
2022/11/03,22:00:00,537.36,49,7784,7833
2022/11/03,22:30:00,537.92,18,7626,7644
2022/11/03,23:00:00,536.82,19,7355,7374
2022/11/03,23:30:00,539.05,18,7062,7080
2022/11/04,00:00:00,536.82,16,6790,6806
2022/11/04,00:30:00,536.82,15,6576,6591
2022/11/04,01:00:00,537.36,14,6327,6341
2022/11/04,01:30:00,537.92,12,6208,6220
2022/11/04,02:00:00,536.82,11,6090,6101
2022/11/04,02:30:00,536.82,11,5946,5957
2022/11/04,03:00:00,537.92,12,5934,5946
2022/11/04,03:30:00,539.05,12,5799,5811
2022/11/04,04:00:00,536.82,11,5864,5875
2022/11/04,04:30:00,537.92,11,5921,5932
2022/11/04,05:00:00,537.36,11,6028,6039
2022/11/04,05:30:00,537.92,9,6116,6125
2022/11/04,06:00:00,537.36,5,6050,6055
2022/11/04,06:30:00,537.36,13,6024,6037
2022/11/04,07:00:00,537.36,459,5858,6317
2022/11/04,07:30:00,537.36,893,5678,6571
2022/11/04,08:00:00,536.82,1278,5441,6719
2022/11/04,08:30:00,539.05,1685,5146,6831
2022/11/04,09:00:00,537.36,1977,5034,7011
2022/11/04,09:30:00,537.36,2199,4983,7182
2022/11/04,10:00:00,537.36,2320,4901,7221
2022/11/04,10:30:00,538.48,2425,4944,7369
2022/11/04,11:00:00,537.92,2508,4986,7494
2022/11/04,11:30:00,537.92,2471,5033,7504
2022/11/04,12:00:00,538.48,2490,5009,7499
2022/11/04,12:30:00,537.36,2439,5086,7525
2022/11/04,13:00:00,537.36,2381,5210,7591
2022/11/04,13:30:00,538.48,2240,5398,7638
2022/11/04,14:00:00,536.82,2054,5630,7684
2022/11/04,14:30:00,537.36,1630,6022,7652
2022/11/04,15:00:00,538.48,1171,6453,7624
2022/11/04,15:30:00,536.28,825,6966,7791
2022/11/04,16:00:00,534.71,403,7380,7783
2022/11/04,16:30:00,537.36,198,7591,7789
2022/11/04,17:00:00,537.36,43,7851,7894
2022/11/04,17:30:00,536.82,39,7995,8034
2022/11/04,18:00:00,537.36,34,7949,7983
2022/11/04,18:30:00,536.82,33,7849,7882
2022/11/04,19:00:00,535.22,34,7686,7720
2022/11/04,19:30:00,537.36,33,7513,7546
2022/11/04,20:00:00,537.36,32,7357,7389
2022/11/04,20:30:00,537.36,3,7270,7273
2022/11/04,21:00:00,536.82,1,7163,7164
2022/11/04,21:30:00,538.48,0,7033,7033
2022/11/04,22:00:00,536.82,0,6961,6961
2022/11/04,22:30:00,537.36,0,6777,6777
2022/11/04,23:00:00,537.36,0,6607,6607
2022/11/04,23:30:00,536.82,0,6409,6409
2022/11/05,00:00:00,537.36,0,6211,6211
2022/11/05,00:30:00,539.05,0,6087,6087
2022/11/05,01:00:00,536.82,0,5957,5957
2022/11/05,01:30:00,537.92,0,5869,5869
2022/11/05,02:00:00,536.82,0,5806,5806
2022/11/05,02:30:00,537.36,0,5761,5761
2022/11/05,03:00:00,536.28,0,5708,5708
2022/11/05,03:30:00,537.36,0,5675,5675
2022/11/05,04:00:00,534.71,2,5695,5697
2022/11/05,04:30:00,536.82,4,5677,5681
2022/11/05,05:00:00,537.92,5,5761,5766
2022/11/05,05:30:00,535.75,9,5792,5801
2022/11/05,06:00:00,535.22,12,5669,5681
2022/11/05,06:30:00,531.3,23,5555,5578
2022/11/05,07:00:00,531.3,423,5276,5699
2022/11/05,07:30:00,531.3,888,5009,5897
2022/11/05,08:00:00,537.92,1278,4625,5903
2022/11/05,08:30:00,537.36,1617,4442,6059
2022/11/05,09:00:00,331.98,1935,4243,6178
2022/11/05,09:30:00,332.15,2216,4162,6378
2022/11/05,10:00:00,331.98,2342,4083,6425
2022/11/05,10:30:00,332.07,2402,4029,6431
2022/11/05,11:00:00,331.98,2479,4045,6524
2022/11/05,11:30:00,331.9,2499,4021,6520
2022/11/05,12:00:00,332.07,2479,4112,6591
2022/11/05,12:30:00,331.98,2403,4223,6626
2022/11/05,13:00:00,331.98,2343,4385,6728
2022/11/05,13:30:00,536.82,2186,4564,6750
2022/11/05,14:00:00,536.28,1989,4856,6845
2022/11/05,14:30:00,537.36,1691,5201,6892
2022/11/05,15:00:00,537.36,1330,5579,6909
2022/11/05,15:30:00,536.82,941,6100,7041
2022/11/05,16:00:00,537.36,480,6572,7052
2022/11/05,16:30:00,537.36,88,6966,7054
2022/11/05,17:00:00,535.75,77,7433,7510
2022/11/05,17:30:00,537.36,48,7729,7777
2022/11/05,18:00:00,536.82,49,7883,7932
2022/11/05,18:30:00,536.28,46,7966,8012
2022/11/05,19:00:00,536.82,48,7915,7963
2022/11/05,19:30:00,536.82,46,7865,7911
2022/11/05,20:00:00,537.36,49,7777,7826
2022/11/05,20:30:00,536.82,50,7651,7701
2022/11/05,21:00:00,536.28,69,7493,7562
2022/11/05,21:30:00,535.75,32,7472,7504
2022/11/05,22:00:00,536.82,31,7277,7308
2022/11/05,22:30:00,536.28,28,7032,7060
2022/11/05,23:00:00,536.28,30,6808,6838
2022/11/05,23:30:00,535.75,34,6547,6581
2022/11/06,00:00:00,538.48,52,6267,6319
2022/11/06,00:30:00,534.2,52,6058,6110
2022/11/06,01:00:00,534.2,64,5914,5978
2022/11/06,01:30:00,534.2,69,5713,5782
2022/11/06,02:00:00,535.75,58,5607,5665
2022/11/06,02:30:00,533.7,38,5636,5674
2022/11/06,03:00:00,534.71,40,5517,5557
2022/11/06,03:30:00,534.2,52,5535,5587
2022/11/06,04:00:00,534.2,51,5555,5606
2022/11/06,04:30:00,534.2,53,5690,5743
2022/11/06,05:00:00,534.71,51,5788,5839
2022/11/06,05:30:00,534.2,49,5966,6015
2022/11/06,06:00:00,533.7,40,6073,6113
2022/11/06,06:30:00,535.22,56,6258,6314
2022/11/06,07:00:00,535.22,334,6419,6753
2022/11/06,07:30:00,534.71,740,6314,7054
2022/11/06,08:00:00,535.22,1161,6132,7293
2022/11/06,08:30:00,537.36,1445,6071,7516
2022/11/06,09:00:00,537.36,1588,5951,7539
2022/11/06,09:30:00,535.75,1790,5984,7774
2022/11/06,10:00:00,538.48,1961,5864,7825
2022/11/06,10:30:00,538.48,1889,5887,7776
2022/11/06,11:00:00,535.75,1977,5849,7826
2022/11/06,11:30:00,534.2,2107,5733,7840
2022/11/06,12:00:00,537.92,2193,5673,7866
2022/11/06,12:30:00,537.92,2303,5744,8047
2022/11/06,13:00:00,537.36,2195,5909,8104
2022/11/06,13:30:00,537.36,2098,6058,8156
2022/11/06,14:00:00,538.48,1924,6203,8127
2022/11/06,14:30:00,536.82,1656,6999,8655
2022/11/06,15:00:00,536.28,1343,7284,8627
2022/11/06,15:30:00,536.82,898,7702,8600
2022/11/06,16:00:00,535.22,500,7999,8499
2022/11/06,16:30:00,536.82,130,8317,8447
2022/11/06,17:00:00,533.7,149,8657,8806
2022/11/06,17:30:00,537.92,154,8809,8963
2022/11/06,18:00:00,536.82,154,8802,8956
2022/11/06,18:30:00,536.82,154,8782,8936
2022/11/06,19:00:00,535.75,153,8672,8825
2022/11/06,19:30:00,536.28,153,8578,8731
2022/11/06,20:00:00,536.82,158,8439,8597
2022/11/06,20:30:00,537.36,151,8322,8473
2022/11/06,21:00:00,537.36,111,8152,8263
2022/11/06,21:30:00,537.92,35,8092,8127
2022/11/06,22:00:00,537.92,33,7751,7784
2022/11/06,22:30:00,537.92,3,7559,7562
2022/11/06,23:00:00,537.92,3,7290,7293
2022/11/06,23:30:00,537.92,3,6963,6966
2022/11/07,00:00:00,536.82,5,6697,6702
2022/11/07,00:30:00,537.36,6,6420,6426
2022/11/07,01:00:00,537.92,3,6210,6213
2022/11/07,01:30:00,538.48,3,6098,6101
2022/11/07,02:00:00,537.92,4,5951,5955
2022/11/07,02:30:00,537.92,3,5938,5941
2022/11/07,03:00:00,537.92,7,5875,5882
2022/11/07,03:30:00,537.36,4,5859,5863
2022/11/07,04:00:00,539.05,4,5871,5875
2022/11/07,04:30:00,526.49,4,6001,6005
2022/11/07,05:00:00,525.97,2,6151,6153
2022/11/07,05:30:00,537.92,4,6327,6331
2022/11/07,06:00:00,537.92,2,6389,6391
2022/11/07,06:30:00,537.92,8,6583,6591
2022/11/07,07:00:00,539.05,266,6762,7028
2022/11/07,07:30:00,539.05,610,6678,7288
2022/11/07,08:00:00,540.21,1061,6419,7480
2022/11/07,08:30:00,540.21,1439,6264,7703
2022/11/07,09:00:00,539.05,1811,6129,7940
2022/11/07,09:30:00,537.36,1978,6076,8054
2022/11/07,10:00:00,536.28,1976,6083,8059
2022/11/07,10:30:00,536.28,1949,6074,8023
2022/11/07,11:00:00,537.92,2087,5914,8001
2022/11/07,11:30:00,537.36,2108,5733,7841
2022/11/07,12:00:00,539.05,2209,5664,7873
2022/11/07,12:30:00,537.36,2214,5626,7840
2022/11/07,13:00:00,539.05,2261,5699,7960
2022/11/07,13:30:00,538.48,2186,5888,8074
2022/11/07,14:00:00,539.05,1959,6190,8149
2022/11/07,14:30:00,538.48,1708,6556,8264
2022/11/07,15:00:00,537.92,1406,6880,8286
2022/11/07,15:30:00,534.71,1039,7316,8355
2022/11/07,16:00:00,514.88,596,7666,8262
2022/11/07,16:30:00,515.19,144,8048,8192
2022/11/07,17:00:00,511.47,175,8459,8634
2022/11/07,17:30:00,511.47,175,8629,8804
2022/11/07,18:00:00,511.54,168,8690,8858
2022/11/07,18:30:00,512.71,157,8637,8794
2022/11/07,19:00:00,512.79,142,8577,8719
2022/11/07,19:30:00,512.79,143,8505,8648
2022/11/07,20:00:00,516.6,141,8401,8542
2022/11/07,20:30:00,536.82,113,8265,8378
2022/11/07,21:00:00,535.75,34,8148,8182
2022/11/07,21:30:00,536.28,32,7912,7944
2022/11/07,22:00:00,536.28,31,7656,7687
2022/11/07,22:30:00,536.28,1,7416,7417
2022/11/07,23:00:00,536.28,6,7135,7141
2022/11/07,23:30:00,537.92,1,6797,6798
2022/11/08,00:00:00,536.28,0,6579,6579
2022/11/08,00:30:00,534.71,0,6332,6332
2022/11/08,01:00:00,535.75,6,6050,6056
2022/11/08,01:30:00,537.92,17,5922,5939
2022/11/08,02:00:00,529.18,12,5808,5820
2022/11/08,02:30:00,528.62,24,5679,5703
2022/11/08,03:00:00,529.74,15,5649,5664
2022/11/08,03:30:00,530.31,9,5638,5647
2022/11/08,04:00:00,528.62,7,5700,5707
2022/11/08,04:30:00,530.31,3,5772,5775
2022/11/08,05:00:00,528.62,1,5871,5872
2022/11/08,05:30:00,537.36,0,6155,6155
2022/11/08,06:00:00,527.54,4,6274,6278
2022/11/08,06:30:00,536.82,130,6467,6597
2022/11/08,07:00:00,539.05,387,6584,6971
2022/11/08,07:30:00,539.05,677,6614,7291
2022/11/08,08:00:00,538.48,920,6314,7234
2022/11/08,08:30:00,537.92,1065,6298,7363
2022/11/08,09:00:00,540.21,1022,6338,7360
2022/11/08,09:30:00,537.36,1035,6251,7286
2022/11/08,10:00:00,536.28,1096,6378,7474
2022/11/08,10:30:00,536.28,956,6491,7447
2022/11/08,11:00:00,536.82,992,6527,7519
2022/11/08,11:30:00,537.36,1114,6567,7681
2022/11/08,12:00:00,536.82,1001,6703,7704
2022/11/08,12:30:00,536.28,846,6767,7613
2022/11/08,13:00:00,536.82,872,6786,7658
2022/11/08,13:30:00,536.82,901,6811,7712
2022/11/08,14:00:00,537.36,752,7023,7775
2022/11/08,14:30:00,536.28,718,7180,7898
2022/11/08,15:00:00,536.28,720,7331,8051
2022/11/08,15:30:00,536.28,680,7505,8185
2022/11/08,16:00:00,537.36,435,7814,8249
2022/11/08,16:30:00,536.82,392,8171,8563
2022/11/08,17:00:00,537.36,27,8702,8729
2022/11/08,17:30:00,518.28,15,8947,8962
2022/11/08,18:00:00,529.18,15,8976,8991
2022/11/08,18:30:00,529.18,5,8974,8979
2022/11/08,19:00:00,529.18,5,8887,8892
2022/11/08,19:30:00,529.18,7,8799,8806
2022/11/08,20:00:00,530.31,16,8614,8630
2022/11/08,20:30:00,529.74,16,8458,8474
2022/11/08,21:00:00,529.18,9,8214,8223
2022/11/08,21:30:00,529.18,6,7959,7965
2022/11/08,22:00:00,529.18,3,7713,7716
2022/11/08,22:30:00,529.74,0,7416,7416
2022/11/08,23:00:00,529.18,0,7133,7133
2022/11/08,23:30:00,529.18,0,6815,6815
2022/11/09,00:00:00,529.18,0,6511,6511
2022/11/09,00:30:00,539.05,0,6236,6236
2022/11/09,01:00:00,529.74,0,6046,6046
2022/11/09,01:30:00,538.48,0,5897,5897
2022/11/09,02:00:00,537.92,0,5740,5740
2022/11/09,02:30:00,537.36,0,5694,5694
2022/11/09,03:00:00,538.48,0,5640,5640
2022/11/09,03:30:00,539.05,0,5603,5603
2022/11/09,04:00:00,537.92,0,5650,5650
2022/11/09,04:30:00,538.48,0,5764,5764
2022/11/09,05:00:00,538.48,0,5897,5897
2022/11/09,05:30:00,537.36,0,6092,6092
2022/11/09,06:00:00,537.36,0,6248,6248
2022/11/09,06:30:00,537.92,0,6446,6446
2022/11/09,07:00:00,537.92,282,6597,6879
2022/11/09,07:30:00,537.36,456,6627,7083
2022/11/09,08:00:00,537.36,575,6545,7120
2022/11/09,08:30:00,536.82,891,6274,7165
2022/11/09,09:00:00,536.28,1265,5940,7205
2022/11/09,09:30:00,537.36,1569,5797,7366
2022/11/09,10:00:00,537.36,1816,5717,7533
2022/11/09,10:30:00,537.92,1835,5802,7637
2022/11/09,11:00:00,536.82,1840,6137,7977
2022/11/09,11:30:00,537.92,1699,6252,7951
2022/11/09,12:00:00,537.92,1634,6328,7962
2022/11/09,12:30:00,536.82,1318,6613,7931
2022/11/09,13:00:00,537.36,1262,6745,8007
2022/11/09,13:30:00,537.36,1122,6854,7976
2022/11/09,14:00:00,537.92,961,7081,8042
2022/11/09,14:30:00,537.36,773,7234,8007
2022/11/09,15:00:00,537.36,794,7320,8114
2022/11/09,15:30:00,531.76,547,7608,8155
2022/11/09,16:00:00,538.48,377,7901,8278
2022/11/09,16:30:00,538.48,329,8230,8559
2022/11/09,17:00:00,537.92,31,8731,8762
2022/11/09,17:30:00,539.62,41,8983,9024
2022/11/09,18:00:00,539.62,21,9047,9068
2022/11/09,18:30:00,539.05,6,9068,9074
2022/11/09,19:00:00,539.05,9,8959,8968
2022/11/09,19:30:00,538.48,2,8838,8840
2022/11/09,20:00:00,539.05,3,8756,8759
2022/11/09,20:30:00,538.48,3,8559,8562
2022/11/09,21:00:00,539.62,6,8323,8329
2022/11/09,21:30:00,539.62,6,8057,8063
2022/11/09,22:00:00,538.48,7,7762,7769
2022/11/09,22:30:00,539.05,5,7510,7515
2022/11/09,23:00:00,538.48,4,7165,7169
2022/11/09,23:30:00,537.36,3,6826,6829
2022/11/10,00:00:00,537.36,1,6515,6516
2022/11/10,00:30:00,537.36,0,6226,6226
2022/11/10,01:00:00,537.92,0,6009,6009
2022/11/10,01:30:00,537.36,0,5875,5875
2022/11/10,02:00:00,537.36,0,5729,5729
2022/11/10,02:30:00,536.82,0,5647,5647
2022/11/10,03:00:00,537.36,0,5593,5593
2022/11/10,03:30:00,537.36,2,5603,5605
2022/11/10,04:00:00,537.92,0,5644,5644
2022/11/10,04:30:00,537.92,0,5721,5721
2022/11/10,05:00:00,537.92,0,5907,5907
2022/11/10,05:30:00,536.82,3,6109,6112
2022/11/10,06:00:00,536.82,3,6280,6283
2022/11/10,06:30:00,536.82,9,6450,6459
2022/11/10,07:00:00,537.36,391,6491,6882
2022/11/10,07:30:00,536.82,851,6393,7244
2022/11/10,08:00:00,538.48,1257,5995,7252
2022/11/10,08:30:00,539.62,1625,5678,7303
2022/11/10,09:00:00,529.18,1903,5380,7283
2022/11/10,09:30:00,536.28,2236,5251,7487
2022/11/10,10:00:00,535.75,2301,5133,7434
2022/11/10,10:30:00,535.75,2316,5217,7533
2022/11/10,11:00:00,535.75,2432,5139,7571
2022/11/10,11:30:00,535.75,2374,5234,7608
2022/11/10,12:00:00,536.82,2391,5215,7606
2022/11/10,12:30:00,534.71,2309,5375,7684
2022/11/10,13:00:00,536.82,2223,5556,7779
2022/11/10,13:30:00,536.28,2121,5757,7878
2022/11/10,14:00:00,534.71,1963,6017,7980
2022/11/10,14:30:00,533.2,1732,6294,8026
2022/11/10,15:00:00,533.7,1381,6677,8058
2022/11/10,15:30:00,531.3,976,7137,8113
2022/11/10,16:00:00,531.3,513,7491,8004
2022/11/10,16:30:00,531.76,337,7892,8229
2022/11/10,17:00:00,531.76,137,8325,8462
2022/11/10,17:30:00,531.76,141,8624,8765
2022/11/10,18:00:00,531.3,140,8667,8807
2022/11/10,18:30:00,531.76,143,8625,8768
2022/11/10,19:00:00,531.76,143,8584,8727
2022/11/10,19:30:00,531.3,145,8472,8617
2022/11/10,20:00:00,531.3,144,8358,8502
2022/11/10,20:30:00,531.3,144,8252,8396
2022/11/10,21:00:00,531.76,143,8020,8163
2022/11/10,21:30:00,532.24,143,7867,8010
2022/11/10,22:00:00,531.76,145,7583,7728
2022/11/10,22:30:00,531.3,80,7418,7498
2022/11/10,23:00:00,532.24,17,7254,7271
2022/11/10,23:30:00,531.76,25,6897,6922
2022/11/11,00:00:00,540.21,46,6630,6676
2022/11/11,00:30:00,536.82,56,6376,6432
2022/11/11,01:00:00,536.28,61,6161,6222
2022/11/11,01:30:00,535.75,52,5985,6037
2022/11/11,02:00:00,536.28,54,5805,5859
2022/11/11,02:30:00,537.36,66,5651,5717
2022/11/11,03:00:00,537.92,69,5589,5658
2022/11/11,03:30:00,537.92,78,5541,5619
2022/11/11,04:00:00,529.18,76,5577,5653
2022/11/11,04:30:00,526.49,81,5617,5698
2022/11/11,05:00:00,528.08,67,5760,5827
2022/11/11,05:30:00,529.18,71,5816,5887
2022/11/11,06:00:00,538.48,71,5827,5898
2022/11/11,06:30:00,539.05,71,5829,5900
2022/11/11,07:00:00,539.62,406,5742,6148
2022/11/11,07:30:00,537.36,861,5604,6465
2022/11/11,08:00:00,537.92,1247,5237,6484
2022/11/11,08:30:00,539.05,1682,4884,6566
2022/11/11,09:00:00,528.08,2003,4710,6713
2022/11/11,09:30:00,535.75,2224,4607,6831
2022/11/11,10:00:00,534.2,2356,4560,6916
2022/11/11,10:30:00,534.71,2468,4588,7056
2022/11/11,11:00:00,534.71,2516,4628,7144
2022/11/11,11:30:00,535.22,2524,4634,7158
2022/11/11,12:00:00,535.22,2489,4559,7048
2022/11/11,12:30:00,535.75,2461,4652,7113
2022/11/11,13:00:00,536.28,2354,4826,7180
2022/11/11,13:30:00,535.22,2206,5046,7252
2022/11/11,14:00:00,534.71,2003,5332,7335
2022/11/11,14:30:00,535.22,1715,5720,7435
2022/11/11,15:00:00,535.75,1356,6144,7500
2022/11/11,15:30:00,534.71,956,6711,7667
2022/11/11,16:00:00,535.22,501,7189,7690
2022/11/11,16:30:00,535.22,141,7352,7493
2022/11/11,17:00:00,535.22,154,7683,7837
2022/11/11,17:30:00,535.22,155,7786,7941
2022/11/11,18:00:00,535.22,159,7747,7906
2022/11/11,18:30:00,535.22,133,7673,7806
2022/11/11,19:00:00,535.75,70,7571,7641
2022/11/11,19:30:00,535.75,79,7369,7448
2022/11/11,20:00:00,535.22,80,7238,7318
2022/11/11,20:30:00,535.22,43,7191,7234
2022/11/11,21:00:00,534.71,53,7054,7107
2022/11/11,21:30:00,535.22,58,6931,6989
2022/11/11,22:00:00,534.2,60,6826,6886
2022/11/11,22:30:00,534.71,70,6634,6704
2022/11/11,23:00:00,534.71,70,6439,6509
2022/11/11,23:30:00,534.71,70,6270,6340
2022/11/12,00:00:00,534.71,74,6030,6104
2022/11/12,00:30:00,535.22,80,5894,5974
2022/11/12,01:00:00,536.28,80,5699,5779
2022/11/12,01:30:00,535.22,86,5554,5640
2022/11/12,02:00:00,535.22,77,5507,5584
2022/11/12,02:30:00,536.28,64,5419,5483
2022/11/12,03:00:00,534.71,65,5414,5479
2022/11/12,03:30:00,535.22,58,5411,5469
2022/11/12,04:00:00,536.28,58,5371,5429
2022/11/12,04:30:00,534.71,57,5465,5522
2022/11/12,05:00:00,535.22,53,5539,5592
2022/11/12,05:30:00,535.22,61,5574,5635
2022/11/12,06:00:00,536.28,69,5482,5551
2022/11/12,06:30:00,535.22,76,5373,5449
2022/11/12,07:00:00,536.82,395,5156,5551
2022/11/12,07:30:00,535.22,859,4834,5693
2022/11/12,08:00:00,538.48,1273,4511,5784
2022/11/12,08:30:00,540.21,1603,4271,5874
2022/11/12,09:00:00,537.36,1914,4113,6027
2022/11/12,09:30:00,536.28,2170,4034,6204
2022/11/12,10:00:00,536.82,2273,3956,6229
2022/11/12,10:30:00,537.92,2398,3936,6334
2022/11/12,11:00:00,537.36,2420,3892,6312
2022/11/12,11:30:00,539.05,2439,3848,6287
2022/11/12,12:00:00,537.36,2433,3882,6315
2022/11/12,12:30:00,537.36,2400,3942,6342
2022/11/12,13:00:00,532.72,2287,4123,6410
2022/11/12,13:30:00,534.71,2192,4347,6539
2022/11/12,14:00:00,535.22,1951,4581,6532
2022/11/12,14:30:00,534.71,1648,4938,6586
2022/11/12,15:00:00,534.2,1322,5354,6676
2022/11/12,15:30:00,535.22,911,5916,6827
2022/11/12,16:00:00,535.22,448,6379,6827
2022/11/12,16:30:00,534.2,329,6801,7130
2022/11/12,17:00:00,535.75,80,7231,7311
2022/11/12,17:30:00,535.22,85,7521,7606
2022/11/12,18:00:00,534.71,86,7730,7816
2022/11/12,18:30:00,534.71,104,7800,7904
2022/11/12,19:00:00,534.71,104,7735,7839
2022/11/12,19:30:00,534.2,108,7702,7810
2022/11/12,20:00:00,534.2,114,7605,7719
2022/11/12,20:30:00,534.71,116,7478,7594
2022/11/12,21:00:00,534.71,122,7444,7566
2022/11/12,21:30:00,534.71,100,7300,7400
2022/11/12,22:00:00,535.75,99,7099,7198
2022/11/12,22:30:00,534.71,100,6963,7063
2022/11/12,23:00:00,534.71,106,6708,6814
2022/11/12,23:30:00,534.71,98,6407,6505
2022/11/13,00:00:00,534.2,93,6096,6189
2022/11/13,00:30:00,534.71,75,5954,6029
2022/11/13,01:00:00,535.22,82,5672,5754
2022/11/13,01:30:00,535.75,83,5560,5643
2022/11/13,02:00:00,534.71,78,5487,5565
2022/11/13,02:30:00,534.71,81,5417,5498
2022/11/13,03:00:00,534.71,79,5332,5411
2022/11/13,03:30:00,535.22,77,5333,5410
2022/11/13,04:00:00,534.71,75,5383,5458
2022/11/13,04:30:00,534.71,80,5517,5597
2022/11/13,05:00:00,534.71,85,5674,5759
2022/11/13,05:30:00,534.71,84,5851,5935
2022/11/13,06:00:00,536.28,91,6019,6110
2022/11/13,06:30:00,533.7,87,6205,6292
2022/11/13,07:00:00,534.71,417,6316,6733
2022/11/13,07:30:00,534.71,870,6189,7059
2022/11/13,08:00:00,538.48,1287,5804,7091
2022/11/13,08:30:00,534.71,1650,5607,7257
2022/11/13,09:00:00,537.92,1918,5483,7401
2022/11/13,09:30:00,536.28,2140,5486,7626
2022/11/13,10:00:00,536.28,2364,5328,7692
2022/11/13,10:30:00,535.22,2393,5398,7791
2022/11/13,11:00:00,535.75,2478,5384,7862
2022/11/13,11:30:00,535.22,2443,5553,7996
2022/11/13,12:00:00,535.22,2359,5671,8030
2022/11/13,12:30:00,535.75,2293,5834,8127
2022/11/13,13:00:00,535.75,2239,6079,8318
2022/11/13,13:30:00,535.75,2126,6343,8469
2022/11/13,14:00:00,534.2,1931,6589,8520
2022/11/13,14:30:00,534.2,1558,6973,8531
2022/11/13,15:00:00,535.22,1190,7217,8407
2022/11/13,15:30:00,534.71,804,7645,8449
2022/11/13,16:00:00,535.22,381,7963,8344
2022/11/13,16:30:00,535.22,70,8311,8381
2022/11/13,17:00:00,534.71,74,8680,8754
2022/11/13,17:30:00,534.71,76,8820,8896
2022/11/13,18:00:00,539.62,92,8828,8920
2022/11/13,18:30:00,529.18,90,8749,8839
2022/11/13,19:00:00,538.48,100,8659,8759
2022/11/13,19:30:00,529.18,88,8579,8667
2022/11/13,20:00:00,532.24,99,8442,8541
2022/11/13,20:30:00,531.76,101,8270,8371
2022/11/13,21:00:00,532.24,103,8093,8196
2022/11/13,21:30:00,532.24,93,7938,8031
2022/11/13,22:00:00,532.24,89,7631,7720
2022/11/13,22:30:00,531.76,62,7425,7487
2022/11/13,23:00:00,532.72,57,7129,7186
2022/11/13,23:30:00,531.76,51,6820,6871
2022/11/14,00:00:00,532.24,49,6510,6559
2022/11/14,00:30:00,532.24,49,6277,6326
2022/11/14,01:00:00,532.24,47,6096,6143
2022/11/14,01:30:00,532.72,48,5882,5930
2022/11/14,02:00:00,531.76,46,5774,5820
2022/11/14,02:30:00,532.24,45,5671,5716
2022/11/14,03:00:00,532.24,48,5608,5656
2022/11/14,03:30:00,532.24,48,5671,5719
2022/11/14,04:00:00,531.3,50,5704,5754
2022/11/14,04:30:00,531.76,49,5804,5853
2022/11/14,05:00:00,532.24,50,5972,6022
2022/11/14,05:30:00,532.24,49,6153,6202
2022/11/14,06:00:00,532.24,47,6363,6410
2022/11/14,06:30:00,532.24,39,6517,6556
2022/11/14,07:00:00,532.24,317,6647,6964
2022/11/14,07:30:00,533.2,669,6616,7285
2022/11/14,08:00:00,529.74,1092,6416,7508
2022/11/14,08:30:00,535.75,1432,6313,7745
2022/11/14,09:00:00,534.2,1748,6145,7893
2022/11/14,09:30:00,533.7,1975,5968,7943
2022/11/14,10:00:00,533.2,2133,5846,7979
2022/11/14,10:30:00,533.7,2259,5687,7946
2022/11/14,11:00:00,533.2,2315,5721,8036
2022/11/14,11:30:00,533.7,2287,5793,8080
2022/11/14,12:00:00,533.7,2283,5809,8092
2022/11/14,12:30:00,534.71,2162,5935,8097
2022/11/14,13:00:00,528.23,1748,6450,8198
2022/11/14,13:30:00,535.22,1519,6803,8322
2022/11/14,14:00:00,535.75,1242,7058,8300
2022/11/14,14:30:00,535.75,997,7393,8390
2022/11/14,15:00:00,533.2,729,7786,8515
2022/11/14,15:30:00,533.2,392,7959,8351
2022/11/14,16:00:00,535.75,212,8128,8340
2022/11/14,16:30:00,535.22,0,8397,8397
2022/11/14,17:00:00,535.22,1,8791,8792
2022/11/14,17:30:00,535.22,0,8971,8971
2022/11/14,18:00:00,534.71,1,8974,8975
2022/11/14,18:30:00,535.75,15,8928,8943
2022/11/14,19:00:00,535.75,17,8854,8871
2022/11/14,19:30:00,536.28,25,8739,8764
2022/11/14,20:00:00,537.92,13,8652,8665
2022/11/14,20:30:00,538.48,9,8476,8485
2022/11/14,21:00:00,535.75,9,8308,8317
2022/11/14,21:30:00,537.36,2,8114,8116
2022/11/14,22:00:00,534.71,1,7832,7833
2022/11/14,22:30:00,532.72,1,7586,7587
2022/11/14,23:00:00,533.7,1,7234,7235
2022/11/14,23:30:00,533.7,0,6944,6944
2022/11/15,00:00:00,533.7,1,6619,6620
2022/11/15,00:30:00,532.72,3,6404,6407
2022/11/15,01:00:00,533.2,4,6189,6193
2022/11/15,01:30:00,532.72,17,6045,6062
2022/11/15,02:00:00,533.2,15,5876,5891
2022/11/15,02:30:00,533.7,17,5794,5811
2022/11/15,03:00:00,533.2,16,5776,5792
2022/11/15,03:30:00,533.2,18,5701,5719
2022/11/15,04:00:00,532.72,20,5808,5828
2022/11/15,04:30:00,534.2,14,5829,5843
2022/11/15,05:00:00,533.7,14,5982,5996
2022/11/15,05:30:00,533.2,12,6244,6256
2022/11/15,06:00:00,533.2,13,6340,6353
2022/11/15,06:30:00,532.24,9,6533,6542
2022/11/15,07:00:00,533.7,163,6818,6981
2022/11/15,07:30:00,536.28,328,7084,7412
2022/11/15,08:00:00,539.62,478,7018,7496
2022/11/15,08:30:00,537.36,741,6955,7696
2022/11/15,09:00:00,537.92,720,6917,7637
2022/11/15,09:30:00,533.7,947,6890,7837
2022/11/15,10:00:00,534.71,1073,6895,7968
2022/11/15,10:30:00,535.22,1101,6869,7970
2022/11/15,11:00:00,535.75,1269,6787,8056
2022/11/15,11:30:00,535.22,1341,6713,8054
2022/11/15,12:00:00,535.75,1371,6690,8061
2022/11/15,12:30:00,534.71,1445,6753,8198
2022/11/15,13:00:00,535.75,1307,6919,8226
2022/11/15,13:30:00,535.22,1273,7116,8389
2022/11/15,14:00:00,535.22,1124,7224,8348
2022/11/15,14:30:00,535.22,829,7502,8331
2022/11/15,15:00:00,534.2,634,7762,8396
2022/11/15,15:30:00,534.71,406,7973,8379
2022/11/15,16:00:00,535.22,237,8120,8357
2022/11/15,16:30:00,535.22,52,8384,8436
2022/11/15,17:00:00,534.71,60,8843,8903
2022/11/15,17:30:00,535.22,62,9006,9068
2022/11/15,18:00:00,536.28,57,9046,9103
2022/11/15,18:30:00,537.92,61,9063,9124
2022/11/15,19:00:00,539.05,34,9021,9055
2022/11/15,19:30:00,538.48,26,8933,8959
2022/11/15,20:00:00,529.18,25,8798,8823
2022/11/15,20:30:00,529.74,24,8639,8663
2022/11/15,21:00:00,532.72,20,8394,8414
2022/11/15,21:30:00,532.24,17,8158,8175
2022/11/15,22:00:00,532.24,18,7890,7908
2022/11/15,22:30:00,531.76,18,7578,7596
2022/11/15,23:00:00,532.24,19,7230,7249
2022/11/15,23:30:00,532.72,15,6886,6901
2022/11/16,00:00:00,532.24,17,6587,6604
2022/11/16,00:30:00,532.24,25,6318,6343
2022/11/16,01:00:00,531.76,24,6070,6094
2022/11/16,01:30:00,531.76,22,5901,5923
2022/11/16,02:00:00,532.72,23,5777,5800
2022/11/16,02:30:00,532.72,26,5723,5749
2022/11/16,03:00:00,532.24,15,5691,5706
2022/11/16,03:30:00,532.72,7,5650,5657
2022/11/16,04:00:00,532.24,7,5695,5702
2022/11/16,04:30:00,532.72,10,5800,5810
2022/11/16,05:00:00,532.24,11,5932,5943
2022/11/16,05:30:00,532.24,12,6168,6180
2022/11/16,06:00:00,531.76,30,6296,6326
2022/11/16,06:30:00,532.24,22,6535,6557
2022/11/16,07:00:00,532.72,266,6682,6948
2022/11/16,07:30:00,532.24,505,6674,7179
2022/11/16,08:00:00,539.05,948,6278,7226
2022/11/16,08:30:00,529.18,1486,5917,7403
2022/11/16,09:00:00,529.18,1696,5849,7545
2022/11/16,09:30:00,529.74,2123,5772,7895
2022/11/16,10:00:00,528.08,2243,5739,7982
2022/11/16,10:30:00,529.18,2131,5790,7921
2022/11/16,11:00:00,529.18,1843,6031,7874
2022/11/16,11:30:00,529.74,1690,6044,7734
2022/11/16,12:00:00,530.31,1909,5897,7806
2022/11/16,12:30:00,536.28,1726,6090,7816
2022/11/16,13:00:00,538.48,1902,6145,8047
2022/11/16,13:30:00,526.49,1679,6440,8119
2022/11/16,14:00:00,526.49,1627,6583,8210
2022/11/16,14:30:00,530.84,1236,6867,8103
2022/11/16,15:00:00,529.18,923,7224,8147
2022/11/16,15:30:00,525.49,670,7525,8195
2022/11/16,16:00:00,514.88,363,7883,8246
2022/11/16,16:30:00,511.86,27,8323,8350
2022/11/16,17:00:00,511.69,47,8861,8908
2022/11/16,17:30:00,2558.9,58,9078,9136
2022/11/16,18:00:00,2588.06,51,9108,9159
2022/11/16,18:30:00,511.49,58,9135,9193
2022/11/16,19:00:00,511.82,49,9058,9107
2022/11/16,19:30:00,515.19,40,8961,9001
2022/11/16,20:00:00,526.49,47,8785,8832
2022/11/16,20:30:00,536.82,43,8613,8656
2022/11/16,21:00:00,536.28,42,8412,8454
2022/11/16,21:30:00,536.28,48,8109,8157
2022/11/16,22:00:00,536.28,46,7824,7870
2022/11/16,22:30:00,539.05,15,7532,7547
2022/11/16,23:00:00,536.28,17,7215,7232
2022/11/16,23:30:00,534.71,16,6911,6927
2022/11/17,00:00:00,536.28,18,6595,6613
2022/11/17,00:30:00,536.82,13,6310,6323
2022/11/17,01:00:00,537.92,12,6094,6106
2022/11/17,01:30:00,529.18,7,5921,5928
2022/11/17,02:00:00,536.28,3,5782,5785
2022/11/17,02:30:00,529.18,7,5721,5728
2022/11/17,03:00:00,536.82,10,5660,5670
2022/11/17,03:30:00,540.21,12,5663,5675
2022/11/17,04:00:00,537.92,11,5696,5707
2022/11/17,04:30:00,530.31,13,5787,5800
2022/11/17,05:00:00,536.28,4,5979,5983
2022/11/17,05:30:00,529.18,3,6174,6177
2022/11/17,06:00:00,539.05,3,6324,6327
2022/11/17,06:30:00,537.92,4,6609,6613
2022/11/17,07:00:00,535.75,233,6766,6999
2022/11/17,07:30:00,529.18,652,6690,7342
2022/11/17,08:00:00,539.62,1100,6230,7330
2022/11/17,08:30:00,529.74,1500,5874,7374
2022/11/17,09:00:00,540.21,1773,5671,7444
2022/11/17,09:30:00,535.22,1870,5619,7489
2022/11/17,10:00:00,539.05,2146,5447,7593
2022/11/17,10:30:00,528.08,2347,5322,7669
2022/11/17,11:00:00,535.22,2403,5430,7833
2022/11/17,11:30:00,539.62,2412,5555,7967
2022/11/17,12:00:00,536.28,2379,5633,8012
2022/11/17,12:30:00,530.84,2327,5721,8048
2022/11/17,13:00:00,532.72,2076,5996,8072
2022/11/17,13:30:00,532.24,1963,6140,8103
2022/11/17,14:00:00,532.24,1868,6340,8208
2022/11/17,14:30:00,532.24,1589,6639,8228
2022/11/17,15:00:00,532.72,1236,6929,8165
2022/11/17,15:30:00,522.41,896,7317,8213
2022/11/17,16:00:00,513.93,460,7718,8178
2022/11/17,16:30:00,513.06,120,8173,8293
2022/11/17,17:00:00,513.06,142,8637,8779
2022/11/17,17:30:00,511.49,147,8815,8962
2022/11/17,18:00:00,530.31,146,8856,9002
2022/11/17,18:30:00,530.31,143,8858,9001
2022/11/17,19:00:00,527.54,133,8789,8922
2022/11/17,19:30:00,528.08,85,8729,8814
2022/11/17,20:00:00,527.54,46,8607,8653
2022/11/17,20:30:00,528.08,41,8478,8519
2022/11/17,21:00:00,528.08,37,8272,8309
2022/11/17,21:30:00,527.54,37,8112,8149
2022/11/17,22:00:00,528.08,38,7791,7829
2022/11/17,22:30:00,528.08,9,7599,7608
2022/11/17,23:00:00,528.08,4,7291,7295
2022/11/17,23:30:00,528.62,4,6966,6970
2022/11/18,00:00:00,527.54,1,6671,6672
2022/11/18,00:30:00,528.62,0,6457,6457
2022/11/18,01:00:00,538.48,3,6232,6235
2022/11/18,01:30:00,528.08,3,6040,6043
2022/11/18,02:00:00,527.01,4,5862,5866
2022/11/18,02:30:00,528.08,5,5784,5789
2022/11/18,03:00:00,528.62,4,5686,5690
2022/11/18,03:30:00,527.54,4,5675,5679
2022/11/18,04:00:00,529.74,4,5601,5605
2022/11/18,04:30:00,527.54,0,5753,5753
2022/11/18,05:00:00,527.54,0,5831,5831
2022/11/18,05:30:00,528.08,0,5952,5952
2022/11/18,06:00:00,528.08,0,6043,6043
2022/11/18,06:30:00,528.08,0,6011,6011
2022/11/18,07:00:00,528.08,307,5992,6299
2022/11/18,07:30:00,529.74,760,5801,6561
2022/11/18,08:00:00,529.74,1251,5445,6696
2022/11/18,08:30:00,529.18,1679,5134,6813
2022/11/18,09:00:00,529.74,2046,4911,6957
2022/11/18,09:30:00,529.74,2343,4812,7155
2022/11/18,10:00:00,529.74,2491,4705,7196
2022/11/18,10:30:00,530.31,2595,4739,7334
2022/11/18,11:00:00,529.74,2638,4760,7398
2022/11/18,11:30:00,529.18,2664,4727,7391
2022/11/18,12:00:00,529.74,2613,4656,7269
2022/11/18,12:30:00,529.74,2556,4807,7363
2022/11/18,13:00:00,528.62,2415,4960,7375
2022/11/18,13:30:00,530.31,2187,5161,7348
2022/11/18,14:00:00,529.18,2030,5442,7472
2022/11/18,14:30:00,529.18,1742,5769,7511
2022/11/18,15:00:00,529.18,1370,6297,7667
2022/11/18,15:30:00,529.18,931,6794,7725
2022/11/18,16:00:00,529.74,457,7253,7710
2022/11/18,16:30:00,529.18,111,7413,7524
2022/11/18,17:00:00,529.18,110,7775,7885
2022/11/18,17:30:00,528.62,110,7908,8018
2022/11/18,18:00:00,530.31,111,7883,7994
2022/11/18,18:30:00,529.18,113,7766,7879
2022/11/18,19:00:00,529.18,108,7615,7723
2022/11/18,19:30:00,529.18,48,7502,7550
2022/11/18,20:00:00,529.74,0,7394,7394
2022/11/18,20:30:00,529.18,0,7260,7260
2022/11/18,21:00:00,529.74,0,7211,7211
2022/11/18,21:30:00,529.18,0,7097,7097
2022/11/18,22:00:00,529.74,0,6879,6879
2022/11/18,22:30:00,528.62,0,6767,6767
2022/11/18,23:00:00,528.08,0,6583,6583
2022/11/18,23:30:00,529.18,0,6362,6362
2022/11/19,00:00:00,528.08,13,6201,6214
2022/11/19,00:30:00,528.62,12,6004,6016
2022/11/19,01:00:00,528.08,9,5884,5893
2022/11/19,01:30:00,527.54,7,5769,5776
2022/11/19,02:00:00,527.54,12,5592,5604
2022/11/19,02:30:00,528.08,10,5546,5556
2022/11/19,03:00:00,527.54,7,5526,5533
2022/11/19,03:30:00,527.01,7,5500,5507
2022/11/19,04:00:00,527.01,8,5476,5484
2022/11/19,04:30:00,527.01,6,5538,5544
2022/11/19,05:00:00,527.01,9,5624,5633
2022/11/19,05:30:00,527.54,10,5668,5678
2022/11/19,06:00:00,528.08,12,5666,5678
2022/11/19,06:30:00,527.01,11,5573,5584
2022/11/19,07:00:00,527.54,291,5355,5646
2022/11/19,07:30:00,528.62,794,5026,5820
2022/11/19,08:00:00,529.18,1241,4653,5894
2022/11/19,08:30:00,528.62,1668,4341,6009
2022/11/19,09:00:00,528.08,2083,4098,6181
2022/11/19,09:30:00,527.54,2365,4024,6389
2022/11/19,10:00:00,525.97,2501,3920,6421
2022/11/19,10:30:00,531.47,2606,3863,6469
2022/11/19,11:00:00,527.54,2664,3912,6576
2022/11/19,11:30:00,528.62,2687,3893,6580
2022/11/19,12:00:00,527.54,2647,3904,6551
2022/11/19,12:30:00,529.74,2593,3996,6589
2022/11/19,13:00:00,531.47,2505,4115,6620
2022/11/19,13:30:00,527.54,2295,4227,6522
2022/11/19,14:00:00,527.54,2126,4466,6592
2022/11/19,14:30:00,527.54,1764,4820,6584
2022/11/19,15:00:00,530.89,1387,5257,6644
2022/11/19,15:30:00,527.01,946,5840,6786
2022/11/19,16:00:00,527.54,491,6331,6822
2022/11/19,16:30:00,528.08,128,6759,6887
2022/11/19,17:00:00,528.08,116,7256,7372
2022/11/19,17:30:00,528.08,121,7568,7689
2022/11/19,18:00:00,528.62,124,7757,7881
2022/11/19,18:30:00,528.08,130,7853,7983
2022/11/19,19:00:00,528.08,136,7798,7934
2022/11/19,19:30:00,528.08,139,7752,7891
2022/11/19,20:00:00,528.62,138,7679,7817
2022/11/19,20:30:00,528.08,144,7597,7741
2022/11/19,21:00:00,527.54,150,7521,7671
2022/11/19,21:30:00,527.54,141,7390,7531
2022/11/19,22:00:00,529.18,95,7165,7260
2022/11/19,22:30:00,527.54,29,7075,7104
2022/11/19,23:00:00,528.62,40,6767,6807
2022/11/19,23:30:00,528.62,50,6504,6554
2022/11/20,00:00:00,528.08,49,6262,6311
2022/11/20,00:30:00,529.18,39,5969,6008
2022/11/20,01:00:00,529.18,37,5792,5829
2022/11/20,01:30:00,529.18,39,5587,5626
2022/11/20,02:00:00,528.62,38,5501,5539
2022/11/20,02:30:00,528.62,38,5442,5480
2022/11/20,03:00:00,529.18,41,5355,5396
2022/11/20,03:30:00,529.74,38,5387,5425
2022/11/20,04:00:00,530.31,38,5422,5460
2022/11/20,04:30:00,527.54,29,5584,5613
2022/11/20,05:00:00,528.62,29,5700,5729
2022/11/20,05:30:00,527.54,36,5887,5923
2022/11/20,06:00:00,527.01,47,6105,6152
2022/11/20,06:30:00,528.08,58,6328,6386
2022/11/20,07:00:00,529.18,357,6423,6780
2022/11/20,07:30:00,529.74,873,6220,7093
2022/11/20,08:00:00,527.54,1315,5840,7155
2022/11/20,08:30:00,528.62,1774,5458,7232
2022/11/20,09:00:00,529.74,2124,5163,7287
2022/11/20,09:30:00,529.18,2386,5059,7445
2022/11/20,10:00:00,529.18,2567,4900,7467
2022/11/20,10:30:00,528.62,2668,4921,7589
2022/11/20,11:00:00,530.31,2740,4823,7563
2022/11/20,11:30:00,528.62,2745,4869,7614
2022/11/20,12:00:00,529.18,2673,4948,7621
2022/11/20,12:30:00,529.18,2673,5057,7730
2022/11/20,13:00:00,529.74,2534,5337,7871
2022/11/20,13:30:00,530.31,2350,5629,7979
2022/11/20,14:00:00,528.08,2160,5951,8111
2022/11/20,14:30:00,529.18,1749,6311,8060
2022/11/20,15:00:00,528.08,1361,6788,8149
2022/11/20,15:30:00,529.18,833,7288,8121
2022/11/20,16:00:00,529.18,467,7654,8121
2022/11/20,16:30:00,528.62,152,8002,8154
2022/11/20,17:00:00,529.18,194,8407,8601
2022/11/20,17:30:00,529.18,206,8598,8804
2022/11/20,18:00:00,529.18,218,8591,8809
2022/11/20,18:30:00,529.18,224,8592,8816
2022/11/20,19:00:00,529.74,212,8524,8736
2022/11/20,19:30:00,529.18,217,8425,8642
2022/11/20,20:00:00,529.74,232,8297,8529
2022/11/20,20:30:00,529.18,242,8144,8386
2022/11/20,21:00:00,529.18,235,7959,8194
2022/11/20,21:30:00,529.74,140,7871,8011
2022/11/20,22:00:00,530.31,137,7613,7750
2022/11/20,22:30:00,528.62,106,7388,7494
2022/11/20,23:00:00,529.18,96,7103,7199
2022/11/20,23:30:00,529.74,106,6742,6848
2022/11/21,00:00:00,529.18,106,6429,6535
2022/11/21,00:30:00,528.08,104,6209,6313
2022/11/21,01:00:00,527.54,100,5997,6097
2022/11/21,01:30:00,528.08,94,5814,5908
2022/11/21,02:00:00,527.01,94,5725,5819
2022/11/21,02:30:00,527.01,101,5614,5715
2022/11/21,03:00:00,527.54,99,5536,5635
2022/11/21,03:30:00,528.08,99,5597,5696
2022/11/21,04:00:00,527.54,94,5611,5705
2022/11/21,04:30:00,527.54,88,5753,5841
2022/11/21,05:00:00,530.31,62,5923,5985
2022/11/21,05:30:00,529.74,57,6155,6212
2022/11/21,06:00:00,529.18,58,6309,6367
2022/11/21,06:30:00,528.08,63,6474,6537
2022/11/21,07:00:00,528.62,301,6586,6887
2022/11/21,07:30:00,529.18,756,6444,7200
2022/11/21,08:00:00,529.74,1219,6098,7317
2022/11/21,08:30:00,529.18,1452,6242,7694
2022/11/21,09:00:00,528.08,1666,6105,7771
2022/11/21,09:30:00,528.08,1995,5933,7928
2022/11/21,10:00:00,528.62,2344,5531,7875
2022/11/21,10:30:00,530.31,2499,5378,7877
2022/11/21,11:00:00,529.74,2646,5363,8009
2022/11/21,11:30:00,528.08,2590,5442,8032
2022/11/21,12:00:00,528.62,2513,5490,8003
2022/11/21,12:30:00,529.18,2319,5743,8062
2022/11/21,13:00:00,529.18,2221,5969,8190
2022/11/21,13:30:00,529.18,1935,6327,8262
2022/11/21,14:00:00,528.62,1821,6515,8336
2022/11/21,14:30:00,528.62,1529,6830,8359
2022/11/21,15:00:00,528.62,1232,7225,8457
2022/11/21,15:30:00,529.18,805,7608,8413
2022/11/21,16:00:00,529.74,429,7877,8306
2022/11/21,16:30:00,529.74,144,8214,8358
2022/11/21,17:00:00,530.31,158,8455,8613
2022/11/21,17:30:00,527.54,158,8677,8835
2022/11/21,18:00:00,528.08,156,8718,8874
2022/11/21,18:30:00,528.08,162,8705,8867
2022/11/21,19:00:00,529.18,163,8606,8769
2022/11/21,19:30:00,528.62,161,8543,8704
2022/11/21,20:00:00,527.01,96,8510,8606
2022/11/21,20:30:00,527.54,52,8407,8459
2022/11/21,21:00:00,527.01,52,8227,8279
2022/11/21,21:30:00,528.08,51,8065,8116
2022/11/21,22:00:00,528.08,47,7755,7802
2022/11/21,22:30:00,527.54,16,7531,7547
2022/11/21,23:00:00,527.54,16,7203,7219
2022/11/21,23:30:00,527.01,14,6897,6911
2022/11/22,00:00:00,527.54,15,6567,6582
2022/11/22,00:30:00,527.01,12,6277,6289
2022/11/22,01:00:00,528.62,14,6091,6105
2022/11/22,01:30:00,528.62,13,5920,5933
2022/11/22,02:00:00,528.08,14,5797,5811
2022/11/22,02:30:00,527.54,18,5755,5773
2022/11/22,03:00:00,527.01,20,5730,5750
2022/11/22,03:30:00,526.49,14,5691,5705
2022/11/22,04:00:00,527.01,15,5740,5755
2022/11/22,04:30:00,527.01,13,5814,5827
2022/11/22,05:00:00,528.08,18,5989,6007
2022/11/22,05:30:00,527.01,10,6211,6221
2022/11/22,06:00:00,527.01,5,6397,6402
2022/11/22,06:30:00,528.08,4,6659,6663
2022/11/22,07:00:00,528.62,10,6979,6989
2022/11/22,07:30:00,528.62,321,7082,7403
2022/11/22,08:00:00,527.54,435,7075,7510
2022/11/22,08:30:00,527.54,602,7038,7640
2022/11/22,09:00:00,527.54,808,6857,7665
2022/11/22,09:30:00,529.74,1178,6672,7850
2022/11/22,10:00:00,527.01,1235,6399,7634
2022/11/22,10:30:00,518.67,1631,6293,7924
2022/11/22,11:00:00,518.28,1799,6196,7995
2022/11/22,11:30:00,518.67,1795,6318,8113
2022/11/22,12:00:00,518.67,1663,6511,8174
2022/11/22,12:30:00,517.88,1659,6556,8215
2022/11/22,13:00:00,518.28,1743,6602,8345
2022/11/22,13:30:00,518.28,1514,6809,8323
2022/11/22,14:00:00,518.28,1354,6901,8255
2022/11/22,14:30:00,519.91,1198,6995,8193
2022/11/22,15:00:00,519.49,961,7274,8235
2022/11/22,15:30:00,515.67,764,7656,8420
2022/11/22,16:00:00,516.02,422,7919,8341
2022/11/22,16:30:00,505.07,139,8271,8410
2022/11/22,17:00:00,502.84,165,8664,8829
2022/11/22,17:30:00,502.82,135,8895,9030
2022/11/22,18:00:00,502.82,61,8962,9023
2022/11/22,18:30:00,502.82,44,8989,9033
2022/11/22,19:00:00,502.82,46,8957,9003
2022/11/22,19:30:00,503.42,48,8867,8915
2022/11/22,20:00:00,505.71,50,8758,8808
2022/11/22,20:30:00,529.18,46,8639,8685
2022/11/22,21:00:00,530.31,43,8407,8450
2022/11/22,21:30:00,530.89,34,8196,8230
2022/11/22,22:00:00,529.18,37,7918,7955
2022/11/22,22:30:00,529.74,33,7587,7620
2022/11/22,23:00:00,529.74,33,7286,7319
2022/11/22,23:30:00,529.74,35,6953,6988
2022/11/23,00:00:00,530.31,38,6639,6677
2022/11/23,00:30:00,529.74,10,6389,6399
2022/11/23,01:00:00,529.74,9,6139,6148
2022/11/23,01:30:00,529.74,5,5978,5983
2022/11/23,02:00:00,529.18,0,5841,5841
2022/11/23,02:30:00,529.18,0,5771,5771
2022/11/23,03:00:00,528.62,0,5701,5701
2022/11/23,03:30:00,529.74,0,5696,5696
2022/11/23,04:00:00,529.18,4,5739,5743
2022/11/23,04:30:00,529.18,8,5833,5841
2022/11/23,05:00:00,529.74,21,6001,6022
2022/11/23,05:30:00,530.31,35,6227,6262
2022/11/23,06:00:00,530.31,36,6347,6383
2022/11/23,06:30:00,529.74,49,6584,6633
2022/11/23,07:00:00,529.74,300,6695,6995
2022/11/23,07:30:00,529.74,743,6547,7290
2022/11/23,08:00:00,529.18,1147,6127,7274
2022/11/23,08:30:00,530.31,1587,5904,7491
2022/11/23,09:00:00,529.74,2021,5500,7521
2022/11/23,09:30:00,530.31,2299,5307,7606
2022/11/23,10:00:00,529.18,2442,5116,7558
2022/11/23,10:30:00,530.31,2529,5114,7643
2022/11/23,11:00:00,529.74,2597,5087,7684
2022/11/23,11:30:00,529.18,2604,5108,7712
2022/11/23,12:00:00,529.18,2565,5156,7721
2022/11/23,12:30:00,529.74,2497,5262,7759
2022/11/23,13:00:00,527.54,2432,5478,7910
2022/11/23,13:30:00,527.01,2270,5272,7542
2022/11/23,14:00:00,528.62,2026,6072,8098
2022/11/23,14:30:00,527.54,1638,6486,8124
2022/11/23,15:00:00,527.54,1290,6924,8214
2022/11/23,15:30:00,528.08,893,7402,8295
2022/11/23,16:00:00,528.62,437,7746,8183
2022/11/23,16:30:00,528.08,168,8086,8254
2022/11/23,17:00:00,528.08,196,8557,8753
2022/11/23,17:30:00,527.54,199,8752,8951
2022/11/23,18:00:00,528.08,204,8772,8976
2022/11/23,18:30:00,527.54,198,8784,8982
2022/11/23,19:00:00,527.54,194,8709,8903
2022/11/23,19:30:00,527.54,202,8626,8828
2022/11/23,20:00:00,528.08,180,8494,8674
2022/11/23,20:30:00,527.01,100,8421,8521
2022/11/23,21:00:00,527.54,107,8253,8360
2022/11/23,21:30:00,528.08,111,7998,8109
2022/11/23,22:00:00,527.54,105,7757,7862
2022/11/23,22:30:00,528.08,99,7506,7605
2022/11/23,23:00:00,527.54,91,7143,7234
2022/11/23,23:30:00,527.01,96,6829,6925
2022/11/24,00:00:00,528.08,77,6498,6575
2022/11/24,00:30:00,528.08,40,6293,6333
2022/11/24,01:00:00,527.54,40,6100,6140
2022/11/24,01:30:00,528.08,34,5935,5969
2022/11/24,02:00:00,528.08,29,5797,5826
2022/11/24,02:30:00,527.54,37,5699,5736
2022/11/24,03:00:00,527.54,48,5661,5709
2022/11/24,03:30:00,527.54,45,5631,5676
2022/11/24,04:00:00,527.54,32,5701,5733
2022/11/24,04:30:00,527.54,22,5834,5856
2022/11/24,05:00:00,527.54,8,5993,6001
2022/11/24,05:30:00,527.54,8,6227,6235
2022/11/24,06:00:00,527.54,6,6422,6428
2022/11/24,06:30:00,528.08,1,6653,6654
2022/11/24,07:00:00,527.54,185,6892,7077
2022/11/24,07:30:00,528.08,370,7025,7395
2022/11/24,08:00:00,527.54,615,6869,7484
2022/11/24,08:30:00,529.18,847,6782,7629
2022/11/24,09:00:00,529.74,1050,6690,7740
2022/11/24,09:30:00,529.18,1037,6830,7867
2022/11/24,10:00:00,529.74,1318,6837,8155
2022/11/24,10:30:00,529.74,1344,6852,8196
2022/11/24,11:00:00,529.74,1344,6987,8331
2022/11/24,11:30:00,529.18,1051,7185,8236
2022/11/24,12:00:00,528.62,1019,7155,8174
2022/11/24,12:30:00,529.18,903,7139,8042
2022/11/24,13:00:00,529.74,863,7126,7989
2022/11/24,13:30:00,529.18,819,7241,8060
2022/11/24,14:00:00,528.08,899,7248,8147
2022/11/24,14:30:00,529.74,748,7488,8236
2022/11/24,15:00:00,529.74,568,7724,8292
2022/11/24,15:30:00,529.74,509,7930,8439
2022/11/24,16:00:00,529.74,275,8157,8432
2022/11/24,16:30:00,529.74,50,8467,8517
2022/11/24,17:00:00,529.18,56,8925,8981
2022/11/24,17:30:00,529.18,72,9084,9156
2022/11/24,18:00:00,529.18,61,9129,9190
2022/11/24,18:30:00,528.62,56,9113,9169
2022/11/24,19:00:00,528.08,38,9033,9071
2022/11/24,19:30:00,527.54,40,8966,9006
2022/11/24,20:00:00,528.62,52,8773,8825
2022/11/24,20:30:00,528.08,41,8656,8697
2022/11/24,21:00:00,528.08,48,8385,8433
2022/11/24,21:30:00,528.08,44,8104,8148
2022/11/24,22:00:00,528.08,41,7920,7961
2022/11/24,22:30:00,527.54,34,7686,7720
2022/11/24,23:00:00,527.54,41,7384,7425
2022/11/24,23:30:00,528.62,39,7045,7084
2022/11/25,00:00:00,529.18,38,6704,6742
2022/11/25,00:30:00,529.18,14,6469,6483
2022/11/25,01:00:00,527.54,32,6251,6283
2022/11/25,01:30:00,530.31,11,6057,6068
2022/11/25,02:00:00,527.01,23,5908,5931
2022/11/25,02:30:00,527.01,34,5757,5791
2022/11/25,03:00:00,527.01,46,5668,5714
2022/11/25,03:30:00,528.08,46,5675,5721
2022/11/25,04:00:00,529.74,60,5622,5682
2022/11/25,04:30:00,529.74,56,5704,5760
2022/11/25,05:00:00,529.18,83,5768,5851
2022/11/25,05:30:00,528.08,105,5904,6009
2022/11/25,06:00:00,528.08,90,6014,6104
2022/11/25,06:30:00,527.01,79,6073,6152
2022/11/25,07:00:00,528.62,262,6238,6500
2022/11/25,07:30:00,529.18,405,6381,6786
2022/11/25,08:00:00,529.18,608,6294,6902
2022/11/25,08:30:00,527.54,949,6057,7006
2022/11/25,09:00:00,528.62,1540,5933,7473
2022/11/25,09:30:00,527.54,1971,6097,8068
2022/11/25,10:00:00,528.08,2094,6179,8273
2022/11/25,10:30:00,446.81,2231,6007,8238
2022/11/25,11:00:00,530.31,2544,5939,8483
2022/11/25,11:30:00,530.89,2413,6071,8484
2022/11/25,12:00:00,527.01,2052,6457,8509
2022/11/25,12:30:00,530.31,1930,6540,8470
2022/11/25,13:00:00,529.74,1550,7036,8586
2022/11/25,13:30:00,529.18,1551,7128,8679
2022/11/25,14:00:00,529.74,1395,7067,8462
2022/11/25,14:30:00,529.74,1296,7442,8738
2022/11/25,15:00:00,529.18,982,7754,8736
2022/11/25,15:30:00,529.18,620,8044,8664
2022/11/25,16:00:00,529.74,364,8295,8659
2022/11/25,16:30:00,529.74,84,8261,8345
2022/11/25,17:00:00,529.18,68,8498,8566
2022/11/25,17:30:00,529.74,122,8445,8567
2022/11/25,18:00:00,529.74,106,8392,8498
2022/11/25,18:30:00,529.74,128,8229,8357
2022/11/25,19:00:00,529.74,108,8093,8201
2022/11/25,19:30:00,529.18,100,7863,7963
2022/11/25,20:00:00,529.74,119,7657,7776
2022/11/25,20:30:00,529.18,140,7528,7668
2022/11/25,21:00:00,529.18,105,7488,7593
2022/11/25,21:30:00,529.74,127,7291,7418
2022/11/25,22:00:00,529.74,126,7136,7262
2022/11/25,22:30:00,530.31,145,6976,7121
2022/11/25,23:00:00,529.74,97,6807,6904
2022/11/25,23:30:00,528.62,144,6507,6651
2022/11/26,00:00:00,529.74,106,6308,6414
2022/11/26,00:30:00,530.31,75,6121,6196
2022/11/26,01:00:00,530.31,108,5872,5980
2022/11/26,01:30:00,529.74,105,5769,5874
2022/11/26,02:00:00,529.18,93,5654,5747
2022/11/26,02:30:00,529.74,102,5567,5669
2022/11/26,03:00:00,529.74,95,5515,5610
2022/11/26,03:30:00,529.18,115,5508,5623
2022/11/26,04:00:00,529.18,113,5520,5633
2022/11/26,04:30:00,529.74,113,5578,5691
2022/11/26,05:00:00,529.74,114,5657,5771
2022/11/26,05:30:00,529.18,112,5741,5853
2022/11/26,06:00:00,529.18,110,5699,5809
2022/11/26,06:30:00,529.74,111,5702,5813
2022/11/26,07:00:00,530.31,359,5651,6010
2022/11/26,07:30:00,530.31,618,5615,6233
2022/11/26,08:00:00,529.18,784,5605,6389
2022/11/26,08:30:00,529.74,842,5530,6372
2022/11/26,09:00:00,529.18,1301,5399,6700
2022/11/26,09:30:00,528.62,1463,5472,6935
2022/11/26,10:00:00,530.31,1250,5590,6840
2022/11/26,10:30:00,529.18,1365,5637,7002
2022/11/26,11:00:00,529.18,1342,5805,7147
2022/11/26,11:30:00,529.74,1437,5775,7212
2022/11/26,12:00:00,529.74,1394,5802,7196
2022/11/26,12:30:00,530.31,1584,5686,7270
2022/11/26,13:00:00,530.31,1666,5700,7366
2022/11/26,13:30:00,529.18,1448,5821,7269
2022/11/26,14:00:00,529.18,1262,5917,7179
2022/11/26,14:30:00,530.31,1105,6118,7223
2022/11/26,15:00:00,529.18,1072,6234,7306
2022/11/26,15:30:00,529.18,829,6516,7345
2022/11/26,16:00:00,530.31,397,7027,7424
2022/11/26,16:30:00,529.74,69,7501,7570
2022/11/26,17:00:00,529.74,38,8004,8042
2022/11/26,17:30:00,529.18,41,8410,8451
2022/11/26,18:00:00,529.18,38,8725,8763
2022/11/26,18:30:00,528.62,31,8830,8861
2022/11/26,19:00:00,529.18,31,8771,8802
2022/11/26,19:30:00,529.18,31,8643,8674
2022/11/26,20:00:00,529.18,31,8501,8532
2022/11/26,20:30:00,529.18,31,8385,8416
2022/11/26,21:00:00,529.74,1,8286,8287
2022/11/26,21:30:00,529.74,0,8115,8115
2022/11/26,22:00:00,529.74,1,7896,7897
2022/11/26,22:30:00,529.74,0,7643,7643
2022/11/26,23:00:00,529.74,0,7286,7286
2022/11/26,23:30:00,445.51,0,6974,6974
2022/11/27,00:00:00,530.31,0,6640,6640
2022/11/27,00:30:00,529.74,0,6348,6348
2022/11/27,01:00:00,529.18,0,6071,6071
2022/11/27,01:30:00,530.31,0,5826,5826
2022/11/27,02:00:00,529.18,0,5747,5747
2022/11/27,02:30:00,529.74,0,5629,5629
2022/11/27,03:00:00,529.18,0,5588,5588
2022/11/27,03:30:00,529.18,0,5555,5555
2022/11/27,04:00:00,529.74,2,5580,5582
2022/11/27,04:30:00,529.18,16,5755,5771
2022/11/27,05:00:00,529.74,25,5893,5918
2022/11/27,05:30:00,529.18,27,6179,6206
2022/11/27,06:00:00,529.74,31,6377,6408
2022/11/27,06:30:00,529.74,42,6644,6686
2022/11/27,07:00:00,529.74,274,6835,7109
2022/11/27,07:30:00,516.38,527,6965,7492
2022/11/27,08:00:00,529.74,917,6567,7484
2022/11/27,08:30:00,529.18,1248,6322,7570
2022/11/27,09:00:00,527.01,1355,6359,7714
2022/11/27,09:30:00,528.62,1132,6632,7764
2022/11/27,10:00:00,530.31,1771,6121,7892
2022/11/27,10:30:00,529.74,1933,5896,7829
2022/11/27,11:00:00,530.31,1841,6034,7875
2022/11/27,11:30:00,530.89,1533,6361,7894
2022/11/27,12:00:00,529.74,1554,6269,7823
2022/11/27,12:30:00,529.74,1934,6303,8237
2022/11/27,13:00:00,527.54,1850,6440,8290
2022/11/27,13:30:00,527.54,1533,6755,8288
2022/11/27,14:00:00,526.49,1155,7221,8376
2022/11/27,14:30:00,525.97,748,7635,8383
2022/11/27,15:00:00,530.89,609,7776,8385
2022/11/27,15:30:00,529.18,512,8033,8545
2022/11/27,16:00:00,529.18,566,8264,8830
2022/11/27,16:30:00,529.18,204,8725,8929
2022/11/27,17:00:00,529.74,203,9177,9380
2022/11/27,17:30:00,529.18,215,9334,9549
2022/11/27,18:00:00,529.74,194,9430,9624
2022/11/27,18:30:00,529.74,150,9508,9658
2022/11/27,19:00:00,529.74,89,9524,9613
2022/11/27,19:30:00,529.74,82,9418,9500
2022/11/27,20:00:00,529.18,95,9317,9412
2022/11/27,20:30:00,536.04,94,9189,9283
2022/11/27,21:00:00,536.04,104,8963,9067
2022/11/27,21:30:00,536.53,101,8640,8741
2022/11/27,22:00:00,536.04,103,8334,8437
2022/11/27,22:30:00,536.53,112,7990,8102
2022/11/27,23:00:00,536.04,115,7612,7727
2022/11/27,23:30:00,535.56,98,7136,7234
2022/11/28,00:00:00,533.27,109,6779,6888
2022/11/28,00:30:00,535.56,105,6465,6570
2022/11/28,01:00:00,531.57,111,6178,6289
2022/11/28,01:30:00,535.09,115,5926,6041
2022/11/28,02:00:00,533.27,104,5831,5935
2022/11/28,02:30:00,533.72,104,5718,5822
2022/11/28,03:00:00,535.09,100,5697,5797
2022/11/28,03:30:00,535.56,100,5683,5783
2022/11/28,04:00:00,535.56,112,5657,5769
2022/11/28,04:30:00,535.56,103,5822,5925
2022/11/28,05:00:00,530.37,111,6007,6118
2022/11/28,05:30:00,531.99,117,6304,6421
2022/11/28,06:00:00,531.99,118,6523,6641
2022/11/28,06:30:00,527.54,112,6888,7000
2022/11/28,07:00:00,527.01,299,7046,7345
2022/11/28,07:30:00,526.49,706,6945,7651
2022/11/28,08:00:00,527.54,1144,6452,7596
2022/11/28,08:30:00,529.74,1508,6033,7541
2022/11/28,09:00:00,529.74,1780,5824,7604
2022/11/28,09:30:00,533.72,2194,5565,7759
2022/11/28,10:00:00,532.84,2194,5494,7688
2022/11/28,10:30:00,532.84,2069,5549,7618
2022/11/28,11:00:00,531.99,2022,5618,7640
2022/11/28,11:30:00,531.99,2353,5494,7847
2022/11/28,12:00:00,531.16,2021,5753,7774
2022/11/28,12:30:00,531.99,1641,6160,7801
2022/11/28,13:00:00,529.6,1215,6654,7869
2022/11/28,13:30:00,529.23,1018,7067,8085
2022/11/28,14:00:00,529.6,879,7486,8365
2022/11/28,14:30:00,530.37,691,7792,8483
2022/11/28,15:00:00,534.62,595,7922,8517
2022/11/28,15:30:00,534.62,485,8197,8682
2022/11/28,16:00:00,534.62,542,8377,8919
2022/11/28,16:30:00,533.72,144,8701,8845
2022/11/28,17:00:00,533.27,145,9141,9286
2022/11/28,17:30:00,533.72,146,9320,9466
2022/11/28,18:00:00,533.72,140,9357,9497
2022/11/28,18:30:00,533.27,147,9391,9538
2022/11/28,19:00:00,532.84,147,9353,9500
2022/11/28,19:30:00,534.62,146,9244,9390
2022/11/28,20:00:00,530.76,148,9114,9262
2022/11/28,20:30:00,535.56,139,8966,9105
2022/11/28,21:00:00,536.53,145,8757,8902
2022/11/28,21:30:00,536.04,132,8566,8698
2022/11/28,22:00:00,535.56,135,8246,8381
2022/11/28,22:30:00,535.09,140,7921,8061
2022/11/28,23:00:00,535.56,139,7591,7730
2022/11/28,23:30:00,532.84,132,7184,7316
2022/11/29,00:00:00,533.72,141,6769,6910
2022/11/29,00:30:00,533.27,112,6445,6557
2022/11/29,01:00:00,530.37,111,6211,6322
2022/11/29,01:30:00,530.76,112,5985,6097
2022/11/29,02:00:00,535.56,109,5869,5978
2022/11/29,02:30:00,534.62,110,5724,5834
2022/11/29,03:00:00,534.62,116,5707,5823
2022/11/29,03:30:00,534.17,114,5697,5811
2022/11/29,04:00:00,535.56,106,5741,5847
2022/11/29,04:30:00,534.17,105,5857,5962
2022/11/29,05:00:00,534.17,92,6107,6199
2022/11/29,05:30:00,534.62,96,6360,6456
2022/11/29,06:00:00,533.72,96,6580,6676
2022/11/29,06:30:00,534.17,93,6891,6984
2022/11/29,07:00:00,536.04,102,7269,7371
2022/11/29,07:30:00,527.01,316,7562,7878
2022/11/29,08:00:00,534.62,703,7371,8074
2022/11/29,08:30:00,534.17,1024,7285,8309
2022/11/29,09:00:00,535.09,1281,6959,8240
2022/11/29,09:30:00,535.56,1253,7011,8264
2022/11/29,10:00:00,532.84,1516,6721,8237
2022/11/29,10:30:00,534.17,1798,6647,8445
2022/11/29,11:00:00,533.72,2018,6654,8672
2022/11/29,11:30:00,533.27,2152,6612,8764
2022/11/29,12:00:00,533.27,2117,6608,8725
2022/11/29,12:30:00,533.72,2114,6689,8803
2022/11/29,13:00:00,533.27,2096,6715,8811
2022/11/29,13:30:00,535.56,2045,6881,8926
2022/11/29,14:00:00,535.09,1914,7077,8991
2022/11/29,14:30:00,535.56,1619,7316,8935
2022/11/29,15:00:00,535.09,1267,7698,8965
2022/11/29,15:30:00,534.62,887,8029,8916
2022/11/29,16:00:00,534.17,447,8362,8809
2022/11/29,16:30:00,535.56,80,8821,8901
2022/11/29,17:00:00,531.57,29,9426,9455
2022/11/29,17:30:00,533.72,9,9661,9670
2022/11/29,18:00:00,533.27,5,9763,9768
2022/11/29,18:30:00,533.27,3,9774,9777
2022/11/29,19:00:00,534.17,28,9734,9762
2022/11/29,19:30:00,533.72,40,9642,9682
2022/11/29,20:00:00,533.27,22,9567,9589
2022/11/29,20:30:00,533.27,4,9391,9395
2022/11/29,21:00:00,526.16,2,9153,9155
2022/11/29,21:30:00,534.17,0,8909,8909
2022/11/29,22:00:00,535.56,0,8615,8615
2022/11/29,22:30:00,534.62,0,8248,8248
2022/11/29,23:00:00,535.56,0,7876,7876
2022/11/29,23:30:00,534.62,3,7428,7431
2022/11/30,00:00:00,534.62,5,7023,7028
2022/11/30,00:30:00,534.62,9,6681,6690
2022/11/30,01:00:00,534.62,10,6376,6386
2022/11/30,01:30:00,534.62,13,6172,6185
2022/11/30,02:00:00,535.09,11,6060,6071
2022/11/30,02:30:00,535.09,6,5924,5930
2022/11/30,03:00:00,534.17,7,5900,5907
2022/11/30,03:30:00,535.56,6,5885,5891
2022/11/30,04:00:00,535.09,9,5903,5912
2022/11/30,04:30:00,535.56,7,6032,6039
2022/11/30,05:00:00,536.04,8,6195,6203
2022/11/30,05:30:00,535.09,16,6490,6506
2022/11/30,06:00:00,535.56,13,6743,6756
2022/11/30,06:30:00,535.09,17,7045,7062
2022/11/30,07:00:00,535.09,197,7313,7510
2022/11/30,07:30:00,534.62,547,7336,7883
2022/11/30,08:00:00,536.53,1042,6911,7953
2022/11/30,08:30:00,534.62,1449,6614,8063
2022/11/30,09:00:00,536.04,1867,6282,8149
2022/11/30,09:30:00,536.04,2100,6080,8180
2022/11/30,10:00:00,535.56,2274,5989,8263
2022/11/30,10:30:00,535.09,2300,5890,8190
2022/11/30,11:00:00,537.02,2382,5735,8117
2022/11/30,11:30:00,534.17,2409,5700,8109
2022/11/30,12:00:00,524.95,2419,5720,8139
2022/11/30,12:30:00,535.09,2419,5834,8253
2022/11/30,13:00:00,535.09,2299,6049,8348
2022/11/30,13:30:00,535.09,2224,6254,8478
2022/11/30,14:00:00,535.56,2030,6528,8558
2022/11/30,14:30:00,535.56,1657,6805,8462
2022/11/30,15:00:00,534.62,1314,7164,8478
2022/11/30,15:30:00,535.09,932,7581,8513
2022/11/30,16:00:00,535.09,458,8029,8487
2022/11/30,16:30:00,535.56,123,8530,8653
2022/11/30,17:00:00,534.62,173,9070,9243
2022/11/30,17:30:00,535.09,167,9361,9528
2022/11/30,18:00:00,535.09,154,9504,9658
2022/11/30,18:30:00,534.62,157,9506,9663
2022/11/30,19:00:00,535.56,150,9469,9619
2022/11/30,19:30:00,535.09,147,9457,9604
2022/11/30,20:00:00,535.56,149,9364,9513
2022/11/30,20:30:00,533.27,150,9199,9349
2022/11/30,21:00:00,534.62,149,9010,9159
2022/11/30,21:30:00,535.09,153,8726,8879
2022/11/30,22:00:00,535.56,150,8462,8612
2022/11/30,22:30:00,535.09,11,8248,8259
2022/11/30,23:00:00,535.09,7,7887,7894
2022/11/30,23:30:00,534.62,5,7476,7481
2022/12/01,00:00:00,338.14,4,7067,7071
2022/12/01,00:30:00,336.97,4,6682,6686
2022/12/01,01:00:00,337.55,3,6421,6424
2022/12/01,01:30:00,337.25,5,6215,6220
2022/12/01,02:00:00,336.97,5,6050,6055
2022/12/01,02:30:00,336.41,5,5934,5939
2022/12/01,03:00:00,336.69,5,5857,5862
2022/12/01,03:30:00,336.41,5,5869,5874
2022/12/01,04:00:00,337.25,0,5909,5909
2022/12/01,04:30:00,336.41,0,6041,6041
2022/12/01,05:00:00,337.84,0,6224,6224
2022/12/01,05:30:00,336.97,0,6473,6473
2022/12/01,06:00:00,337.84,0,6674,6674
2022/12/01,06:30:00,336.97,2,7019,7021
2022/12/01,07:00:00,337.55,204,7197,7401
2022/12/01,07:30:00,337.84,651,7063,7714
2022/12/01,08:00:00,337.55,1169,6532,7701
2022/12/01,08:30:00,336.41,1586,6187,7773
2022/12/01,09:00:00,338.76,1984,5816,7800
2022/12/01,09:30:00,336.41,2268,5605,7873
2022/12/01,10:00:00,337.55,2396,5432,7828
2022/12/01,10:30:00,338.45,2505,5317,7822
2022/12/01,11:00:00,338.45,2568,5244,7812
2022/12/01,11:30:00,338.45,2568,5192,7760
2022/12/01,12:00:00,338.45,2527,5245,7772
2022/12/01,12:30:00,337.25,2476,5305,7781
2022/12/01,13:00:00,337.25,2402,5438,7840
2022/12/01,13:30:00,338.14,2262,5679,7941
2022/12/01,14:00:00,338.14,2024,5983,8007
2022/12/01,14:30:00,338.14,1730,6372,8102
2022/12/01,15:00:00,338.14,1341,6793,8134
2022/12/01,15:30:00,349.99,971,7258,8229
2022/12/01,16:00:00,401.19,490,7609,8099
2022/12/01,16:30:00,401.55,126,8036,8162
2022/12/01,17:00:00,399.5,143,8581,8724
2022/12/01,17:30:00,405.33,148,8856,9004
2022/12/01,18:00:00,403.48,145,8953,9098
2022/12/01,18:30:00,403.24,136,9031,9167
2022/12/01,19:00:00,402.33,32,9055,9087
2022/12/01,19:30:00,399.5,31,8998,9029
2022/12/01,20:00:00,348.94,31,8887,8918
2022/12/01,20:30:00,351.52,31,8762,8793
2022/12/01,21:00:00,338.45,32,8550,8582
2022/12/01,21:30:00,337.84,32,8331,8363
2022/12/01,22:00:00,335.67,36,8070,8106
2022/12/01,22:30:00,335.67,12,7923,7935
2022/12/01,23:00:00,335.67,10,7608,7618
2022/12/01,23:30:00,335.59,5,7326,7331
2022/12/02,00:00:00,335.59,5,6991,6996
2022/12/02,00:30:00,335.67,4,6688,6692
2022/12/02,01:00:00,335.67,5,6386,6391
2022/12/02,01:30:00,335.67,7,6165,6172
2022/12/02,02:00:00,335.51,8,6047,6055
2022/12/02,02:30:00,335.67,9,5961,5970
2022/12/02,03:00:00,335.59,12,5859,5871
2022/12/02,03:30:00,335.59,11,5850,5861
2022/12/02,04:00:00,335.67,11,5834,5845
2022/12/02,04:30:00,335.59,15,5871,5886
2022/12/02,05:00:00,335.67,18,6028,6046
2022/12/02,05:30:00,335.67,18,6201,6219
2022/12/02,06:00:00,335.67,21,6336,6357
2022/12/02,06:30:00,335.59,17,6332,6349
2022/12/02,07:00:00,335.59,189,6411,6600
2022/12/02,07:30:00,335.67,575,6326,6901
2022/12/02,08:00:00,335.75,1077,5911,6988
2022/12/02,08:30:00,336.43,1511,5645,7156
2022/12/02,09:00:00,336.34,1980,5318,7298
2022/12/02,09:30:00,336.26,2206,5177,7383
2022/12/02,10:00:00,336.34,2368,5111,7479
2022/12/02,10:30:00,336.34,2477,5066,7543
2022/12/02,11:00:00,336.17,2545,5066,7611
2022/12/02,11:30:00,336.26,2540,5080,7620
2022/12/02,12:00:00,336.34,2543,4993,7536
2022/12/02,12:30:00,336.26,2485,5121,7606
2022/12/02,13:00:00,336.17,2411,5185,7596
2022/12/02,13:30:00,336.43,2240,5447,7687
2022/12/02,14:00:00,336.34,2045,5680,7725
2022/12/02,14:30:00,336.34,1726,6069,7795
2022/12/02,15:00:00,336.34,1330,6587,7917
2022/12/02,15:30:00,336.34,874,7178,8052
2022/12/02,16:00:00,336.43,397,7551,7948
2022/12/02,16:30:00,336.34,128,7684,7812
2022/12/02,17:00:00,336.34,141,8046,8187
2022/12/02,17:30:00,336.17,142,8152,8294
2022/12/02,18:00:00,336.43,141,8119,8260
2022/12/02,18:30:00,336.34,140,7999,8139
2022/12/02,19:00:00,336.34,140,7859,7999
2022/12/02,19:30:00,336.52,140,7681,7821
2022/12/02,20:00:00,336.26,140,7526,7666
2022/12/02,20:30:00,335.83,113,7533,7646
2022/12/02,21:00:00,336,117,7477,7594
2022/12/02,21:30:00,336,73,7389,7462
2022/12/02,22:00:00,335.92,6,7333,7339
2022/12/02,22:30:00,335.83,7,7146,7153
2022/12/02,23:00:00,335.75,5,6937,6942
2022/12/02,23:30:00,335.67,6,6713,6719
2022/12/03,00:00:00,335.59,7,6486,6493
2022/12/03,00:30:00,335.67,8,6286,6294
2022/12/03,01:00:00,335.67,7,6108,6115
2022/12/03,01:30:00,335.51,7,5899,5906
2022/12/03,02:00:00,335.67,8,5811,5819
2022/12/03,02:30:00,335.67,10,5723,5733
2022/12/03,03:00:00,335.67,11,5663,5674
2022/12/03,03:30:00,335.67,14,5584,5598
2022/12/03,04:00:00,335.67,11,5674,5685
2022/12/03,04:30:00,335.67,9,5711,5720
2022/12/03,05:00:00,335.67,8,5799,5807
2022/12/03,05:30:00,335.59,7,5854,5861
2022/12/03,06:00:00,335.59,10,5937,5947
2022/12/03,06:30:00,335.67,12,5838,5850
2022/12/03,07:00:00,335.59,141,5736,5877
2022/12/03,07:30:00,335.67,535,5569,6104
2022/12/03,08:00:00,335.67,743,5504,6247
2022/12/03,08:30:00,335.59,1231,5207,6438
2022/12/03,09:00:00,335.67,1217,5225,6442
2022/12/03,09:30:00,335.67,1279,5281,6560
2022/12/03,10:00:00,335.67,1887,4975,6862
2022/12/03,10:30:00,335.51,2087,4799,6886
2022/12/03,11:00:00,336.34,2420,4528,6948
2022/12/03,11:30:00,336.26,2512,4482,6994
2022/12/03,12:00:00,336.17,2505,4424,6929
2022/12/03,12:30:00,336.26,2462,4374,6836
2022/12/03,13:00:00,336.26,2374,4548,6922
2022/12/03,13:30:00,336.43,2113,4836,6949
2022/12/03,14:00:00,336.26,1928,4986,6914
2022/12/03,14:30:00,336.26,1635,5380,7015
2022/12/03,15:00:00,336.26,1297,5724,7021
2022/12/03,15:30:00,336.17,895,6188,7083
2022/12/03,16:00:00,336.34,379,6722,7101
2022/12/03,16:30:00,337.31,66,7235,7301
2022/12/03,17:00:00,476.93,17,7757,7774
2022/12/03,17:30:00,480.83,19,8064,8083
2022/12/03,18:00:00,477.32,18,8370,8388
2022/12/03,18:30:00,473.78,21,8470,8491
2022/12/03,19:00:00,369.98,21,8433,8454
2022/12/03,19:30:00,336.26,16,8459,8475
2022/12/03,20:00:00,336.34,18,8357,8375
2022/12/03,20:30:00,336.34,21,8238,8259
2022/12/03,21:00:00,336.26,22,8186,8208
2022/12/03,21:30:00,336.43,24,8030,8054
2022/12/03,22:00:00,336.26,25,7910,7935
2022/12/03,22:30:00,336.34,22,7661,7683
2022/12/03,23:00:00,336.34,26,7348,7374
2022/12/03,23:30:00,336.26,25,6988,7013
2022/12/04,00:00:00,336.34,27,6666,6693
2022/12/04,00:30:00,336.26,25,6327,6352
2022/12/04,01:00:00,336.43,28,6065,6093
2022/12/04,01:30:00,336.43,28,5916,5944
2022/12/04,02:00:00,336.26,25,5771,5796
2022/12/04,02:30:00,336.52,26,5610,5636
2022/12/04,03:00:00,336.26,19,5604,5623
2022/12/04,03:30:00,336.43,20,5614,5634
2022/12/04,04:00:00,336.34,20,5624,5644
2022/12/04,04:30:00,336.34,22,5787,5809
2022/12/04,05:00:00,336.34,20,5952,5972
2022/12/04,05:30:00,336.34,22,6270,6292
2022/12/04,06:00:00,336.26,24,6488,6512
2022/12/04,06:30:00,336.26,28,6787,6815
2022/12/04,07:00:00,336.34,166,7072,7238
2022/12/04,07:30:00,336.34,426,7122,7548
2022/12/04,08:00:00,336.34,843,6751,7594
2022/12/04,08:30:00,336.34,1456,6370,7826
2022/12/04,09:00:00,336.26,1849,6063,7912
2022/12/04,09:30:00,336.43,2126,5807,7933
2022/12/04,10:00:00,336.43,2272,5582,7854
2022/12/04,10:30:00,336.34,2396,5422,7818
2022/12/04,11:00:00,336.34,2424,5384,7808
2022/12/04,11:30:00,336.52,2498,5342,7840
2022/12/04,12:00:00,336.26,2448,5310,7758
2022/12/04,12:30:00,336.34,2412,5430,7842
2022/12/04,13:00:00,336.17,2305,5629,7934
2022/12/04,13:30:00,336.43,2173,5929,8102
2022/12/04,14:00:00,336.34,1963,6268,8231
2022/12/04,14:30:00,336.34,1597,6677,8274
2022/12/04,15:00:00,336.43,1232,7106,8338
2022/12/04,15:30:00,379.24,793,7574,8367
2022/12/04,16:00:00,464.21,376,7827,8203
2022/12/04,16:30:00,460.49,127,8229,8356
2022/12/04,17:00:00,399,143,8748,8891
2022/12/04,17:30:00,399.02,143,8973,9116
2022/12/04,18:00:00,451.95,144,9078,9222
2022/12/04,18:30:00,441.06,146,9136,9282
2022/12/04,19:00:00,407.75,147,9086,9233
2022/12/04,19:30:00,338.99,150,9030,9180
2022/12/04,20:00:00,379.3,148,8966,9114
2022/12/04,20:30:00,336.34,150,8748,8898
2022/12/04,21:00:00,336.34,150,8583,8733
2022/12/04,21:30:00,336.43,127,8362,8489
2022/12/04,22:00:00,336.34,40,8126,8166
2022/12/04,22:30:00,336.26,42,7934,7976
2022/12/04,23:00:00,336.34,44,7556,7600
2022/12/04,23:30:00,336.34,41,7180,7221
2022/12/05,00:00:00,336.26,36,6843,6879
2022/12/05,00:30:00,336.34,4,6579,6583
2022/12/05,01:00:00,336.26,3,6336,6339
2022/12/05,01:30:00,336.26,3,6137,6140
2022/12/05,02:00:00,336.17,4,5920,5924
2022/12/05,02:30:00,336.34,3,5817,5820
2022/12/05,03:00:00,336.34,3,5756,5759
2022/12/05,03:30:00,336.34,3,5738,5741
2022/12/05,04:00:00,336.43,4,5792,5796
2022/12/05,04:30:00,336.34,3,5906,5909
2022/12/05,05:00:00,336.34,2,6127,6129
2022/12/05,05:30:00,336.26,4,6422,6426
2022/12/05,06:00:00,336.17,4,6628,6632
2022/12/05,06:30:00,336.17,4,6979,6983
2022/12/05,07:00:00,336.34,149,7316,7465
2022/12/05,07:30:00,336.26,393,7284,7677
2022/12/05,08:00:00,336.34,796,6912,7708
2022/12/05,08:30:00,336.26,1139,6648,7787
2022/12/05,09:00:00,336.43,1562,6281,7843
2022/12/05,09:30:00,336.26,1824,6038,7862
2022/12/05,10:00:00,336.43,1944,5838,7782
2022/12/05,10:30:00,336.17,2118,5703,7821
2022/12/05,11:00:00,336.17,2195,5608,7803
2022/12/05,11:30:00,336.34,2158,5631,7789
2022/12/05,12:00:00,336.26,2178,5627,7805
2022/12/05,12:30:00,336.26,2074,5736,7810
2022/12/05,13:00:00,336.26,1918,5982,7900
2022/12/05,13:30:00,336.26,1803,6277,8080
2022/12/05,14:00:00,336.34,1651,6559,8210
2022/12/05,14:30:00,336.34,1321,6911,8232
2022/12/05,15:00:00,336.34,981,7353,8334
2022/12/05,15:30:00,379.35,594,7811,8405
2022/12/05,16:00:00,376.86,211,8050,8261
2022/12/05,16:30:00,391.37,25,8452,8477
2022/12/05,17:00:00,351.6,50,8939,8989
2022/12/05,17:30:00,401.64,44,9206,9250
2022/12/05,18:00:00,396.56,46,9310,9356
2022/12/05,18:30:00,407.88,39,9387,9426
2022/12/05,19:00:00,405.19,37,9354,9391
2022/12/05,19:30:00,405.13,33,9301,9334
2022/12/05,20:00:00,404.84,34,9214,9248
2022/12/05,20:30:00,376.92,33,9050,9083
2022/12/05,21:00:00,361.19,38,8802,8840
2022/12/05,21:30:00,335.67,32,8496,8528
2022/12/05,22:00:00,335.59,31,8231,8262
2022/12/05,22:30:00,335.51,30,8003,8033
2022/12/05,23:00:00,336.09,30,7649,7679
2022/12/05,23:30:00,335.51,29,7292,7321
2022/12/06,00:00:00,335.59,29,6916,6945
2022/12/06,00:30:00,335.51,0,6638,6638
2022/12/06,01:00:00,335.59,0,6332,6332
2022/12/06,01:30:00,335.59,0,6148,6148
2022/12/06,02:00:00,335.43,0,5986,5986
2022/12/06,02:30:00,335.59,0,5894,5894
2022/12/06,03:00:00,335.59,0,5832,5832
2022/12/06,03:30:00,335.59,0,5793,5793
2022/12/06,04:00:00,335.59,0,5863,5863
2022/12/06,04:30:00,374.07,0,6003,6003
2022/12/06,05:00:00,374.07,0,6178,6178
2022/12/06,05:30:00,373.95,0,6493,6493
2022/12/06,06:00:00,373.95,0,6778,6778
2022/12/06,06:30:00,373.95,0,7080,7080
2022/12/06,07:00:00,374.07,177,7455,7632
2022/12/06,07:30:00,374.32,437,7472,7909
2022/12/06,08:00:00,374.32,844,7108,7952
2022/12/06,08:30:00,368.34,1241,6778,8019
2022/12/06,09:00:00,368.88,1625,6428,8053
2022/12/06,09:30:00,369.16,1929,6117,8046
2022/12/06,10:00:00,368.88,2112,5820,7932
2022/12/06,10:30:00,369.35,2009,5881,7890
2022/12/06,11:00:00,368.88,1865,6087,7952
2022/12/06,11:30:00,368.98,1922,6276,8198
2022/12/06,12:00:00,369.16,1907,6393,8300
2022/12/06,12:30:00,368.61,1887,6648,8535
2022/12/06,13:00:00,368.98,1754,6901,8655
2022/12/06,13:30:00,363.17,1630,6943,8573
2022/12/06,14:00:00,366.55,1398,7283,8681
2022/12/06,14:30:00,368.61,1046,7617,8663
2022/12/06,15:00:00,368.88,830,7816,8646
2022/12/06,15:30:00,369.07,608,8172,8780
2022/12/06,16:00:00,369.07,269,8337,8606
2022/12/06,16:30:00,369.07,0,8766,8766
2022/12/06,17:00:00,374.25,17,9318,9335
2022/12/06,17:30:00,372.7,19,9580,9599
2022/12/06,18:00:00,368.88,26,9700,9726
2022/12/06,18:30:00,362.93,29,9739,9768
2022/12/06,19:00:00,361.35,31,9709,9740
2022/12/06,19:30:00,361.34,32,9618,9650
2022/12/06,20:00:00,361.9,31,9469,9500
2022/12/06,20:30:00,362.7,32,9359,9391
2022/12/06,21:00:00,368.43,33,9103,9136
2022/12/06,21:30:00,367.91,32,8768,8800
2022/12/06,22:00:00,369.16,32,8449,8481
2022/12/06,22:30:00,369.07,31,8238,8269
2022/12/06,23:00:00,369.07,32,7885,7917
2022/12/06,23:30:00,369.07,5,7406,7411
2022/12/07,00:00:00,369.07,0,7069,7069
2022/12/07,00:30:00,368.98,0,6684,6684
2022/12/07,01:00:00,369.16,0,6401,6401
2022/12/07,01:30:00,369.16,0,6219,6219
2022/12/07,02:00:00,369.07,0,6065,6065
2022/12/07,02:30:00,369.07,0,5948,5948
2022/12/07,03:00:00,368.98,0,5894,5894
2022/12/07,03:30:00,368.98,0,5837,5837
2022/12/07,04:00:00,368.79,0,5877,5877
2022/12/07,04:30:00,369.07,0,6015,6015
2022/12/07,05:00:00,369.16,0,6208,6208
2022/12/07,05:30:00,368.98,0,6533,6533
2022/12/07,06:00:00,392,0,6802,6802
2022/12/07,06:30:00,368.98,0,7199,7199
2022/12/07,07:00:00,399.18,8,7483,7631
2022/12/07,07:30:00,386.87,3,7473,7936
2022/12/07,08:00:00,369.07,3,7091,7974
2022/12/07,08:30:00,368.98,4,6848,8192
2022/12/07,09:00:00,369.16,8,6487,8155
2022/12/07,09:30:00,369.07,8,6199,8247
2022/12/07,10:00:00,369.16,5,6095,8240
2022/12/07,10:30:00,368.98,7,6142,8189
2022/12/07,11:00:00,369.16,3,6141,8214
2022/12/07,11:30:00,369.16,3,6211,8404
2022/12/07,12:00:00,368.98,5,6228,8313
2022/12/07,12:30:00,369.07,2,6603,8395
2022/12/07,13:00:00,369.07,3,7032,8475
2022/12/07,13:30:00,369.07,1,7299,8520
2022/12/07,14:00:00,369.07,5,7548,8713
2022/12/07,14:30:00,369.07,0,7526,8836
2022/12/07,15:00:00,368.88,8,7815,8873
2022/12/07,15:30:00,369.07,1,8061,8862
2022/12/07,16:00:00,369.07,9,8219,8648
2022/12/07,16:30:00,390.47,2,8686,8808
2022/12/07,17:00:00,392.44,0,9177,9317
2022/12/07,17:30:00,368.98,1,9485,9626
2022/12/07,18:00:00,388.78,2,9542,9684
2022/12/07,18:30:00,388.75,3,9595,9738
2022/12/07,19:00:00,392.74,2,9556,9698
2022/12/07,19:30:00,388.7,3,9498,9641
2022/12/07,20:00:00,388.7,3,9408,9551
2022/12/07,20:30:00,374.45,1,9232,9363
2022/12/07,21:00:00,374.19,1,9081,9112
2022/12/07,21:30:00,374.45,1,8804,8835
2022/12/07,22:00:00,374.45,3,8453,8486
2022/12/07,22:30:00,374.45,5,8287,8322
2022/12/07,23:00:00,374.32,3,7886,7929
2022/12/07,23:30:00,374.45,1,7465,7506
2022/12/08,00:00:00,374.32,40,7074,7114
2022/12/08,00:30:00,374.32,16,6763,6779
2022/12/08,01:00:00,374.45,18,6459,6477
2022/12/08,01:30:00,374.45,15,6239,6254
2022/12/08,02:00:00,374.45,19,6062,6081
2022/12/08,02:30:00,374.45,20,5966,5986
2022/12/08,03:00:00,374.32,12,5913,5925
2022/12/08,03:30:00,374.32,12,5850,5862
2022/12/08,04:00:00,374.32,15,5861,5876
2022/12/08,04:30:00,374.32,18,6008,6026
2022/12/08,05:00:00,374.32,17,6210,6227
2022/12/08,05:30:00,374.32,19,6524,6543
2022/12/08,06:00:00,374.32,20,6783,6803
2022/12/08,06:30:00,374.07,17,7143,7160
2022/12/08,07:00:00,374.32,29,7494,7523
2022/12/08,07:30:00,374.32,427,7485,7912
2022/12/08,08:00:00,374.32,869,7031,7900
2022/12/08,08:30:00,374.32,1311,6690,8001
2022/12/08,09:00:00,374.32,1681,6327,8008
2022/12/08,09:30:00,374.07,2001,5994,7995
2022/12/08,10:00:00,374.32,2200,5785,7985
2022/12/08,10:30:00,374.32,2367,5593,7960
2022/12/08,11:00:00,374.45,2374,5522,7896
2022/12/08,11:30:00,374.45,2343,5540,7883
2022/12/08,12:00:00,374.32,2346,5554,7900
2022/12/08,12:30:00,374.45,2240,5654,7894
2022/12/08,13:00:00,374.32,2155,5834,7989
2022/12/08,13:30:00,374.32,2093,6062,8155
2022/12/08,14:00:00,374.32,1926,6312,8238
2022/12/08,14:30:00,374.32,1577,6706,8283
2022/12/08,15:00:00,361.02,1234,7138,8372
2022/12/08,15:30:00,341.21,797,7586,8383
2022/12/08,16:00:00,374.19,379,7915,8294
2022/12/08,16:30:00,374.32,126,8357,8483
2022/12/08,17:00:00,360.26,138,8977,9115
2022/12/08,17:30:00,373.1,138,9249,9387
2022/12/08,18:00:00,374.07,145,9340,9485
2022/12/08,18:30:00,374.32,147,9396,9543
2022/12/08,19:00:00,374.32,110,9373,9483
2022/12/08,19:30:00,374.19,44,9400,9444
2022/12/08,20:00:00,374.45,55,9248,9303
2022/12/08,20:30:00,374.19,48,9072,9120
2022/12/08,21:00:00,374.19,52,8868,8920
2022/12/08,21:30:00,368.34,62,8582,8644
2022/12/08,22:00:00,367.91,68,8309,8377
2022/12/08,22:30:00,371.61,74,8120,8194
2022/12/08,23:00:00,374.45,73,7843,7916
2022/12/08,23:30:00,374.45,77,7483,7560
2022/12/09,00:00:00,374.19,77,7145,7222
2022/12/09,00:30:00,374.19,47,6854,6901
2022/12/09,01:00:00,374.19,47,6546,6593
2022/12/09,01:30:00,374.19,41,6346,6387
2022/12/09,02:00:00,374.45,40,6137,6177
2022/12/09,02:30:00,374.19,32,6016,6048
2022/12/09,03:00:00,374.45,34,5907,5941
2022/12/09,03:30:00,374.45,41,5882,5923
2022/12/09,04:00:00,374.45,36,5874,5910
2022/12/09,04:30:00,374.19,30,5974,6004
2022/12/09,05:00:00,374.45,24,6127,6151
2022/12/09,05:30:00,374.19,21,6318,6339
2022/12/09,06:00:00,374.19,17,6447,6464
2022/12/09,06:30:00,374.32,21,6506,6527
2022/12/09,07:00:00,374.19,27,6646,6673
2022/12/09,07:30:00,374.32,403,6661,7064
2022/12/09,08:00:00,374.19,837,6391,7228
2022/12/09,08:30:00,374.32,1280,6132,7412
2022/12/09,09:00:00,374.32,1571,5911,7482
2022/12/09,09:30:00,374.57,1930,5674,7604
2022/12/09,10:00:00,374.07,2126,5529,7655
2022/12/09,10:30:00,372.98,2258,5451,7709
2022/12/09,11:00:00,374.7,2335,5399,7734
2022/12/09,11:30:00,374.32,2370,5353,7723
2022/12/09,12:00:00,374.19,2359,5292,7651
2022/12/09,12:30:00,374.19,2294,5348,7642
2022/12/09,13:00:00,374.19,2213,5461,7674
2022/12/09,13:30:00,374.45,2024,5695,7719
2022/12/09,14:00:00,374.32,1843,6044,7887
2022/12/09,14:30:00,374.32,1540,6400,7940
2022/12/09,15:00:00,374.32,1126,6926,8052
2022/12/09,15:30:00,374.32,683,7514,8197
2022/12/09,16:00:00,374.32,276,7880,8156
2022/12/09,16:30:00,390.28,6,8035,8041
2022/12/09,17:00:00,374.32,1,8448,8449
2022/12/09,17:30:00,380.06,1,8564,8565
2022/12/09,18:00:00,392.7,0,8545,8545
2022/12/09,18:30:00,374.57,2,8420,8422
2022/12/09,19:00:00,374.32,6,8228,8234
2022/12/09,19:30:00,374.32,9,8009,8018
2022/12/09,20:00:00,374.32,13,7865,7878
2022/12/09,20:30:00,374.32,19,7873,7892
2022/12/09,21:00:00,374.19,15,7833,7848
2022/12/09,21:30:00,374.19,18,7695,7713
2022/12/09,22:00:00,374.19,21,7519,7540
2022/12/09,22:30:00,374.19,21,7367,7388
2022/12/09,23:00:00,374.19,20,7112,7132
2022/12/09,23:30:00,374.45,20,6953,6973
2022/12/10,00:00:00,374.19,18,6719,6737
2022/12/10,00:30:00,374.32,18,6448,6466
2022/12/10,01:00:00,374.32,17,6247,6264
2022/12/10,01:30:00,374.32,22,6011,6033
2022/12/10,02:00:00,374.32,21,5906,5927
2022/12/10,02:30:00,374.32,17,5782,5799
2022/12/10,03:00:00,374.32,18,5718,5736
2022/12/10,03:30:00,374.32,15,5698,5713
2022/12/10,04:00:00,374.32,13,5720,5733
2022/12/10,04:30:00,374.32,8,5787,5795
2022/12/10,05:00:00,374.32,2,5868,5870
2022/12/10,05:30:00,374.32,2,5971,5973
2022/12/10,06:00:00,374.32,2,6042,6044
2022/12/10,06:30:00,374.32,1,5979,5980
2022/12/10,07:00:00,374.32,11,5892,5903
2022/12/10,07:30:00,374.32,418,5774,6192
2022/12/10,08:00:00,374.32,915,5446,6361
2022/12/10,08:30:00,374.32,1367,5220,6587
2022/12/10,09:00:00,374.32,1764,4941,6705
2022/12/10,09:30:00,374.32,2075,4700,6775
2022/12/10,10:00:00,374.32,2287,4536,6823
2022/12/10,10:30:00,374.32,2404,4431,6835
2022/12/10,11:00:00,374.32,2453,4347,6800
2022/12/10,11:30:00,374.32,2476,4295,6771
2022/12/10,12:00:00,374.32,2445,4308,6753
2022/12/10,12:30:00,374.32,2423,4345,6768
2022/12/10,13:00:00,374.45,2348,4429,6777
2022/12/10,13:30:00,374.19,2195,4619,6814
2022/12/10,14:00:00,374.32,1937,4875,6812
2022/12/10,14:30:00,374.32,1643,5239,6882
2022/12/10,15:00:00,374.32,1253,5714,6967
2022/12/10,15:30:00,374.32,820,6262,7082
2022/12/10,16:00:00,374.32,356,6808,7164
2022/12/10,16:30:00,374.32,70,7384,7454
2022/12/10,17:00:00,374.32,30,7965,7995
2022/12/10,17:30:00,374.32,30,8288,8318
2022/12/10,18:00:00,374.32,30,8611,8641
2022/12/10,18:30:00,374.32,30,8654,8684
2022/12/10,19:00:00,374.32,32,8550,8582
2022/12/10,19:30:00,374.32,32,8630,8662
2022/12/10,20:00:00,374.32,32,8583,8615
2022/12/10,20:30:00,374.32,32,8516,8548
2022/12/10,21:00:00,374.32,32,8363,8395
2022/12/10,21:30:00,374.32,37,8299,8336
2022/12/10,22:00:00,374.32,46,8139,8185
2022/12/10,22:30:00,374.32,57,7872,7929
2022/12/10,23:00:00,374.32,62,7517,7579
2022/12/10,23:30:00,374.32,59,7177,7236
2022/12/11,00:00:00,374.32,57,6802,6859
2022/12/11,00:30:00,374.32,32,6500,6532
2022/12/11,01:00:00,374.07,32,6209,6241
2022/12/11,01:30:00,374.45,37,5954,5991
2022/12/11,02:00:00,374.45,33,5782,5815
2022/12/11,02:30:00,374.45,29,5676,5705
2022/12/11,03:00:00,374.19,26,5609,5635
2022/12/11,03:30:00,374.32,27,5587,5614
2022/12/11,04:00:00,374.32,27,5655,5682
2022/12/11,04:30:00,374.32,24,5794,5818
2022/12/11,05:00:00,374.32,30,5977,6007
2022/12/11,05:30:00,374.32,26,6339,6365
2022/12/11,06:00:00,374.32,26,6591,6617
2022/12/11,06:30:00,374.19,28,6968,6996
2022/12/11,07:00:00,374.19,179,7287,7466
2022/12/11,07:30:00,374.19,479,7274,7753
2022/12/11,08:00:00,374.19,961,6822,7783
2022/12/11,08:30:00,374.19,1431,6450,7881
2022/12/11,09:00:00,374.19,1812,6175,7987
2022/12/11,09:30:00,374.32,2121,5864,7985
2022/12/11,10:00:00,374.32,2313,5636,7949
2022/12/11,10:30:00,374.32,2427,5505,7932
2022/12/11,11:00:00,373.95,2432,5447,7879
2022/12/11,11:30:00,374.19,2486,5401,7887
2022/12/11,12:00:00,374.19,2468,5397,7865
2022/12/11,12:30:00,374.19,2429,5463,7892
2022/12/11,13:00:00,374.19,2355,5689,8044
2022/12/11,13:30:00,374.45,2224,5926,8150
2022/12/11,14:00:00,374.19,2013,6213,8226
2022/12/11,14:30:00,374.45,1695,6589,8284
2022/12/11,15:00:00,374.45,1325,7057,8382
2022/12/11,15:30:00,374.33,890,7568,8458
2022/12/11,16:00:00,374.45,409,7820,8229
2022/12/11,16:30:00,393.45,112,8259,8371
2022/12/11,17:00:00,391.83,124,8895,9019
2022/12/11,17:30:00,392.34,130,9170,9300
2022/12/11,18:00:00,392.34,141,9299,9440
2022/12/11,18:30:00,392.34,150,9392,9542
2022/12/11,19:00:00,392.34,145,9396,9541
2022/12/11,19:30:00,392.34,151,9338,9489
2022/12/11,20:00:00,373.84,148,9253,9401
2022/12/11,20:30:00,374.32,150,9104,9254
2022/12/11,21:00:00,373.95,152,8905,9057
2022/12/11,21:30:00,381.36,156,8602,8758
2022/12/11,22:00:00,334.42,50,8396,8446
2022/12/11,22:30:00,334.42,21,8250,8271
2022/12/11,23:00:00,334.08,23,7875,7898
2022/12/11,23:30:00,335.5,21,7428,7449
2022/12/12,00:00:00,334.78,25,7015,7040
2022/12/12,00:30:00,334.78,20,6671,6691
2022/12/12,01:00:00,335.13,16,6367,6383
2022/12/12,01:30:00,334.78,13,6156,6169
2022/12/12,02:00:00,335.5,11,5989,6000
2022/12/12,02:30:00,333.4,8,5906,5914
2022/12/12,03:00:00,334.08,6,5845,5851
2022/12/12,03:30:00,334.08,6,5842,5848
2022/12/12,04:00:00,334.78,7,5883,5890
2022/12/12,04:30:00,334.78,7,6040,6047
2022/12/12,05:00:00,335.5,9,6223,6232
2022/12/12,05:30:00,334.42,39,6557,6596
2022/12/12,06:00:00,334.42,40,6802,6842
2022/12/12,06:30:00,334.42,25,7174,7199
2022/12/12,07:00:00,334.42,130,7515,7645
2022/12/12,07:30:00,334.42,431,7596,8027
2022/12/12,08:00:00,334.78,895,7049,7944
2022/12/12,08:30:00,333.06,1351,6736,8087
2022/12/12,09:00:00,332.73,1524,6414,7938
2022/12/12,09:30:00,333.73,1789,6165,7954
2022/12/12,10:00:00,333.73,2007,5954,7961
2022/12/12,10:30:00,334.78,2117,5833,7950
2022/12/12,11:00:00,335.13,1977,5782,7759
2022/12/12,11:30:00,334.78,2015,5776,7791
2022/12/12,12:00:00,334.42,2165,5716,7881
2022/12/12,12:30:00,335.13,2288,5661,7949
2022/12/12,13:00:00,335.13,2290,5740,8030
2022/12/12,13:30:00,334.08,2125,6053,8178
2022/12/12,14:00:00,335.86,1922,6326,8248
2022/12/12,14:30:00,361.11,1601,6731,8332
2022/12/12,15:00:00,361.11,1202,7168,8370
2022/12/12,15:30:00,340.16,767,7620,8387
2022/12/12,16:00:00,369.59,386,7803,8189
2022/12/12,16:30:00,362.97,95,8253,8348
2022/12/12,17:00:00,366.66,110,8873,8983
2022/12/12,17:30:00,382.64,112,9131,9243
2022/12/12,18:00:00,392.54,112,9289,9401
2022/12/12,18:30:00,394.24,112,9394,9506
2022/12/12,19:00:00,401.63,114,9376,9490
2022/12/12,19:30:00,364.69,118,9348,9466
2022/12/12,20:00:00,395.66,25,9385,9410
2022/12/12,20:30:00,333.06,35,9231,9266
2022/12/12,21:00:00,333.73,42,9016,9058
2022/12/12,21:30:00,333.06,44,8728,8772
2022/12/12,22:00:00,333.06,43,8433,8476
2022/12/12,22:30:00,333.4,39,8228,8267
2022/12/12,23:00:00,333.4,43,7832,7875
2022/12/12,23:30:00,333.4,37,7439,7476
2022/12/13,00:00:00,333.4,34,7027,7061
2022/12/13,00:30:00,333.73,29,6681,6710
2022/12/13,01:00:00,333.06,20,6406,6426
2022/12/13,01:30:00,333.4,20,6195,6215
2022/12/13,02:00:00,333.4,24,6003,6027
2022/12/13,02:30:00,333.4,15,5917,5932
2022/12/13,03:00:00,340.45,11,5863,5874
2022/12/13,03:30:00,339.65,6,5844,5850
2022/12/13,04:00:00,339.43,10,5865,5875
2022/12/13,04:30:00,339.65,10,6046,6056
2022/12/13,05:00:00,339.65,4,6252,6256
2022/12/13,05:30:00,339.54,15,6578,6593
2022/12/13,06:00:00,339.54,9,6807,6816
2022/12/13,06:30:00,339.65,7,7164,7171
2022/12/13,07:00:00,339.32,4,7511,7515
2022/12/13,07:30:00,339.54,332,7632,7964
2022/12/13,08:00:00,339.54,683,7226,7909
2022/12/13,08:30:00,339.54,934,7077,8011
2022/12/13,09:00:00,339.54,1283,6776,8059
2022/12/13,09:30:00,340.57,1401,6713,8114
2022/12/13,10:00:00,333.4,1615,6461,8076
2022/12/13,10:30:00,333.4,1493,6416,7909
2022/12/13,11:00:00,333.4,1732,6163,7895
2022/12/13,11:30:00,333.06,1864,5972,7836
2022/12/13,12:00:00,334.08,1826,6090,7916
2022/12/13,12:30:00,333.06,1662,6223,7885
2022/12/13,13:00:00,333.4,1534,6463,7997
2022/12/13,13:30:00,333.73,1362,6773,8135
2022/12/13,14:00:00,333.73,1208,7058,8266
2022/12/13,14:30:00,333.4,1039,7267,8306
2022/12/13,15:00:00,333.4,894,7568,8462
2022/12/13,15:30:00,333.4,510,7960,8470
2022/12/13,16:00:00,333.06,241,8079,8320
2022/12/13,16:30:00,333.73,0,8494,8494
2022/12/13,17:00:00,394.33,0,9098,9098
2022/12/13,17:30:00,403.88,0,9347,9347
2022/12/13,18:00:00,410.71,0,9468,9468
2022/12/13,18:30:00,408.08,0,9539,9539
2022/12/13,19:00:00,391.56,0,9510,9510
2022/12/13,19:30:00,391.19,1,9483,9484
2022/12/13,20:00:00,396.1,1,9377,9378
2022/12/13,20:30:00,388.94,0,9267,9267
2022/12/13,21:00:00,390.72,0,9051,9051
2022/12/13,21:30:00,335.13,4,8688,8692
2022/12/13,22:00:00,335.13,14,8407,8421
2022/12/13,22:30:00,335.13,8,8209,8217
2022/12/13,23:00:00,335.5,14,7905,7919
2022/12/13,23:30:00,335.13,18,7485,7503
2022/12/14,00:00:00,335.5,22,7073,7095
2022/12/14,00:30:00,335.13,23,6681,6704
2022/12/14,01:00:00,334.78,24,6386,6410
2022/12/14,01:30:00,335.5,36,6147,6183
2022/12/14,02:00:00,335.13,37,6002,6039
2022/12/14,02:30:00,335.5,35,5899,5934
2022/12/14,03:00:00,335.13,30,5839,5869
2022/12/14,03:30:00,335.5,25,5846,5871
2022/12/14,04:00:00,334.78,40,5864,5904
2022/12/14,04:30:00,335.13,26,6013,6039
2022/12/14,05:00:00,334.78,36,6193,6229
2022/12/14,05:30:00,334.78,38,6497,6535
2022/12/14,06:00:00,335.13,30,6725,6755
2022/12/14,06:30:00,335.13,32,7124,7156
2022/12/14,07:00:00,335.13,34,7542,7576
2022/12/14,07:30:00,335.13,300,7786,8086
2022/12/14,08:00:00,335.13,417,7713,8130
2022/12/14,08:30:00,334.78,540,7826,8366
2022/12/14,09:00:00,334.78,699,7796,8495
2022/12/14,09:30:00,335.5,816,7754,8570
2022/12/14,10:00:00,335.13,1325,7262,8587
2022/12/14,10:30:00,335.5,1505,7132,8637
2022/12/14,11:00:00,334.78,1751,6817,8568
2022/12/14,11:30:00,335.13,1871,6779,8650
2022/12/14,12:00:00,335.13,1884,6728,8612
2022/12/14,12:30:00,335.13,1892,6823,8715
2022/12/14,13:00:00,335.86,1698,7044,8742
2022/12/14,13:30:00,335.5,1699,7192,8891
2022/12/14,14:00:00,335.13,1721,7301,9022
2022/12/14,14:30:00,335.5,1426,7640,9066
2022/12/14,15:00:00,335.5,1126,7893,9019
2022/12/14,15:30:00,335.13,759,8262,9021
2022/12/14,16:00:00,335.86,340,8339,8679
2022/12/14,16:30:00,393.15,90,8727,8817
2022/12/14,17:00:00,401.41,96,9333,9429
2022/12/14,17:30:00,397.98,99,9582,9681
2022/12/14,18:00:00,400.05,99,9700,9799
2022/12/14,18:30:00,398.54,99,9736,9835
2022/12/14,19:00:00,399.8,97,9694,9791
2022/12/14,19:30:00,401.57,51,9688,9739
2022/12/14,20:00:00,349.94,0,9625,9625
2022/12/14,20:30:00,335.13,0,9444,9444
2022/12/14,21:00:00,335.86,0,9182,9182
2022/12/14,21:30:00,335.5,0,8799,8799
2022/12/14,22:00:00,335.86,0,8581,8581
2022/12/14,22:30:00,335.5,0,8386,8386
2022/12/14,23:00:00,334.78,0,8061,8061
2022/12/14,23:30:00,335.86,1,7674,7675
2022/12/15,00:00:00,335.5,1,7187,7188
2022/12/15,00:30:00,335.5,1,6822,6823
2022/12/15,01:00:00,335.5,1,6512,6513
2022/12/15,01:30:00,334.78,1,6279,6280
2022/12/15,02:00:00,335.5,1,6131,6132
2022/12/15,02:30:00,335.5,1,5986,5987
2022/12/15,03:00:00,335.5,1,5950,5951
2022/12/15,03:30:00,335.13,1,5943,5944
2022/12/15,04:00:00,334.42,1,5969,5970
2022/12/15,04:30:00,335.13,1,6073,6074
2022/12/15,05:00:00,334.78,1,6287,6288
2022/12/15,05:30:00,335.13,1,6574,6575
2022/12/15,06:00:00,335.13,1,6827,6828
2022/12/15,06:30:00,371.81,1,7240,7241
2022/12/15,07:00:00,335.5,5,7567,7572
2022/12/15,07:30:00,335.13,366,7672,8038
2022/12/15,08:00:00,374.22,700,7372,8072
2022/12/15,08:30:00,335.86,1071,7198,8269
2022/12/15,09:00:00,335.5,1422,6909,8331
2022/12/15,09:30:00,335.13,1759,6701,8460
2022/12/15,10:00:00,335.13,2025,6465,8490
2022/12/15,10:30:00,335.5,2138,6308,8446
2022/12/15,11:00:00,335.5,2255,6143,8398
2022/12/15,11:30:00,335.86,2289,6075,8364
2022/12/15,12:00:00,335.13,2307,5994,8301
2022/12/15,12:30:00,335.5,2243,6143,8386
2022/12/15,13:00:00,335.5,2196,6284,8480
2022/12/15,13:30:00,335.13,2014,6676,8690
2022/12/15,14:00:00,335.5,1840,6892,8732
2022/12/15,14:30:00,335.5,1525,7236,8761
2022/12/15,15:00:00,335.13,1148,7544,8692
2022/12/15,15:30:00,335.13,710,7941,8651
2022/12/15,16:00:00,335.5,284,8079,8363
2022/12/15,16:30:00,367.46,32,8469,8501
2022/12/15,17:00:00,392.99,60,9013,9073
2022/12/15,17:30:00,393.14,95,9289,9384
2022/12/15,18:00:00,396.87,141,9313,9454
2022/12/15,18:30:00,410.72,139,9369,9508
2022/12/15,19:00:00,396.87,140,9305,9445
2022/12/15,19:30:00,394.54,139,9231,9370
2022/12/15,20:00:00,392.94,139,9127,9266
2022/12/15,20:30:00,375.68,140,8930,9070
2022/12/15,21:00:00,374.56,139,8738,8877
2022/12/15,21:30:00,335.5,139,8491,8630
2022/12/15,22:00:00,335.86,140,8139,8279
2022/12/15,22:30:00,335.5,35,8183,8218
2022/12/15,23:00:00,335.13,33,7877,7910
2022/12/15,23:30:00,336.23,36,7564,7600
2022/12/16,00:00:00,335.13,37,7141,7178
2022/12/16,00:30:00,335.5,27,6896,6923
2022/12/16,01:00:00,335.5,8,6589,6597
2022/12/16,01:30:00,334.78,11,6353,6364
2022/12/16,02:00:00,334.78,6,6193,6199
2022/12/16,02:30:00,335.5,6,6002,6008
2022/12/16,03:00:00,335.13,3,5967,5970
2022/12/16,03:30:00,334.78,2,5921,5923
2022/12/16,04:00:00,334.42,2,5900,5902
2022/12/16,04:30:00,335.5,2,5956,5958
2022/12/16,05:00:00,335.13,4,6150,6154
2022/12/16,05:30:00,335.13,3,6329,6332
2022/12/16,06:00:00,335.5,4,6436,6440
2022/12/16,06:30:00,335.13,4,6632,6636
2022/12/16,07:00:00,334.78,11,6709,6720
2022/12/16,07:30:00,335.86,395,6738,7133
2022/12/16,08:00:00,335.13,843,6411,7254
2022/12/16,08:30:00,335.86,1313,6128,7441
2022/12/16,09:00:00,335.5,1757,5798,7555
2022/12/16,09:30:00,335.86,2092,5509,7601
2022/12/16,10:00:00,335.5,2307,5357,7664
2022/12/16,10:30:00,335.86,2453,5316,7769
2022/12/16,11:00:00,335.86,2518,5246,7764
2022/12/16,11:30:00,335.86,2497,5215,7712
2022/12/16,12:00:00,335.86,2485,5164,7649
2022/12/16,12:30:00,335.86,2475,5244,7719
2022/12/16,13:00:00,335.13,2360,5365,7725
2022/12/16,13:30:00,335.5,2229,5544,7773
2022/12/16,14:00:00,336.23,2055,5873,7928
2022/12/16,14:30:00,335.5,1718,6182,7900
2022/12/16,15:00:00,335.5,1294,6675,7969
2022/12/16,15:30:00,335.13,857,7257,8114
2022/12/16,16:00:00,335.13,401,7635,8036
2022/12/16,16:30:00,335.86,70,7809,7879
2022/12/16,17:00:00,376.17,31,8220,8251
2022/12/16,17:30:00,341.23,34,8324,8358
2022/12/16,18:00:00,376.39,37,8351,8388
2022/12/16,18:30:00,335.5,43,8237,8280
2022/12/16,19:00:00,335.5,47,8021,8068
2022/12/16,19:30:00,335.5,52,7860,7912
2022/12/16,20:00:00,335.5,52,7712,7764
2022/12/16,20:30:00,335.5,58,7673,7731
2022/12/16,21:00:00,335.5,65,7602,7667
2022/12/16,21:30:00,335.13,68,7412,7480
2022/12/16,22:00:00,335.5,74,7328,7402
2022/12/16,22:30:00,335.5,76,7145,7221
2022/12/16,23:00:00,335.13,71,6960,7031
2022/12/16,23:30:00,335.5,67,6749,6816
2022/12/17,00:00:00,335.5,68,6517,6585
2022/12/17,00:30:00,335.13,63,6277,6340
2022/12/17,01:00:00,335.5,60,6127,6187
2022/12/17,01:30:00,335.13,59,5922,5981
2022/12/17,02:00:00,335.13,55,5823,5878
2022/12/17,02:30:00,334.78,49,5749,5798
2022/12/17,03:00:00,335.13,49,5671,5720
2022/12/17,03:30:00,334.42,48,5640,5688
2022/12/17,04:00:00,335.13,45,5632,5677
2022/12/17,04:30:00,335.5,44,5715,5759
2022/12/17,05:00:00,335.13,41,5782,5823
2022/12/17,05:30:00,334.42,25,5878,5903
2022/12/17,06:00:00,335.13,25,6000,6025
2022/12/17,06:30:00,334.78,24,5919,5943
2022/12/17,07:00:00,335.13,26,5869,5895
2022/12/17,07:30:00,334.42,416,5706,6122
2022/12/17,08:00:00,335.13,917,5353,6270
2022/12/17,08:30:00,335.13,1377,5062,6439
2022/12/17,09:00:00,334.78,1783,4858,6641
2022/12/17,09:30:00,335.13,2122,4611,6733
2022/12/17,10:00:00,335.5,2344,4457,6801
2022/12/17,10:30:00,335.13,2485,4327,6812
2022/12/17,11:00:00,335.5,2550,4288,6838
2022/12/17,11:30:00,335.13,2555,4266,6821
2022/12/17,12:00:00,334.78,2527,4228,6755
2022/12/17,12:30:00,335.5,2480,4270,6750
2022/12/17,13:00:00,334.78,2387,4308,6695
2022/12/17,13:30:00,335.13,2247,4512,6759
2022/12/17,14:00:00,339.88,2071,4760,6831
2022/12/17,14:30:00,340.34,1708,5140,6848
2022/12/17,15:00:00,340.34,1338,5529,6867
2022/12/17,15:30:00,340.22,906,6078,6984
2022/12/17,16:00:00,340.11,449,6614,7063
2022/12/17,16:30:00,380.75,95,7157,7252
2022/12/17,17:00:00,375.64,55,7604,7659
2022/12/17,17:30:00,335.13,55,7943,7998
2022/12/17,18:00:00,335.13,57,8206,8263
2022/12/17,18:30:00,335.13,62,8307,8369
2022/12/17,19:00:00,380.75,62,8289,8351
2022/12/17,19:30:00,370.78,64,8281,8345
2022/12/17,20:00:00,369.82,73,8227,8300
2022/12/17,20:30:00,335.13,77,8122,8199
2022/12/17,21:00:00,335.13,90,8023,8113
2022/12/17,21:30:00,334.78,99,7974,8073
2022/12/17,22:00:00,335.13,97,7811,7908
2022/12/17,22:30:00,335.86,93,7561,7654
2022/12/17,23:00:00,335.86,86,7301,7387
2022/12/17,23:30:00,335.5,80,6984,7064
2022/12/18,00:00:00,335.5,68,6644,6712
2022/12/18,00:30:00,338.67,62,6345,6407
2022/12/18,01:00:00,335.13,72,6054,6126
2022/12/18,01:30:00,335.5,69,5911,5980
2022/12/18,02:00:00,335.13,68,5745,5813
2022/12/18,02:30:00,334.78,68,5583,5651
2022/12/18,03:00:00,335.13,65,5571,5636
2022/12/18,03:30:00,335.5,61,5582,5643
2022/12/18,04:00:00,334.78,26,5568,5594
2022/12/18,04:30:00,335.13,24,5763,5787
2022/12/18,05:00:00,334.42,26,5885,5911
2022/12/18,05:30:00,335.5,20,6232,6252
2022/12/18,06:00:00,334.78,18,6481,6499
2022/12/18,06:30:00,335.86,21,6849,6870
2022/12/18,07:00:00,335.86,30,7132,7162
2022/12/18,07:30:00,335.13,426,7114,7540
2022/12/18,08:00:00,335.5,959,6659,7618
2022/12/18,08:30:00,335.13,1452,6334,7786
2022/12/18,09:00:00,335.5,1834,5965,7799
2022/12/18,09:30:00,335.13,2215,5692,7907
2022/12/18,10:00:00,335.86,2407,5454,7861
2022/12/18,10:30:00,335.5,2514,5353,7867
2022/12/18,11:00:00,335.5,2600,5267,7867
2022/12/18,11:30:00,335.5,2623,5239,7862
2022/12/18,12:00:00,335.5,2561,5187,7748
2022/12/18,12:30:00,335.13,2523,5279,7802
2022/12/18,13:00:00,335.5,2462,5450,7912
2022/12/18,13:30:00,335.5,2358,5672,8030
2022/12/18,14:00:00,335.5,2143,5970,8113
2022/12/18,14:30:00,335.5,1803,6377,8180
2022/12/18,15:00:00,335.13,1410,6829,8239
2022/12/18,15:30:00,335.13,1013,7293,8306
2022/12/18,16:00:00,335.5,502,7644,8146
2022/12/18,16:30:00,335.5,145,8049,8194
2022/12/18,17:00:00,335.13,192,8482,8674
2022/12/18,17:30:00,370.05,202,8589,8791
2022/12/18,18:00:00,372.03,200,8695,8895
2022/12/18,18:30:00,335.5,200,8592,8792
2022/12/18,19:00:00,335.5,195,8436,8631
2022/12/18,19:30:00,335.5,187,8420,8607
2022/12/18,20:00:00,335.5,194,8198,8392
2022/12/18,20:30:00,335.5,197,8238,8435
2022/12/18,21:00:00,335.5,161,8254,8415
2022/12/18,21:30:00,334.78,74,8272,8346
2022/12/18,22:00:00,335.86,71,8040,8111
2022/12/18,22:30:00,335.5,73,7916,7989
2022/12/18,23:00:00,334.78,99,7550,7649
2022/12/18,23:30:00,334.78,111,7180,7291
2022/12/19,00:00:00,335.13,105,6821,6926
2022/12/19,00:30:00,335.29,107,6500,6607
2022/12/19,01:00:00,335.13,100,6219,6319
2022/12/19,01:30:00,335.37,79,6072,6151
2022/12/19,02:00:00,335.03,80,5911,5991
2022/12/19,02:30:00,335.5,76,5803,5879
2022/12/19,03:00:00,335.2,73,5771,5844
2022/12/19,03:30:00,335.11,71,5754,5825
2022/12/19,04:00:00,335.13,72,5753,5825
2022/12/19,04:30:00,335.2,73,5962,6035
2022/12/19,05:00:00,335.03,80,6139,6219
2022/12/19,05:30:00,335.2,55,6436,6491
2022/12/19,06:00:00,335.5,52,6676,6728
2022/12/19,06:30:00,335.86,40,6995,7035
2022/12/19,07:00:00,335.11,43,7340,7383
2022/12/19,07:30:00,335.5,435,7275,7710
2022/12/19,08:00:00,335.86,952,6784,7736
2022/12/19,08:30:00,335.5,1468,6425,7893
2022/12/19,09:00:00,335.13,1884,6000,7884
2022/12/19,09:30:00,335.5,2169,5714,7883
2022/12/19,10:00:00,335.5,2327,5487,7814
2022/12/19,10:30:00,335.5,2456,5369,7825
2022/12/19,11:00:00,335.29,2519,5292,7811
2022/12/19,11:30:00,335.5,2538,5247,7785
2022/12/19,12:00:00,335.5,2500,5259,7759
2022/12/19,12:30:00,335.13,2471,5351,7822
2022/12/19,13:00:00,335.13,2394,5513,7907
2022/12/19,13:30:00,335.13,2236,5762,7998
2022/12/19,14:00:00,335.13,2046,6030,8076
2022/12/19,14:30:00,335.5,1691,6477,8168
2022/12/19,15:00:00,335.13,1309,6931,8240
2022/12/19,15:30:00,335.13,881,7438,8319
2022/12/19,16:00:00,335.13,435,7701,8136
2022/12/19,16:30:00,335.5,123,8096,8219
2022/12/19,17:00:00,335.03,152,8619,8771
2022/12/19,17:30:00,335.13,159,8844,9003
2022/12/19,18:00:00,335.11,161,8922,9083
2022/12/19,18:30:00,335.11,164,8933,9097
2022/12/19,19:00:00,335.03,164,8892,9056
2022/12/19,19:30:00,335.29,160,8805,8965
2022/12/19,20:00:00,335.2,156,8770,8926
2022/12/19,20:30:00,335.29,151,8631,8782
2022/12/19,21:00:00,335.5,152,8473,8625
2022/12/19,21:30:00,335.5,148,8257,8405
2022/12/19,22:00:00,335.13,102,8022,8124
2022/12/19,22:30:00,335.29,50,7955,8005
2022/12/19,23:00:00,335.03,55,7595,7650
2022/12/19,23:30:00,335.29,53,7275,7328
2022/12/20,00:00:00,334.94,48,6928,6976
2022/12/20,00:30:00,335.03,15,6650,6665
2022/12/20,01:00:00,334.94,12,6350,6362
2022/12/20,01:30:00,334.69,7,6146,6153
2022/12/20,02:00:00,334.77,4,5949,5953
2022/12/20,02:30:00,334.69,3,5891,5894
2022/12/20,03:00:00,334.61,1,5820,5821
2022/12/20,03:30:00,334.77,3,5785,5788
2022/12/20,04:00:00,334.78,7,5810,5817
2022/12/20,04:30:00,334.77,9,5971,5980
2022/12/20,05:00:00,334.61,11,6159,6170
2022/12/20,05:30:00,334.78,8,6461,6469
2022/12/20,06:00:00,335.13,7,6670,6677
2022/12/20,06:30:00,335.5,4,6989,6993
2022/12/20,07:00:00,334.77,3,7227,7230
2022/12/20,07:30:00,334.69,334,7249,7583
2022/12/20,08:00:00,334.86,738,6946,7684
2022/12/20,08:30:00,334.86,1117,6708,7825
2022/12/20,09:00:00,335.5,1400,6385,7785
2022/12/20,09:30:00,334.94,1709,6140,7849
2022/12/20,10:00:00,334.61,1982,5894,7876
2022/12/20,10:30:00,334.69,2201,5600,7801
2022/12/20,11:00:00,334.77,2202,5611,7813
2022/12/20,11:30:00,334.61,2236,5524,7760
2022/12/20,12:00:00,334.77,2266,5548,7814
2022/12/20,12:30:00,334.94,2082,5701,7783
2022/12/20,13:00:00,334.86,2054,5814,7868
2022/12/20,13:30:00,335.13,2036,6040,8076
2022/12/20,14:00:00,335.13,1753,6339,8092
2022/12/20,14:30:00,335.5,1447,6727,8174
2022/12/20,15:00:00,334.78,1175,7069,8244
2022/12/20,15:30:00,335.13,769,7517,8286
2022/12/20,16:00:00,334.77,322,7823,8145
2022/12/20,16:30:00,374.93,43,8285,8328
2022/12/20,17:00:00,375.77,93,8819,8912
2022/12/20,17:30:00,372.51,100,9065,9165
2022/12/20,18:00:00,374.27,101,9149,9250
2022/12/20,18:30:00,377.65,102,9131,9233
2022/12/20,19:00:00,379.32,101,9076,9177
2022/12/20,19:30:00,334.69,101,9009,9110
2022/12/20,20:00:00,334.44,100,8879,8979
2022/12/20,20:30:00,334.77,54,8819,8873
2022/12/20,21:00:00,367.91,0,8719,8719
2022/12/20,21:30:00,368.79,0,8494,8494
2022/12/20,22:00:00,368.61,2,8221,8223
2022/12/20,22:30:00,372.86,2,8067,8069
2022/12/20,23:00:00,373.1,0,7757,7757
2022/12/20,23:30:00,373.1,0,7411,7411
2022/12/21,00:00:00,372.86,0,7044,7044
2022/12/21,00:30:00,373.34,0,6738,6738
2022/12/21,01:00:00,373.1,0,6435,6435
2022/12/21,01:30:00,373.1,0,6227,6227
2022/12/21,02:00:00,373.1,0,6090,6090
2022/12/21,02:30:00,373.34,0,5957,5957
2022/12/21,03:00:00,372.98,0,5910,5910
2022/12/21,03:30:00,373.22,3,5888,5891
2022/12/21,04:00:00,373.22,1,5909,5910
2022/12/21,04:30:00,373.34,1,6069,6070
2022/12/21,05:00:00,373.1,0,6245,6245
2022/12/21,05:30:00,373.1,5,6523,6528
2022/12/21,06:00:00,373.22,3,6752,6755
2022/12/21,06:30:00,373.1,5,7051,7056
2022/12/21,07:00:00,373.1,0,7231,7241
2022/12/21,07:30:00,373.1,9,7315,7654
2022/12/21,08:00:00,373.1,9,7123,7862
2022/12/21,08:30:00,373.22,3,6860,8043
2022/12/21,09:00:00,373.22,6,6553,8069
2022/12/21,09:30:00,373.22,2,6351,8113
2022/12/21,10:00:00,373.1,2,6137,8229
2022/12/21,10:30:00,374.19,5,6003,8228
2022/12/21,11:00:00,349.07,9,5997,8216
2022/12/21,11:30:00,349.07,1,6097,8318
2022/12/21,12:00:00,349.07,8,6340,8158
2022/12/21,12:30:00,349.23,8,6634,8112
2022/12/21,13:00:00,372.98,1,6821,8242
2022/12/21,13:30:00,373.1,6,7177,8413
2022/12/21,14:00:00,373.1,5,7459,8714
2022/12/21,14:30:00,373.1,9,7873,8992
2022/12/21,15:00:00,373.1,3,8226,9089
2022/12/21,15:30:00,373.1,4,8592,9176
2022/12/21,16:00:00,380.23,4,8691,9035
2022/12/21,16:30:00,373.1,6,9011,9127
2022/12/21,17:00:00,373.1,6,9432,9558
2022/12/21,17:30:00,373.1,5,9626,9761
2022/12/21,18:00:00,373.1,5,9649,9804
2022/12/21,18:30:00,373.1,9,9629,9768
2022/12/21,19:00:00,394.15,6,9555,9691
2022/12/21,19:30:00,377.76,8,9442,9570
2022/12/21,20:00:00,373.1,8,9296,9424
2022/12/21,20:30:00,373.1,0,9105,9235
2022/12/21,21:00:00,373.1,5,8916,9051
2022/12/21,21:30:00,373.1,3,8695,8788
2022/12/21,22:00:00,373.1,9,8382,8421
2022/12/21,22:30:00,372.98,9,8220,8259
2022/12/21,23:00:00,372.98,8,7873,7911
2022/12/21,23:30:00,372.98,4,7487,7521
2022/12/22,00:00:00,372.98,31,7127,7158
2022/12/22,00:30:00,372.98,3,6853,6856
2022/12/22,01:00:00,372.98,8,6583,6591
2022/12/22,01:30:00,373.22,12,6335,6347
2022/12/22,02:00:00,372.98,10,6163,6173
2022/12/22,02:30:00,373.22,14,6008,6022
2022/12/22,03:00:00,372.98,11,5940,5951
2022/12/22,03:30:00,373.22,9,5951,5960
2022/12/22,04:00:00,372.98,11,5967,5978
2022/12/22,04:30:00,372.98,17,6057,6074
2022/12/22,05:00:00,372.98,29,6299,6328
2022/12/22,05:30:00,373.22,36,6574,6610
2022/12/22,06:00:00,372.98,43,6763,6806
2022/12/22,06:30:00,372.98,47,7074,7121
2022/12/22,07:00:00,372.98,65,7315,7380
2022/12/22,07:30:00,372.98,396,7361,7757
2022/12/22,08:00:00,372.98,799,7051,7850
2022/12/22,08:30:00,372.98,1264,6774,8038
2022/12/22,09:00:00,349.07,1711,6395,8106
2022/12/22,09:30:00,349.07,2104,6063,8167
2022/12/22,10:00:00,349.07,2276,5867,8143
2022/12/22,10:30:00,349.07,2421,5670,8091
2022/12/22,11:00:00,349.07,2430,5598,8028
2022/12/22,11:30:00,349.07,2367,5655,8022
2022/12/22,12:00:00,349.07,2296,5675,7971
2022/12/22,12:30:00,349.07,2309,5691,8000
2022/12/22,13:00:00,349.07,2384,5716,8100
2022/12/22,13:30:00,349.07,2245,5959,8204
2022/12/22,14:00:00,348.76,2069,6228,8297
2022/12/22,14:30:00,349.23,1698,6650,8348
2022/12/22,15:00:00,349.07,1306,7052,8358
2022/12/22,15:30:00,348.91,865,7511,8376
2022/12/22,16:00:00,349.07,435,7910,8345
2022/12/22,16:30:00,359,93,8414,8507
2022/12/22,17:00:00,400.03,145,8970,9115
2022/12/22,17:30:00,364.76,203,9209,9412
2022/12/22,18:00:00,410.21,197,9296,9493
2022/12/22,18:30:00,403.39,190,9330,9520
2022/12/22,19:00:00,348.91,188,9264,9452
2022/12/22,19:30:00,349.23,185,9186,9371
2022/12/22,20:00:00,349.23,176,9064,9240
2022/12/22,20:30:00,349.07,175,8922,9097
2022/12/22,21:00:00,349.23,170,8791,8961
2022/12/22,21:30:00,349.07,184,8580,8764
2022/12/22,22:00:00,349.07,147,8360,8507
2022/12/22,22:30:00,348.91,69,8331,8400
2022/12/22,23:00:00,349.07,90,8015,8105
2022/12/22,23:30:00,349.07,94,7638,7732
2022/12/23,00:00:00,374.32,93,7264,7357
2022/12/23,00:30:00,374.32,93,6977,7070
2022/12/23,01:00:00,374.32,75,6681,6756
2022/12/23,01:30:00,374.32,71,6408,6479
2022/12/23,02:00:00,349.07,78,6203,6281
2022/12/23,02:30:00,374.32,83,6044,6127
2022/12/23,03:00:00,374.32,89,5950,6039
2022/12/23,03:30:00,374.32,74,5874,5948
2022/12/23,04:00:00,374.32,70,5881,5951
2022/12/23,04:30:00,374.32,61,5994,6055
2022/12/23,05:00:00,374.32,62,6056,6118
2022/12/23,05:30:00,374.32,83,6252,6335
2022/12/23,06:00:00,349.07,71,6392,6463
2022/12/23,06:30:00,374.19,80,6484,6564
2022/12/23,07:00:00,374.32,74,6520,6594
2022/12/23,07:30:00,374.32,379,6665,7044
2022/12/23,08:00:00,374.32,790,6619,7409
2022/12/23,08:30:00,374.32,1051,6617,7668
2022/12/23,09:00:00,374.32,1328,6697,8025
2022/12/23,09:30:00,374.32,1629,6636,8265
2022/12/23,10:00:00,374.32,1844,6516,8360
2022/12/23,10:30:00,374.32,1948,6460,8408
2022/12/23,11:00:00,374.32,2146,6317,8463
2022/12/23,11:30:00,349.23,2122,6336,8458
2022/12/23,12:00:00,374.32,2026,6343,8369
2022/12/23,12:30:00,374.32,2012,6394,8406
2022/12/23,13:00:00,374.32,1854,6582,8436
2022/12/23,13:30:00,374.32,1622,6908,8530
2022/12/23,14:00:00,374.32,971,7370,8341
2022/12/23,14:30:00,374.32,721,7823,8544
2022/12/23,15:00:00,374.32,548,8119,8667
2022/12/23,15:30:00,374.32,510,8402,8912
2022/12/23,16:00:00,374.32,309,8539,8848
2022/12/23,16:30:00,376.55,32,8544,8576
2022/12/23,17:00:00,374.32,33,8869,8902
2022/12/23,17:30:00,374.32,32,8970,9002
2022/12/23,18:00:00,374.32,31,8887,8918
2022/12/23,18:30:00,374.32,31,8735,8766
2022/12/23,19:00:00,374.32,30,8361,8391
2022/12/23,19:30:00,374.32,0,8238,8238
2022/12/23,20:00:00,374.32,0,8109,8109
2022/12/23,20:30:00,374.32,0,8131,8131
2022/12/23,21:00:00,374.32,0,8063,8063
2022/12/23,21:30:00,374.32,0,7972,7972
2022/12/23,22:00:00,374.32,0,7842,7842
2022/12/23,22:30:00,374.32,0,7652,7652
2022/12/23,23:00:00,374.32,2,7383,7385
2022/12/23,23:30:00,374.32,6,7116,7122
2022/12/24,00:00:00,374.45,9,6903,6912
2022/12/24,00:30:00,374.45,0,6641,6641
2022/12/24,01:00:00,374.45,1,6395,6396
2022/12/24,01:30:00,374.45,0,6175,6175
2022/12/24,02:00:00,374.45,0,6014,6014
2022/12/24,02:30:00,374.19,5,5927,5932
2022/12/24,03:00:00,374.32,2,5848,5850
2022/12/24,03:30:00,374.32,1,5831,5832
2022/12/24,04:00:00,374.19,0,5824,5824
2022/12/24,04:30:00,374.45,0,5825,5825
2022/12/24,05:00:00,374.19,0,5956,5956
2022/12/24,05:30:00,333.73,0,6059,6059
2022/12/24,06:00:00,374.32,1,6118,6119
2022/12/24,06:30:00,374.32,1,6122,6123
2022/12/24,07:00:00,374.45,159,6057,6216
2022/12/24,07:30:00,374.45,252,6094,6346
2022/12/24,08:00:00,374.32,392,6153,6545
2022/12/24,08:30:00,374.32,584,6236,6820
2022/12/24,09:00:00,374.32,547,6341,6888
2022/12/24,09:30:00,374.32,719,6430,7149
2022/12/24,10:00:00,374.32,932,6351,7283
2022/12/24,10:30:00,374.32,1326,6133,7459
2022/12/24,11:00:00,374.32,1486,6132,7618
2022/12/24,11:30:00,374.32,1359,6273,7632
2022/12/24,12:00:00,374.32,1174,6461,7635
2022/12/24,12:30:00,374.32,1090,6608,7698
2022/12/24,13:00:00,374.32,923,7020,7943
2022/12/24,13:30:00,374.32,642,7400,8042
2022/12/24,14:00:00,374.32,527,7537,8064
2022/12/24,14:30:00,374.45,467,7651,8118
2022/12/24,15:00:00,374.19,327,7806,8133
2022/12/24,15:30:00,374.45,307,8093,8400
2022/12/24,16:00:00,374.45,406,8327,8733
2022/12/24,16:30:00,374.46,28,8610,8638
2022/12/24,17:00:00,375.3,35,8909,8944
2022/12/24,17:30:00,335.7,28,9191,9219
2022/12/24,18:00:00,333.4,31,9501,9532
2022/12/24,18:30:00,374.32,29,9566,9595
2022/12/24,19:00:00,375.73,35,9479,9514
2022/12/24,19:30:00,380.3,40,9366,9406
2022/12/24,20:00:00,374.45,33,9276,9309
2022/12/24,20:30:00,376.7,31,9162,9193
2022/12/24,21:00:00,374.52,32,9050,9082
2022/12/24,21:30:00,374.45,24,8962,8986
2022/12/24,22:00:00,374.32,3,8790,8793
2022/12/24,22:30:00,374.32,0,8555,8555
2022/12/24,23:00:00,374.45,0,8193,8193
2022/12/24,23:30:00,374.19,1,7737,7738
2022/12/25,00:00:00,374.45,1,7363,7364
2022/12/25,00:30:00,374.45,1,7013,7014
2022/12/25,01:00:00,374.45,0,6611,6611
2022/12/25,01:30:00,374.32,2,6410,6412
2022/12/25,02:00:00,374.45,2,6157,6159
2022/12/25,02:30:00,374.45,2,5996,5998
2022/12/25,03:00:00,374.45,0,5873,5873
2022/12/25,03:30:00,374.45,2,5893,5895
2022/12/25,04:00:00,374.19,2,5906,5908
2022/12/25,04:30:00,349.07,1,6053,6054
2022/12/25,05:00:00,349.07,2,6249,6251
2022/12/25,05:30:00,374.32,2,6520,6522
2022/12/25,06:00:00,374.19,6,6713,6719
2022/12/25,06:30:00,374.19,7,6956,6963
2022/12/25,07:00:00,349.07,0,7146,7156
2022/12/25,07:30:00,374.32,6,7374,7710
2022/12/25,08:00:00,349.07,5,7255,8080
2022/12/25,08:30:00,373.1,3,7291,8494
2022/12/25,09:00:00,373.95,5,7398,8953
2022/12/25,09:30:00,374.19,6,7494,9260
2022/12/25,10:00:00,374.45,5,7624,9289
2022/12/25,10:30:00,374.45,0,7857,9297
2022/12/25,11:00:00,374.19,6,7958,9434
2022/12/25,11:30:00,374.45,4,8111,9295
2022/12/25,12:00:00,374.19,2,8235,9387
2022/12/25,12:30:00,349.07,6,8246,9342
2022/12/25,13:00:00,388.89,6,8546,9522
2022/12/25,13:30:00,384.47,5,8913,9738
2022/12/25,14:00:00,398.21,4,9380,10074
2022/12/25,14:30:00,395.79,0,9660,10150
2022/12/25,15:00:00,391.78,0,9793,10263
2022/12/25,15:30:00,396.56,7,9949,10356
2022/12/25,16:00:00,363.82,9,10022,10281
2022/12/25,16:30:00,366.33,8,10370,10408
2022/12/25,17:00:00,362.46,8,10835,10893
2022/12/25,17:30:00,376.74,5,11004,11059
2022/12/25,18:00:00,392.47,5,11037,11142
2022/12/25,18:30:00,394.04,1,10983,11114
2022/12/25,19:00:00,392.47,2,10884,11016
2022/12/25,19:30:00,392.47,7,10757,10894
2022/12/25,20:00:00,392.47,9,10625,10754
2022/12/25,20:30:00,399.05,0,10473,10533
2022/12/25,21:00:00,399.77,1,10276,10307
2022/12/25,21:30:00,368.43,3,9967,10000
2022/12/25,22:00:00,372.51,3,9594,9627
2022/12/25,22:30:00,373.1,3,9298,9331
2022/12/25,23:00:00,373.34,5,8888,8923
2022/12/25,23:30:00,372.98,5,8336,8371
2022/12/26,00:00:00,372.98,34,7841,7875
2022/12/26,00:30:00,372.98,3,7441,7444
2022/12/26,01:00:00,372.86,1,7022,7023
2022/12/26,01:30:00,372.98,1,6753,6754
2022/12/26,02:00:00,373.1,0,6535,6535
2022/12/26,02:30:00,373.1,2,6314,6316
2022/12/26,03:00:00,373.34,4,6234,6238
2022/12/26,03:30:00,372.98,12,6165,6177
2022/12/26,04:00:00,373.22,19,6222,6241
2022/12/26,04:30:00,372.98,12,6259,6271
2022/12/26,05:00:00,373.1,1,6486,6487
2022/12/26,05:30:00,373.1,1,6866,6867
2022/12/26,06:00:00,373.1,3,7118,7121
2022/12/26,06:30:00,373.1,14,7552,7566
2022/12/26,07:00:00,373.1,27,7946,7973
2022/12/26,07:30:00,373.1,456,8514,8970
2022/12/26,08:00:00,372.86,231,8871,9102
2022/12/26,08:30:00,399.73,398,9174,9572
2022/12/26,09:00:00,392.9,559,9360,9919
2022/12/26,09:30:00,385.69,465,9550,10015
2022/12/26,10:00:00,395.42,516,9710,10226
2022/12/26,10:30:00,388.03,885,9772,10657
2022/12/26,11:00:00,400.65,958,9698,10656
2022/12/26,11:30:00,400.86,1165,9504,10669
2022/12/26,12:00:00,388.52,1137,9311,10448
2022/12/26,12:30:00,388.53,877,9475,10352
2022/12/26,13:00:00,395.74,688,9578,10266
2022/12/26,13:30:00,393.43,1026,9555,10581
2022/12/26,14:00:00,389.01,961,9517,10478
2022/12/26,14:30:00,401.35,1048,9406,10454
2022/12/26,15:00:00,394.79,1087,9499,10586
2022/12/26,15:30:00,394.43,614,9960,10574
2022/12/26,16:00:00,372.63,334,10179,10513
2022/12/26,16:30:00,394,287,10532,10819
2022/12/26,17:00:00,394.12,62,11340,11402
2022/12/26,17:30:00,403.7,49,11680,11729
2022/12/26,18:00:00,405.58,8,11947,11955
2022/12/26,18:30:00,401.94,5,12009,12014
2022/12/26,19:00:00,403.7,51,11964,12015
2022/12/26,19:30:00,392.93,48,11906,11954
2022/12/26,20:00:00,394.39,42,11742,11784
2022/12/26,20:30:00,390.3,46,11531,11577
2022/12/26,21:00:00,392.86,65,11339,11404
2022/12/26,21:30:00,336.34,43,10833,10876
2022/12/26,22:00:00,336.34,15,10398,10413
2022/12/26,22:30:00,336.43,16,9980,9996
2022/12/26,23:00:00,336.34,16,9420,9436
2022/12/26,23:30:00,336.43,13,8788,8801
2022/12/27,00:00:00,374.32,18,8110,8128
2022/12/27,00:30:00,374.32,11,7684,7695
2022/12/27,01:00:00,374.32,10,7259,7269
2022/12/27,01:30:00,374.32,9,6916,6925
2022/12/27,02:00:00,374.32,15,6699,6714
2022/12/27,02:30:00,374.19,12,6557,6569
2022/12/27,03:00:00,374.19,8,6424,6432
2022/12/27,03:30:00,374.19,8,6386,6394
2022/12/27,04:00:00,374.19,10,6433,6443
2022/12/27,04:30:00,374.45,7,6508,6515
2022/12/27,05:00:00,374.45,7,6729,6736
2022/12/27,05:30:00,374.45,9,7178,7187
2022/12/27,06:00:00,374.32,3,7491,7494
2022/12/27,06:30:00,374.32,1,7997,7998
2022/12/27,07:00:00,374.19,1,8533,8534
2022/12/27,07:30:00,389.21,267,8737,9004
2022/12/27,08:00:00,374.19,375,8491,8866
2022/12/27,08:30:00,374.07,799,8158,8957
2022/12/27,09:00:00,373.95,1068,7766,8834
2022/12/27,09:30:00,373.82,1379,7484,8863
2022/12/27,10:00:00,349.07,1878,7094,8972
2022/12/27,10:30:00,374.07,1900,6930,8830
2022/12/27,11:00:00,373.82,1977,6912,8889
2022/12/27,11:30:00,374.32,2104,6823,8927
2022/12/27,12:00:00,373.82,1951,6841,8792
2022/12/27,12:30:00,374.32,1841,7064,8905
2022/12/27,13:00:00,374.32,1647,7108,8755
2022/12/27,13:30:00,374.32,1757,7192,8949
2022/12/27,14:00:00,374.45,1597,7335,8932
2022/12/27,14:30:00,374.19,1319,7699,9018
2022/12/27,15:00:00,374.19,1111,8116,9227
2022/12/27,15:30:00,374.19,703,8612,9315
2022/12/27,16:00:00,395.6,376,9009,9385
2022/12/27,16:30:00,409.92,1,9801,9802
2022/12/27,17:00:00,398.19,0,10674,10674
2022/12/27,17:30:00,374.7,0,11206,11206
2022/12/27,18:00:00,374.88,0,11472,11472
2022/12/27,18:30:00,375.25,0,11545,11545
2022/12/27,19:00:00,374.87,0,11543,11543
2022/12/27,19:30:00,373.66,0,11550,11550
2022/12/27,20:00:00,372.67,0,11429,11429
2022/12/27,20:30:00,403.32,0,11285,11285
2022/12/27,21:00:00,365.97,0,10900,10900
2022/12/27,21:30:00,369.94,0,10584,10584
2022/12/27,22:00:00,374.19,0,10162,10162
2022/12/27,22:30:00,374.45,0,9810,9810
2022/12/27,23:00:00,373.46,0,9253,9253
2022/12/27,23:30:00,373.46,0,8646,8646
2022/12/28,00:00:00,373.7,0,8082,8082
2022/12/28,00:30:00,373.58,0,7578,7578
2022/12/28,01:00:00,373.46,1,7158,7159
2022/12/28,01:30:00,373.7,1,6831,6832
2022/12/28,02:00:00,373.46,2,6621,6623
2022/12/28,02:30:00,336.34,3,6472,6475
2022/12/28,03:00:00,336.26,1,6362,6363
2022/12/28,03:30:00,336.52,2,6326,6328
2022/12/28,04:00:00,336.52,11,6348,6359
2022/12/28,04:30:00,336.34,16,6486,6502
2022/12/28,05:00:00,336.34,11,6714,6725
2022/12/28,05:30:00,336.34,9,7093,7102
2022/12/28,06:00:00,336.52,9,7357,7366
2022/12/28,06:30:00,336.34,9,7933,7942
2022/12/28,07:00:00,336.26,5,8451,8456
2022/12/28,07:30:00,336.34,303,8642,8945
2022/12/28,08:00:00,336.34,654,8217,8871
2022/12/28,08:30:00,336.17,916,7884,8800
2022/12/28,09:00:00,336.17,1368,7409,8777
2022/12/28,09:30:00,336.09,1564,7097,8661
2022/12/28,10:00:00,336.26,2018,6700,8718
2022/12/28,10:30:00,336.26,2261,6498,8759
2022/12/28,11:00:00,336.26,2427,6290,8717
2022/12/28,11:30:00,336.26,2455,6293,8748
2022/12/28,12:00:00,336.26,2373,6359,8732
2022/12/28,12:30:00,336.17,2161,6665,8826
2022/12/28,13:00:00,336.26,2002,6978,8980
2022/12/28,13:30:00,336.26,1822,7246,9068
2022/12/28,14:00:00,336.17,1602,7465,9067
2022/12/28,14:30:00,336.09,1322,7845,9167
2022/12/28,15:00:00,336.34,1091,8199,9290
2022/12/28,15:30:00,336.26,815,8617,9432
2022/12/28,16:00:00,336.17,470,8895,9365
2022/12/28,16:30:00,403.2,84,9506,9590
2022/12/28,17:00:00,404.5,91,10218,10309
2022/12/28,17:30:00,405.36,94,10730,10824
2022/12/28,18:00:00,405.39,93,10982,11075
2022/12/28,18:30:00,405.45,85,11141,11226
2022/12/28,19:00:00,405.39,84,11165,11249
2022/12/28,19:30:00,409.66,87,11194,11281
2022/12/28,20:00:00,392.72,90,11092,11182
2022/12/28,20:30:00,403.18,88,10957,11045
2022/12/28,21:00:00,400.8,86,10731,10817
2022/12/28,21:30:00,402.36,48,10455,10503
2022/12/28,22:00:00,401.54,4,10105,10109
2022/12/28,22:30:00,373.88,2,9763,9765
2022/12/28,23:00:00,374.45,1,9225,9226
2022/12/28,23:30:00,374.19,0,8653,8653
2022/12/29,00:00:00,374.07,0,8130,8130
2022/12/29,00:30:00,374.07,0,7632,7632
2022/12/29,01:00:00,374.19,0,7244,7244
2022/12/29,01:30:00,374.07,0,6926,6926
2022/12/29,02:00:00,347.98,0,6695,6695
2022/12/29,02:30:00,373.82,0,6537,6537
2022/12/29,03:00:00,373.95,0,6423,6423
2022/12/29,03:30:00,348.29,0,6385,6385
2022/12/29,04:00:00,373.95,2,6441,6443
2022/12/29,04:30:00,374.19,5,6552,6557
2022/12/29,05:00:00,374.19,6,6762,6768
2022/12/29,05:30:00,374.45,8,7128,7136
2022/12/29,06:00:00,374.19,2,7385,7397
2022/12/29,06:30:00,374.45,5,7899,7924
2022/12/29,07:00:00,374.19,5,8393,8418
2022/12/29,07:30:00,372.51,9,8528,8867
2022/12/29,08:00:00,372.74,7,8066,8853
2022/12/29,08:30:00,374.32,4,7735,8899
2022/12/29,09:00:00,374.19,3,7278,8861
2022/12/29,09:30:00,373.95,0,6899,8879
2022/12/29,10:00:00,374.45,2,6626,8878
2022/12/29,10:30:00,373.95,7,6418,8805
2022/12/29,11:00:00,348.29,1,6208,8659
2022/12/29,11:30:00,348.29,9,6102,8611
2022/12/29,12:00:00,348.13,0,6035,8495
2022/12/29,12:30:00,348.29,0,6061,8531
2022/12/29,13:00:00,348.29,6,6156,8522
2022/12/29,13:30:00,348.29,2,6344,8566
2022/12/29,14:00:00,348.29,2,6577,8579
2022/12/29,14:30:00,348.29,9,6947,8586
2022/12/29,15:00:00,348.29,0,7396,8656
2022/12/29,15:30:00,348.13,4,7913,8807
2022/12/29,16:00:00,374.83,4,8333,8807
2022/12/29,16:30:00,398.12,9,8932,9051
2022/12/29,17:00:00,396.55,4,9777,9891
2022/12/29,17:30:00,405.49,6,10350,10466
2022/12/29,18:00:00,400.38,9,10666,10785
2022/12/29,18:30:00,405.55,9,10771,10910
2022/12/29,19:00:00,400.38,8,10827,10985
2022/12/29,19:30:00,398.76,5,10815,10980
2022/12/29,20:00:00,397.24,0,10685,10855
2022/12/29,20:30:00,392.51,5,10544,10719
2022/12/29,21:00:00,393.64,5,10316,10501
2022/12/29,21:30:00,374.72,4,10044,10198
2022/12/29,22:00:00,338.88,7,9791,9888
2022/12/29,22:30:00,374.19,0,9617,9707
2022/12/29,23:00:00,374.45,1,9145,9226
2022/12/29,23:30:00,374.45,9,8694,8773
2022/12/30,00:00:00,374.19,81,8172,8253
2022/12/30,00:30:00,374.19,76,7756,7832
2022/12/30,01:00:00,374.45,83,7302,7385
2022/12/30,01:30:00,374.19,69,7042,7111
2022/12/30,02:00:00,374.07,71,6784,6855
2022/12/30,02:30:00,348.13,70,6537,6607
2022/12/30,03:00:00,374.32,74,6453,6527
2022/12/30,03:30:00,348.13,74,6333,6407
2022/12/30,04:00:00,374.07,84,6358,6442
2022/12/30,04:30:00,374.07,81,6428,6509
2022/12/30,05:00:00,374.45,66,6586,6652
2022/12/30,05:30:00,374.45,64,6835,6899
2022/12/30,06:00:00,374.45,65,6982,7047
2022/12/30,06:30:00,374.45,73,7192,7265
2022/12/30,07:00:00,374.32,85,7403,7488
2022/12/30,07:30:00,348.29,440,7471,7911
2022/12/30,08:00:00,374.32,868,7126,7994
2022/12/30,08:30:00,348.13,1252,6798,8050
2022/12/30,09:00:00,374.32,1610,6497,8107
2022/12/30,09:30:00,374.32,2042,6207,8249
2022/12/30,10:00:00,348.29,2317,5993,8310
2022/12/30,10:30:00,374.19,2451,5969,8420
2022/12/30,11:00:00,373.82,2550,5915,8465
2022/12/30,11:30:00,374.45,2614,5800,8414
2022/12/30,12:00:00,373.95,2641,5777,8418
2022/12/30,12:30:00,374.19,2557,5799,8356
2022/12/30,13:00:00,348.13,2488,5968,8456
2022/12/30,13:30:00,374.45,2374,6203,8577
2022/12/30,14:00:00,374.45,2134,6510,8644
2022/12/30,14:30:00,374.32,1760,6951,8711
2022/12/30,15:00:00,374.19,1409,7497,8906
2022/12/30,15:30:00,389.98,976,8202,9178
2022/12/30,16:00:00,394.8,548,8741,9289
2022/12/30,16:30:00,404.17,153,9033,9186
2022/12/30,17:00:00,374.45,89,9575,9664
2022/12/30,17:30:00,374.45,96,9877,9973
2022/12/30,18:00:00,393.66,99,9876,9975
2022/12/30,18:30:00,392.1,92,9793,9885
2022/12/30,19:00:00,374.45,114,9575,9689
2022/12/30,19:30:00,348.44,111,9385,9496
2022/12/30,20:00:00,374.32,122,9200,9322
2022/12/30,20:30:00,348.29,117,9166,9283
2022/12/30,21:00:00,374.19,111,9083,9194
2022/12/30,21:30:00,374.45,104,8933,9037
2022/12/30,22:00:00,373.82,119,8730,8849
2022/12/30,22:30:00,374.19,126,8456,8582
2022/12/30,23:00:00,374.45,116,8200,8316
2022/12/30,23:30:00,374.19,119,7758,7877
2022/12/31,00:00:00,374.19,111,7457,7568
2022/12/31,00:30:00,374.19,81,7153,7234
2022/12/31,01:00:00,348.29,80,6832,6912
2022/12/31,01:30:00,374.19,84,6628,6712
2022/12/31,02:00:00,373.95,86,6389,6475
2022/12/31,02:30:00,374.07,85,6275,6360
2022/12/31,03:00:00,374.19,78,6156,6234
2022/12/31,03:30:00,374.19,78,6134,6212
2022/12/31,04:00:00,374.07,69,6121,6190
2022/12/31,04:30:00,348.13,66,6121,6187
2022/12/31,05:00:00,348.13,78,6236,6314
2022/12/31,05:30:00,374.19,79,6364,6443
2022/12/31,06:00:00,348.13,73,6423,6496
2022/12/31,06:30:00,373.95,69,6440,6509
2022/12/31,07:00:00,374.19,65,6439,6504
2022/12/31,07:30:00,373.95,335,6370,6705
2022/12/31,08:00:00,374.07,797,6169,6966
2022/12/31,08:30:00,374.19,1250,5969,7219
2022/12/31,09:00:00,347.98,1681,5688,7369
2022/12/31,09:30:00,348.29,2053,5575,7628
2022/12/31,10:00:00,348.44,2342,5387,7729
2022/12/31,10:30:00,348.13,2479,5282,7761
2022/12/31,11:00:00,347.98,2585,5185,7770
2022/12/31,11:30:00,348.29,2488,5275,7763
2022/12/31,12:00:00,348.29,2482,5280,7762
2022/12/31,12:30:00,348.29,2462,5235,7697
2022/12/31,13:00:00,348.6,2397,5279,7676
2022/12/31,13:30:00,348.29,2287,5370,7657
2022/12/31,14:00:00,348.29,2108,5574,7682
2022/12/31,14:30:00,348.29,1708,6056,7764
2022/12/31,15:00:00,348.29,1365,6461,7826
2022/12/31,15:30:00,348.29,939,7096,8035
2022/12/31,16:00:00,348.29,483,7747,8230
2022/12/31,16:30:00,395.05,110,8443,8553
2022/12/31,17:00:00,407.07,68,9074,9142
2022/12/31,17:30:00,397.42,64,9576,9640
2022/12/31,18:00:00,401.44,61,10069,10130
2022/12/31,18:30:00,405.43,62,10249,10311
2022/12/31,19:00:00,403.56,65,10229,10294
2022/12/31,19:30:00,409.92,63,10182,10245
2022/12/31,20:00:00,373.63,59,10052,10111
2022/12/31,20:30:00,366.7,61,9856,9917
2022/12/31,21:00:00,397.03,73,9590,9663
2022/12/31,21:30:00,409.92,71,9420,9491
2022/12/31,22:00:00,390.35,69,9094,9163
2022/12/31,22:30:00,373.7,74,8749,8823
2022/12/31,23:00:00,373.7,73,8380,8453
2022/12/31,23:30:00,373.7,70,7965,8035
